Stunden,Zählung Neutor,FR stadteinwärts,FR stadtauswärts,Temperatur (°C),Windstärke (km/h)
1/1/2015 0:00,111,33,78,1,7
1/1/2015 1:00,230,114,116,1,7
1/1/2015 2:00,224,103,121,0,9
1/1/2015 3:00,273,90,183,1,11
1/1/2015 4:00,200,53,147,1,9
1/1/2015 5:00,112,31,81,1,11
1/1/2015 6:00,51,10,41,0,11
1/1/2015 7:00,28,7,21,1,13
1/1/2015 8:00,18,5,13,2,13
1/1/2015 9:00,26,15,11,1,7
1/1/2015 10:00,46,32,14,3,11
1/1/2015 11:00,44,28,16,4,19
1/1/2015 12:00,67,37,30,4,19
1/1/2015 13:00,99,50,49,5,20
1/1/2015 14:00,156,100,56,5,19
1/1/2015 15:00,172,107,65,4,15
1/1/2015 16:00,151,76,75,4,13
1/1/2015 17:00,103,53,50,4,15
1/1/2015 18:00,134,52,82,4,19
1/1/2015 19:00,100,42,58,4,22
1/1/2015 20:00,56,20,36,5,26
1/1/2015 21:00,48,18,30,4,22
1/1/2015 22:00,51,25,26,4,20
1/1/2015 23:00,32,15,17,5,24
1/2/2015 0:00,16,8,8,5,30
1/2/2015 1:00,11,2,9,5,26
1/2/2015 2:00,6,3,3,5,26
1/2/2015 3:00,7,3,4,5,28
1/2/2015 4:00,1,1,0,5,28
1/2/2015 5:00,11,8,3,5,26
1/2/2015 6:00,29,21,8,5,28
1/2/2015 7:00,96,68,28,6,32
1/2/2015 8:00,113,70,43,6,32
1/2/2015 9:00,154,111,43,7,24
1/2/2015 10:00,184,136,48,8,20
1/2/2015 11:00,195,119,76,8,28
1/2/2015 12:00,260,172,88,8,28
1/2/2015 13:00,319,194,125,8,24
1/2/2015 14:00,342,205,137,8,33
1/2/2015 15:00,368,222,146,7,28
1/2/2015 16:00,380,174,206,7,28
1/2/2015 17:00,318,155,163,6,28
1/2/2015 18:00,271,133,138,6,26
1/2/2015 19:00,278,135,143,6,26
1/2/2015 20:00,224,99,125,6,26
1/2/2015 21:00,113,49,64,5,24
1/2/2015 22:00,131,57,74,5,24
1/2/2015 23:00,104,32,72,4,20
1/3/2015 0:00,71,32,39,4,22
1/3/2015 1:00,65,25,40,4,20
1/3/2015 2:00,32,13,19,4,15
1/3/2015 3:00,27,3,24,4,17
1/3/2015 4:00,18,7,11,4,15
1/3/2015 5:00,20,12,8,4,17
1/3/2015 6:00,26,16,10,4,17
1/3/2015 7:00,41,31,10,4,17
1/3/2015 8:00,81,49,32,4,20
1/3/2015 9:00,185,142,43,4,24
1/3/2015 10:00,245,180,65,5,24
1/3/2015 11:00,244,158,86,4,30
1/3/2015 12:00,261,151,110,3,24
1/3/2015 13:00,279,146,133,3,19
1/3/2015 14:00,248,120,128,3,17
1/3/2015 15:00,273,151,122,3,13
1/3/2015 16:00,263,124,139,3,15
1/3/2015 17:00,245,101,144,3,17
1/3/2015 18:00,238,126,112,3,13
1/3/2015 19:00,270,121,149,3,15
1/3/2015 20:00,240,114,126,3,17
1/3/2015 21:00,128,80,48,3,19
1/3/2015 22:00,120,46,74,3,15
1/3/2015 23:00,112,38,74,2,13
1/4/2015 0:00,107,46,61,3,17
1/4/2015 1:00,110,40,70,3,15
1/4/2015 2:00,64,21,43,2,15
1/4/2015 3:00,59,14,45,3,17
1/4/2015 4:00,27,5,22,3,19
1/4/2015 5:00,12,5,7,2,15
1/4/2015 6:00,14,7,7,2,15
1/4/2015 7:00,34,24,10,3,17
1/4/2015 8:00,31,19,12,2,15
1/4/2015 9:00,119,81,38,2,17
1/4/2015 10:00,156,112,44,4,17
1/4/2015 11:00,188,118,70,5,19
1/4/2015 12:00,206,117,89,6,19
1/4/2015 13:00,289,171,118,7,17
1/4/2015 14:00,326,191,135,6,20
1/4/2015 15:00,353,204,149,6,15
1/4/2015 16:00,302,128,174,4,13
1/4/2015 17:00,289,131,158,2,15
1/4/2015 18:00,266,107,159,2,11
1/4/2015 19:00,266,125,141,1,11
1/4/2015 20:00,172,70,102,1,9
1/4/2015 21:00,99,31,68,2,9
1/4/2015 22:00,132,45,87,1,9
1/4/2015 23:00,69,34,35,2,9
1/5/2015 0:00,50,18,32,2,11
1/5/2015 1:00,21,6,15,1,9
1/5/2015 2:00,7,2,5,1,13
1/5/2015 3:00,2,1,1,1,19
1/5/2015 4:00,6,3,3,1,17
1/5/2015 5:00,36,22,14,2,17
1/5/2015 6:00,123,88,35,2,19
1/5/2015 7:00,442,260,182,2,17
1/5/2015 8:00,830,452,378,2,15
1/5/2015 9:00,734,427,307,2,15
1/5/2015 10:00,932,522,410,3,15
1/5/2015 11:00,892,479,413,3,15
1/5/2015 12:00,876,459,417,4,13
1/5/2015 13:00,861,463,398,4,17
1/5/2015 14:00,1054,559,495,4,15
1/5/2015 15:00,1022,548,474,4,17
1/5/2015 16:00,1077,598,479,3,17
1/5/2015 17:00,1214,742,472,2,6
1/5/2015 18:00,973,465,508,2,6
1/5/2015 19:00,853,322,531,2,7
1/5/2015 20:00,504,184,320,2,4
1/5/2015 21:00,357,155,202,2,4
1/5/2015 22:00,260,117,143,2,6
1/5/2015 23:00,147,45,102,2,6
1/6/2015 0:00,91,29,62,3,4
1/6/2015 1:00,48,9,39,3,6
1/6/2015 2:00,13,3,10,2,4
1/6/2015 3:00,8,5,3,2,6
1/6/2015 4:00,12,4,8,2,6
1/6/2015 5:00,38,27,11,3,6
1/6/2015 6:00,119,88,31,3,7
1/6/2015 7:00,505,287,218,3,6
1/6/2015 8:00,998,536,462,3,7
1/6/2015 9:00,978,503,475,3,7
1/6/2015 10:00,850,468,382,4,7
1/6/2015 11:00,907,518,389,4,6
1/6/2015 12:00,972,541,431,5,7
1/6/2015 13:00,983,559,424,5,7
1/6/2015 14:00,990,487,503,5,7
1/6/2015 15:00,987,512,475,4,6
1/6/2015 16:00,1147,570,577,3,4
1/6/2015 17:00,1198,629,569,4,9
1/6/2015 18:00,1036,505,531,3,13
1/6/2015 19:00,829,411,418,3,11
1/6/2015 20:00,544,235,309,3,9
1/6/2015 21:00,350,154,196,4,13
1/6/2015 22:00,334,98,236,3,11
1/6/2015 23:00,156,60,96,4,15
1/7/2015 0:00,78,24,54,4,15
1/7/2015 1:00,44,13,31,4,17
1/7/2015 2:00,7,3,4,4,15
1/7/2015 3:00,8,4,4,4,15
1/7/2015 4:00,7,4,3,5,15
1/7/2015 5:00,37,28,9,4,15
1/7/2015 6:00,133,100,33,2,9
1/7/2015 7:00,752,517,235,3,9
1/7/2015 8:00,1194,687,507,4,9
1/7/2015 9:00,882,476,406,4,13
1/7/2015 10:00,930,475,455,4,19
1/7/2015 11:00,859,484,375,4,20
1/7/2015 12:00,1000,538,462,5,17
1/7/2015 13:00,1029,570,459,6,15
1/7/2015 14:00,1018,548,470,6,19
1/7/2015 15:00,1119,549,570,6,15
1/7/2015 16:00,1192,583,609,5,11
1/7/2015 17:00,1283,650,633,4,13
1/7/2015 18:00,943,448,495,5,15
1/7/2015 19:00,917,456,461,4,15
1/7/2015 20:00,666,344,322,4,17
1/7/2015 21:00,434,209,225,4,15
1/7/2015 22:00,330,123,207,3,17
1/7/2015 23:00,223,89,134,3,20
1/8/2015 0:00,156,51,105,3,20
1/8/2015 1:00,85,19,66,3,19
1/8/2015 2:00,58,21,37,3,20
1/8/2015 3:00,34,2,32,4,20
1/8/2015 4:00,19,6,13,4,19
1/8/2015 5:00,48,34,14,4,19
1/8/2015 6:00,98,74,24,5,24
1/8/2015 7:00,606,397,209,5,19
1/8/2015 8:00,1008,555,453,6,19
1/8/2015 9:00,701,382,319,6,19
1/8/2015 10:00,811,455,356,6,17
1/8/2015 11:00,734,357,377,7,19
1/8/2015 12:00,837,392,445,7,20
1/8/2015 13:00,695,371,324,7,19
1/8/2015 14:00,688,327,361,7,11
1/8/2015 15:00,656,349,307,8,13
1/8/2015 16:00,664,365,299,8,17
1/8/2015 17:00,724,376,348,6,28
1/8/2015 18:00,593,299,294,5,15
1/8/2015 19:00,574,281,293,5,11
1/8/2015 20:00,336,148,188,6,24
1/8/2015 21:00,214,110,104,6,30
1/8/2015 22:00,216,89,127,6,30
1/8/2015 23:00,92,31,61,6,30
1/9/2015 0:00,90,21,69,6,24
1/9/2015 1:00,35,12,23,6,22
1/9/2015 2:00,18,2,16,7,24
1/9/2015 3:00,13,5,8,7,30
1/9/2015 4:00,14,8,6,7,30
1/9/2015 5:00,39,27,12,7,30
1/9/2015 6:00,88,58,30,8,39
1/9/2015 7:00,459,301,158,8,39
1/9/2015 8:00,720,376,344,8,44
1/9/2015 9:00,601,338,263,8,44
1/9/2015 10:00,606,345,261,8,41
1/9/2015 11:00,591,363,228,9,39
1/9/2015 12:00,688,402,286,10,39
1/9/2015 13:00,699,358,341,11,43
1/9/2015 14:00,686,341,345,11,39
1/9/2015 15:00,605,336,269,11,37
1/9/2015 16:00,623,338,285,10,43
1/9/2015 17:00,644,340,304,9,54
1/9/2015 18:00,568,326,242,7,28
1/9/2015 19:00,528,337,191,7,22
1/9/2015 20:00,420,241,179,6,11
1/9/2015 21:00,291,150,141,6,13
1/9/2015 22:00,266,100,166,7,15
1/9/2015 23:00,184,60,124,11,32
1/10/2015 0:00,206,39,167,13,39
1/10/2015 1:00,168,32,136,13,50
1/10/2015 2:00,89,22,67,13,37
1/10/2015 3:00,85,15,70,12,41
1/10/2015 4:00,45,9,36,13,37
1/10/2015 5:00,53,25,28,13,35
1/10/2015 6:00,23,16,7,13,35
1/10/2015 7:00,79,58,21,13,39
1/10/2015 8:00,124,95,29,13,37
1/10/2015 9:00,240,182,58,12,41
1/10/2015 10:00,295,214,81,12,39
1/10/2015 11:00,277,184,93,12,44
1/10/2015 12:00,335,200,135,11,41
1/10/2015 13:00,308,178,130,11,37
1/10/2015 14:00,273,134,139,6,59
1/10/2015 15:00,209,83,126,9,32
1/10/2015 16:00,245,114,131,8,35
1/10/2015 17:00,255,125,130,8,32
1/10/2015 18:00,283,136,147,6,24
1/10/2015 19:00,329,162,167,6,26
1/10/2015 20:00,343,174,169,6,32
1/10/2015 21:00,216,130,86,5,26
1/10/2015 22:00,179,95,84,5,22
1/10/2015 23:00,162,81,81,4,22
1/11/2015 0:00,197,86,111,4,22
1/11/2015 1:00,183,72,111,4,22
1/11/2015 2:00,123,52,71,3,24
1/11/2015 3:00,108,38,70,3,20
1/11/2015 4:00,64,34,30,3,22
1/11/2015 5:00,48,27,21,3,28
1/11/2015 6:00,24,11,13,3,28
1/11/2015 7:00,38,24,14,3,30
1/11/2015 8:00,51,41,10,3,33
1/11/2015 9:00,138,105,33,3,30
1/11/2015 10:00,170,125,45,3,30
1/11/2015 11:00,168,106,62,4,37
1/11/2015 12:00,232,135,97,5,39
1/11/2015 13:00,277,179,98,5,32
1/11/2015 14:00,305,169,136,6,35
1/11/2015 15:00,297,178,119,6,35
1/11/2015 16:00,328,162,166,6,32
1/11/2015 17:00,339,157,182,6,37
1/11/2015 18:00,317,126,191,5,41
1/11/2015 19:00,289,122,167,5,43
1/11/2015 20:00,203,59,144,5,37
1/11/2015 21:00,128,44,84,5,37
1/11/2015 22:00,148,43,105,6,35
1/11/2015 23:00,105,29,76,6,24
1/12/2015 0:00,46,25,21,6,24
1/12/2015 1:00,33,14,19,6,22
1/12/2015 2:00,9,6,3,7,26
1/12/2015 3:00,4,2,2,7,24
1/12/2015 4:00,4,2,2,7,24
1/12/2015 5:00,37,29,8,7,24
1/12/2015 6:00,96,72,24,7,26
1/12/2015 7:00,531,351,180,7,30
1/12/2015 8:00,943,532,411,7,32
1/12/2015 9:00,685,378,307,7,32
1/12/2015 10:00,767,399,368,7,30
1/12/2015 11:00,747,378,369,7,30
1/12/2015 12:00,754,365,389,7,33
1/12/2015 13:00,836,447,389,7,30
1/12/2015 14:00,782,372,410,8,30
1/12/2015 15:00,972,509,463,9,33
1/12/2015 16:00,986,565,421,9,33
1/12/2015 17:00,1092,553,539,9,32
1/12/2015 18:00,913,457,456,9,35
1/12/2015 19:00,811,380,431,9,39
1/12/2015 20:00,493,237,256,8,32
1/12/2015 21:00,328,147,181,8,26
1/12/2015 22:00,300,102,198,9,32
1/12/2015 23:00,183,45,138,9,28
1/13/2015 0:00,93,19,74,10,32
1/13/2015 1:00,21,6,15,9,30
1/13/2015 2:00,13,4,9,10,30
1/13/2015 3:00,5,3,2,9,26
1/13/2015 4:00,8,6,2,9,24
1/13/2015 5:00,37,27,10,10,30
1/13/2015 6:00,122,84,38,11,33
1/13/2015 7:00,600,409,191,9,30
1/13/2015 8:00,962,519,443,9,26
1/13/2015 9:00,929,498,431,8,26
1/13/2015 10:00,767,401,366,8,26
1/13/2015 11:00,764,443,321,9,22
1/13/2015 12:00,849,452,397,9,28
1/13/2015 13:00,766,411,355,9,24
1/13/2015 14:00,819,394,425,9,32
1/13/2015 15:00,776,381,395,9,22
1/13/2015 16:00,890,461,429,9,26
1/13/2015 17:00,1051,613,438,8,22
1/13/2015 18:00,928,495,433,8,20
1/13/2015 19:00,843,396,447,8,20
1/13/2015 20:00,529,216,313,8,20
1/13/2015 21:00,316,155,161,8,28
1/13/2015 22:00,317,122,195,7,20
1/13/2015 23:00,181,80,101,7,20
1/14/2015 0:00,95,24,71,7,19
1/14/2015 1:00,37,17,20,7,17
1/14/2015 2:00,12,3,9,6,17
1/14/2015 3:00,5,2,3,5,28
1/14/2015 4:00,6,5,1,5,19
1/14/2015 5:00,40,32,8,5,26
1/14/2015 6:00,127,98,29,5,26
1/14/2015 7:00,657,453,204,4,24
1/14/2015 8:00,1199,652,547,4,22
1/14/2015 9:00,944,558,386,5,26
1/14/2015 10:00,900,497,403,5,22
1/14/2015 11:00,765,418,347,4,22
1/14/2015 12:00,787,383,404,3,20
1/14/2015 13:00,820,444,376,3,11
1/14/2015 14:00,869,436,433,5,24
1/14/2015 15:00,911,435,476,5,24
1/14/2015 16:00,957,478,479,4,26
1/14/2015 17:00,993,557,436,3,17
1/14/2015 18:00,960,504,456,3,15
1/14/2015 19:00,855,511,344,4,15
1/14/2015 20:00,612,288,324,3,17
1/14/2015 21:00,349,148,201,3,11
1/14/2015 22:00,358,147,211,3,15
1/14/2015 23:00,251,101,150,3,11
1/15/2015 0:00,147,50,97,3,15
1/15/2015 1:00,117,35,82,4,17
1/15/2015 2:00,59,17,42,4,17
1/15/2015 3:00,53,15,38,5,20
1/15/2015 4:00,23,6,17,6,22
1/15/2015 5:00,43,28,15,6,22
1/15/2015 6:00,93,66,27,6,22
1/15/2015 7:00,510,334,176,7,28
1/15/2015 8:00,903,499,404,8,30
1/15/2015 9:00,663,365,298,8,30
1/15/2015 10:00,671,382,289,8,26
1/15/2015 11:00,713,394,319,9,28
1/15/2015 12:00,861,400,461,9,26
1/15/2015 13:00,773,422,351,9,32
1/15/2015 14:00,738,399,339,9,28
1/15/2015 15:00,837,467,370,9,26
1/15/2015 16:00,857,445,412,9,26
1/15/2015 17:00,910,482,428,9,26
1/15/2015 18:00,790,433,357,9,22
1/15/2015 19:00,648,336,312,9,26
1/15/2015 20:00,428,228,200,9,24
1/15/2015 21:00,362,161,201,9,20
1/15/2015 22:00,297,133,164,8,20
1/15/2015 23:00,151,45,106,7,20
1/16/2015 0:00,120,28,92,7,22
1/16/2015 1:00,73,30,43,7,19
1/16/2015 2:00,25,9,16,7,24
1/16/2015 3:00,25,3,22,7,24
1/16/2015 4:00,26,3,23,6,22
1/16/2015 5:00,43,30,13,6,22
1/16/2015 6:00,114,85,29,6,20
1/16/2015 7:00,526,322,204,5,15
1/16/2015 8:00,818,478,340,5,17
1/16/2015 9:00,717,406,311,5,15
1/16/2015 10:00,808,448,360,6,13
1/16/2015 11:00,798,454,344,7,15
1/16/2015 12:00,844,490,354,7,17
1/16/2015 13:00,848,422,426,8,13
1/16/2015 14:00,824,413,411,8,15
1/16/2015 15:00,794,441,353,7,9
1/16/2015 16:00,828,445,383,6,6
1/16/2015 17:00,774,385,389,6,7
1/16/2015 18:00,742,392,350,6,7
1/16/2015 19:00,699,355,344,6,9
1/16/2015 20:00,490,257,233,5,7
1/16/2015 21:00,372,180,192,3,7
1/16/2015 22:00,300,116,184,4,9
1/16/2015 23:00,276,105,171,2,7
1/17/2015 0:00,249,114,135,4,13
1/17/2015 1:00,216,57,159,4,7
1/17/2015 2:00,139,33,106,2,9
1/17/2015 3:00,112,33,79,2,4
1/17/2015 4:00,65,8,57,3,7
1/17/2015 5:00,47,25,22,1,6
1/17/2015 6:00,33,17,16,0,9
1/17/2015 7:00,63,49,14,1,7
1/17/2015 8:00,155,111,44,-1,4
1/17/2015 9:00,335,234,101,1,7
1/17/2015 10:00,455,325,130,2,7
1/17/2015 11:00,490,330,160,4,11
1/17/2015 12:00,569,373,196,5,17
1/17/2015 13:00,631,354,277,5,15
1/17/2015 14:00,656,309,347,5,15
1/17/2015 15:00,544,263,281,5,15
1/17/2015 16:00,548,263,285,3,9
1/17/2015 17:00,478,200,278,2,9
1/17/2015 18:00,515,280,235,1,6
1/17/2015 19:00,403,207,196,1,9
1/17/2015 20:00,448,215,233,0,9
1/17/2015 21:00,322,138,184,1,9
1/17/2015 22:00,196,93,103,0,9
1/17/2015 23:00,226,93,133,0,11
1/18/2015 0:00,223,92,131,0,9
1/18/2015 1:00,206,69,137,1,11
1/18/2015 2:00,161,39,122,2,13
1/18/2015 3:00,105,23,82,1,11
1/18/2015 4:00,49,18,31,1,13
1/18/2015 5:00,40,11,29,1,11
1/18/2015 6:00,26,17,9,1,13
1/18/2015 7:00,31,18,13,1,13
1/18/2015 8:00,51,32,19,1,11
1/18/2015 9:00,136,110,26,0,11
1/18/2015 10:00,223,176,47,1,13
1/18/2015 11:00,219,116,103,1,7
1/18/2015 12:00,230,96,134,2,11
1/18/2015 13:00,282,111,171,3,13
1/18/2015 14:00,353,186,167,3,11
1/18/2015 15:00,342,186,156,3,9
1/18/2015 16:00,327,162,165,3,9
1/18/2015 17:00,453,271,182,2,7
1/18/2015 18:00,335,171,164,2,6
1/18/2015 19:00,334,146,188,2,7
1/18/2015 20:00,264,104,160,2,7
1/18/2015 21:00,143,61,82,2,9
1/18/2015 22:00,174,57,117,2,9
1/18/2015 23:00,101,39,62,1,9
1/19/2015 0:00,40,15,25,1,7
1/19/2015 1:00,22,9,13,1,6
1/19/2015 2:00,12,3,9,0,6
1/19/2015 3:00,7,5,2,-1,4
1/19/2015 4:00,6,3,3,-1,4
1/19/2015 5:00,35,24,11,-1,4
1/19/2015 6:00,123,97,26,-2,2
1/19/2015 7:00,586,386,200,-2,2
1/19/2015 8:00,1037,629,408,-2,4
1/19/2015 9:00,878,496,382,-1,4
1/19/2015 10:00,865,424,441,-1,4
1/19/2015 11:00,781,442,339,0,2
1/19/2015 12:00,962,493,469,1,0
1/19/2015 13:00,906,474,432,2,4
1/19/2015 14:00,947,489,458,2,2
1/19/2015 15:00,1089,569,520,1,4
1/19/2015 16:00,1090,601,489,1,2
1/19/2015 17:00,1323,635,688,0,2
1/19/2015 18:00,970,432,538,-1,0
1/19/2015 19:00,903,425,478,-1,2
1/19/2015 20:00,593,253,340,-2,4
1/19/2015 21:00,392,178,214,-2,4
1/19/2015 22:00,302,112,190,-1,4
1/19/2015 23:00,151,55,96,-1,2
1/20/2015 0:00,91,30,61,-2,4
1/20/2015 1:00,47,13,34,-1,7
1/20/2015 2:00,13,7,6,0,7
1/20/2015 3:00,8,6,2,-1,4
1/20/2015 4:00,8,5,3,-1,4
1/20/2015 5:00,42,31,11,-1,6
1/20/2015 6:00,143,109,34,0,4
1/20/2015 7:00,679,449,230,0,2
1/20/2015 8:00,1075,617,458,0,4
1/20/2015 9:00,967,533,434,0,2
1/20/2015 10:00,882,481,401,0,6
1/20/2015 11:00,874,470,404,1,7
1/20/2015 12:00,987,528,459,2,9
1/20/2015 13:00,953,535,418,2,6
1/20/2015 14:00,1084,541,543,2,7
1/20/2015 15:00,980,507,473,2,6
1/20/2015 16:00,1097,522,575,0,4
1/20/2015 17:00,1176,619,557,0,6
1/20/2015 18:00,1085,534,551,0,7
1/20/2015 19:00,917,442,475,-1,2
1/20/2015 20:00,558,252,306,-2,4
1/20/2015 21:00,403,157,246,-3,4
1/20/2015 22:00,405,154,251,-3,2
1/20/2015 23:00,190,67,123,-4,2
1/21/2015 0:00,74,31,43,-4,2
1/21/2015 1:00,35,13,22,-5,4
1/21/2015 2:00,15,2,13,-3,4
1/21/2015 3:00,12,5,7,-2,7
1/21/2015 4:00,11,9,2,-2,6
1/21/2015 5:00,30,27,3,-3,6
1/21/2015 6:00,134,90,44,-2,6
1/21/2015 7:00,586,462,124,-3,4
1/21/2015 8:00,1204,674,530,-3,7
1/21/2015 9:00,801,502,299,-2,7
1/21/2015 10:00,985,467,518,-1,7
1/21/2015 11:00,719,431,288,0,6
1/21/2015 12:00,1069,546,523,1,7
1/21/2015 13:00,943,541,402,2,9
1/21/2015 14:00,1019,498,521,2,13
1/21/2015 15:00,863,493,370,2,9
1/21/2015 16:00,1230,498,732,1,9
1/21/2015 17:00,1107,601,506,0,11
1/21/2015 18:00,1261,500,761,0,11
1/21/2015 19:00,883,457,426,-1,11
1/21/2015 20:00,665,268,397,-1,11
1/21/2015 21:00,319,139,180,-1,13
1/21/2015 22:00,552,297,255,-2,11
1/21/2015 23:00,400,195,205,-2,9
1/22/2015 0:00,174,54,120,-2,17
1/22/2015 1:00,89,30,59,-2,13
1/22/2015 2:00,82,10,72,-2,15
1/22/2015 3:00,36,11,25,-2,17
1/22/2015 4:00,27,9,18,-2,15
1/22/2015 5:00,50,29,21,-1,20
1/22/2015 6:00,130,85,45,-1,19
1/22/2015 7:00,641,409,232,-1,20
1/22/2015 8:00,1044,574,470,-1,19
1/22/2015 9:00,761,434,327,-1,17
1/22/2015 10:00,873,474,399,0,19
1/22/2015 11:00,830,473,357,0,17
1/22/2015 12:00,944,412,532,0,11
1/22/2015 13:00,873,471,402,0,9
1/22/2015 14:00,935,509,426,0,13
1/22/2015 15:00,997,517,480,0,15
1/22/2015 16:00,1017,536,481,0,15
1/22/2015 17:00,1163,572,591,0,9
1/22/2015 18:00,1016,521,495,0,11
1/22/2015 19:00,765,376,389,0,7
1/22/2015 20:00,509,230,279,0,15
1/22/2015 21:00,361,158,203,0,15
1/22/2015 22:00,369,133,236,0,11
1/22/2015 23:00,211,58,153,-1,11
1/23/2015 0:00,146,40,106,-1,4
1/23/2015 1:00,66,12,54,0,6
1/23/2015 2:00,26,6,20,0,9
1/23/2015 3:00,24,10,14,-1,11
1/23/2015 4:00,9,5,4,-1,15
1/23/2015 5:00,39,29,10,0,11
1/23/2015 6:00,116,78,38,0,15
1/23/2015 7:00,575,377,198,-1,13
1/23/2015 8:00,878,513,365,-1,11
1/23/2015 9:00,699,388,311,0,7
1/23/2015 10:00,741,427,314,-1,7
1/23/2015 11:00,691,393,298,0,7
1/23/2015 12:00,767,448,319,0,7
1/23/2015 13:00,778,410,368,0,9
1/23/2015 14:00,791,377,414,1,4
1/23/2015 15:00,713,370,343,0,4
1/23/2015 16:00,700,355,345,0,4
1/23/2015 17:00,655,329,326,0,6
1/23/2015 18:00,663,361,302,-1,9
1/23/2015 19:00,630,343,287,-1,11
1/23/2015 20:00,426,221,205,-1,9
1/23/2015 21:00,348,172,176,-1,11
1/23/2015 22:00,335,125,210,-1,11
1/23/2015 23:00,251,98,153,-1,13
1/24/2015 0:00,207,82,125,-1,15
1/24/2015 1:00,193,59,134,-1,13
1/24/2015 2:00,150,32,118,-1,13
1/24/2015 3:00,75,23,52,0,15
1/24/2015 4:00,75,12,63,0,17
1/24/2015 5:00,46,17,29,0,17
1/24/2015 6:00,37,24,13,0,13
1/24/2015 7:00,74,58,16,0,11
1/24/2015 8:00,136,90,46,-1,13
1/24/2015 9:00,274,219,55,-1,11
1/24/2015 10:00,286,215,71,0,9
1/24/2015 11:00,189,126,63,0,9
1/24/2015 12:00,249,126,123,1,7
1/24/2015 13:00,269,134,135,1,6
1/24/2015 14:00,300,149,151,1,7
1/24/2015 15:00,256,132,124,1,6
1/24/2015 16:00,249,117,132,2,9
1/24/2015 17:00,273,135,138,2,11
1/24/2015 18:00,310,121,189,0,9
1/24/2015 19:00,316,137,179,0,7
1/24/2015 20:00,328,155,173,-1,9
1/24/2015 21:00,233,108,125,0,9
1/24/2015 22:00,168,75,93,-1,9
1/24/2015 23:00,176,79,97,-1,7
1/25/2015 0:00,164,76,88,-1,7
1/25/2015 1:00,167,67,100,0,11
1/25/2015 2:00,99,48,51,-1,7
1/25/2015 3:00,61,23,38,-1,9
1/25/2015 4:00,44,16,28,-1,2
1/25/2015 5:00,35,12,23,-2,4
1/25/2015 6:00,29,11,18,-2,2
1/25/2015 7:00,19,14,5,-1,2
1/25/2015 8:00,64,45,19,-1,6
1/25/2015 9:00,202,153,49,0,6
1/25/2015 10:00,197,139,58,2,7
1/25/2015 11:00,161,98,63,2,6
1/25/2015 12:00,210,108,102,3,9
1/25/2015 13:00,207,102,105,3,7
1/25/2015 14:00,254,133,121,3,9
1/25/2015 15:00,292,155,137,3,7
1/25/2015 16:00,250,136,114,3,7
1/25/2015 17:00,261,140,121,3,7
1/25/2015 18:00,262,118,144,2,7
1/25/2015 19:00,281,106,175,2,9
1/25/2015 20:00,214,82,132,2,9
1/25/2015 21:00,129,49,80,2,7
1/25/2015 22:00,133,41,92,2,7
1/25/2015 23:00,69,22,47,2,7
1/26/2015 0:00,38,10,28,3,9
1/26/2015 1:00,31,7,24,3,11
1/26/2015 2:00,11,3,8,3,9
1/26/2015 3:00,7,6,1,3,11
1/26/2015 4:00,13,4,9,3,11
1/26/2015 5:00,31,20,11,3,11
1/26/2015 6:00,98,65,33,3,13
1/26/2015 7:00,518,365,153,3,13
1/26/2015 8:00,815,480,335,3,13
1/26/2015 9:00,590,334,256,3,13
1/26/2015 10:00,716,375,341,3,15
1/26/2015 11:00,499,283,216,4,15
1/26/2015 12:00,604,295,309,4,13
1/26/2015 13:00,686,341,345,4,15
1/26/2015 14:00,696,367,329,4,13
1/26/2015 15:00,846,424,422,5,15
1/26/2015 16:00,883,434,449,5,17
1/26/2015 17:00,930,505,425,6,17
1/26/2015 18:00,847,430,417,6,19
1/26/2015 19:00,702,337,365,5,17
1/26/2015 20:00,469,182,287,5,19
1/26/2015 21:00,337,152,185,4,17
1/26/2015 22:00,303,82,221,4,17
1/26/2015 23:00,135,52,83,3,19
1/27/2015 0:00,54,22,32,4,17
1/27/2015 1:00,29,6,23,2,15
1/27/2015 2:00,12,6,6,3,15
1/27/2015 3:00,9,5,4,2,17
1/27/2015 4:00,12,3,9,3,15
1/27/2015 5:00,42,34,8,2,13
1/27/2015 6:00,112,81,31,2,15
1/27/2015 7:00,630,408,222,2,13
1/27/2015 8:00,957,540,417,2,11
1/27/2015 9:00,863,546,317,3,11
1/27/2015 10:00,778,469,309,4,13
1/27/2015 11:00,802,454,348,5,11
1/27/2015 12:00,843,474,369,6,13
1/27/2015 13:00,855,443,412,6,15
1/27/2015 14:00,916,476,440,6,15
1/27/2015 15:00,932,441,491,6,13
1/27/2015 16:00,939,454,485,5,15
1/27/2015 17:00,1049,569,480,4,6
1/27/2015 18:00,1011,536,475,4,11
1/27/2015 19:00,809,397,412,3,9
1/27/2015 20:00,582,262,320,3,9
1/27/2015 21:00,366,148,218,3,7
1/27/2015 22:00,366,132,234,3,7
1/27/2015 23:00,190,78,112,4,9
1/28/2015 0:00,76,19,57,3,9
1/28/2015 1:00,48,15,33,4,11
1/28/2015 2:00,17,5,12,3,11
1/28/2015 3:00,9,4,5,3,11
1/28/2015 4:00,16,7,9,4,15
1/28/2015 5:00,41,29,12,4,13
1/28/2015 6:00,123,89,34,4,19
1/28/2015 7:00,647,431,216,4,17
1/28/2015 8:00,1071,669,402,4,17
1/28/2015 9:00,818,498,320,5,19
1/28/2015 10:00,824,465,359,5,26
1/28/2015 11:00,783,459,324,6,26
1/28/2015 12:00,934,505,429,6,32
1/28/2015 13:00,819,444,375,6,28
1/28/2015 14:00,934,452,482,6,30
1/28/2015 15:00,826,419,407,5,28
1/28/2015 16:00,820,423,397,5,32
1/28/2015 17:00,752,367,385,5,28
1/28/2015 18:00,650,297,353,3,39
1/28/2015 19:00,564,282,282,3,19
1/28/2015 20:00,406,150,256,3,32
1/28/2015 21:00,276,147,129,3,22
1/28/2015 22:00,295,116,179,3,28
1/28/2015 23:00,197,80,117,3,32
1/29/2015 0:00,116,58,58,3,30
1/29/2015 1:00,79,35,44,3,28
1/29/2015 2:00,34,9,25,2,22
1/29/2015 3:00,48,13,35,2,20
1/29/2015 4:00,19,9,10,2,22
1/29/2015 5:00,43,28,15,2,28
1/29/2015 6:00,99,68,31,2,24
1/29/2015 7:00,571,362,209,1,22
1/29/2015 8:00,856,526,330,1,22
1/29/2015 9:00,562,346,216,1,19
1/29/2015 10:00,546,302,244,1,24
1/29/2015 11:00,520,257,263,2,22
1/29/2015 12:00,601,282,319,3,17
1/29/2015 13:00,717,384,333,4,24
1/29/2015 14:00,652,345,307,4,19
1/29/2015 15:00,756,386,370,4,17
1/29/2015 16:00,803,434,369,4,20
1/29/2015 17:00,844,448,396,2,11
1/29/2015 18:00,756,393,363,2,11
1/29/2015 19:00,704,329,375,0,4
1/29/2015 20:00,532,238,294,1,6
1/29/2015 21:00,323,149,174,1,6
1/29/2015 22:00,271,97,174,1,6
1/29/2015 23:00,182,63,119,1,11
1/30/2015 0:00,139,48,91,1,7
1/30/2015 1:00,57,15,42,1,7
1/30/2015 2:00,25,12,13,1,9
1/30/2015 3:00,21,8,13,1,7
1/30/2015 4:00,13,4,9,0,13
1/30/2015 5:00,33,24,9,0,9
1/30/2015 6:00,72,54,18,0,15
1/30/2015 7:00,326,254,72,0,17
1/30/2015 8:00,592,366,226,0,20
1/30/2015 9:00,400,252,148,0,19
1/30/2015 10:00,517,272,245,1,19
1/30/2015 11:00,488,290,198,1,13
1/30/2015 12:00,618,370,248,1,17
1/30/2015 13:00,497,284,213,1,13
1/30/2015 14:00,526,273,253,1,15
1/30/2015 15:00,553,304,249,1,9
1/30/2015 16:00,529,261,268,2,13
1/30/2015 17:00,586,343,243,2,13
1/30/2015 18:00,573,300,273,1,11
1/30/2015 19:00,496,244,252,1,11
1/30/2015 20:00,412,214,198,1,11
1/30/2015 21:00,301,133,168,1,11
1/30/2015 22:00,220,82,138,1,11
1/30/2015 23:00,246,99,147,1,9
1/31/2015 0:00,176,64,112,1,13
1/31/2015 1:00,148,48,100,0,11
1/31/2015 2:00,89,24,65,0,7
1/31/2015 3:00,51,12,39,1,15
1/31/2015 4:00,45,12,33,2,17
1/31/2015 5:00,36,20,16,1,19
1/31/2015 6:00,22,10,12,2,19
1/31/2015 7:00,95,54,41,2,19
1/31/2015 8:00,165,122,43,2,17
1/31/2015 9:00,321,255,66,2,15
1/31/2015 10:00,417,317,100,2,13
1/31/2015 11:00,393,250,143,2,11
1/31/2015 12:00,413,245,168,2,13
1/31/2015 13:00,428,250,178,3,11
1/31/2015 14:00,498,262,236,3,13
1/31/2015 15:00,413,204,209,3,9
1/31/2015 16:00,379,182,197,3,9
1/31/2015 17:00,425,193,232,1,6
1/31/2015 18:00,370,175,195,2,7
1/31/2015 19:00,407,208,199,1,6
1/31/2015 20:00,408,185,223,2,9
1/31/2015 21:00,232,132,100,1,9
1/31/2015 22:00,207,75,132,0,6
1/31/2015 23:00,212,64,148,1,7
2/1/2015 0:00,194,78,116,1,7
2/1/2015 1:00,151,43,108,1,7
2/1/2015 2:00,123,43,80,1,7
2/1/2015 3:00,88,27,61,1,11
2/1/2015 4:00,56,12,44,1,7
2/1/2015 5:00,47,22,25,1,11
2/1/2015 6:00,24,14,10,1,7
2/1/2015 7:00,24,16,8,1,7
2/1/2015 8:00,92,63,29,1,7
2/1/2015 9:00,182,155,27,2,11
2/1/2015 10:00,239,182,57,2,9
2/1/2015 11:00,213,132,81,2,9
2/1/2015 12:00,267,147,120,2,7
2/1/2015 13:00,282,145,137,2,9
2/1/2015 14:00,259,145,114,2,6
2/1/2015 15:00,268,150,118,2,7
2/1/2015 16:00,341,149,192,2,9
2/1/2015 17:00,339,168,171,2,9
2/1/2015 18:00,293,109,184,2,9
2/1/2015 19:00,328,118,210,1,11
2/1/2015 20:00,254,98,156,1,9
2/1/2015 21:00,159,64,95,1,13
2/1/2015 22:00,152,69,83,1,13
2/1/2015 23:00,114,53,61,1,15
2/2/2015 0:00,57,13,44,1,11
2/2/2015 1:00,23,11,12,1,7
2/2/2015 2:00,24,11,13,0,7
2/2/2015 3:00,22,16,6,1,11
2/2/2015 4:00,79,41,38,1,15
2/2/2015 5:00,40,25,15,1,11
2/2/2015 6:00,111,80,31,1,15
2/2/2015 7:00,587,367,220,1,17
2/2/2015 8:00,745,460,285,1,15
2/2/2015 9:00,697,416,281,1,19
2/2/2015 10:00,670,398,272,2,19
2/2/2015 11:00,628,301,327,2,19
2/2/2015 12:00,686,382,304,2,19
2/2/2015 13:00,765,383,382,2,17
2/2/2015 14:00,651,336,315,2,19
2/2/2015 15:00,874,517,357,3,17
2/2/2015 16:00,929,507,422,2,15
2/2/2015 17:00,1078,486,592,1,15
2/2/2015 18:00,776,343,433,2,15
2/2/2015 19:00,714,338,376,2,19
2/2/2015 20:00,413,192,221,1,13
2/2/2015 21:00,354,151,203,1,13
2/2/2015 22:00,264,100,164,1,17
2/2/2015 23:00,144,48,96,1,15
2/3/2015 0:00,94,29,65,1,17
2/3/2015 1:00,32,9,23,1,17
2/3/2015 2:00,21,10,11,1,15
2/3/2015 3:00,11,7,4,1,15
2/3/2015 4:00,13,9,4,1,17
2/3/2015 5:00,35,24,11,1,17
2/3/2015 6:00,118,77,41,1,17
2/3/2015 7:00,647,450,197,1,19
2/3/2015 8:00,794,496,298,1,19
2/3/2015 9:00,838,517,321,1,11
2/3/2015 10:00,604,366,238,2,15
2/3/2015 11:00,625,315,310,2,11
2/3/2015 12:00,657,353,304,2,9
2/3/2015 13:00,726,430,296,3,11
2/3/2015 14:00,798,419,379,3,11
2/3/2015 15:00,768,382,386,3,15
2/3/2015 16:00,820,387,433,3,13
2/3/2015 17:00,1062,572,490,0,11
2/3/2015 18:00,817,371,446,1,7
2/3/2015 19:00,714,322,392,0,7
2/3/2015 20:00,484,204,280,0,13
2/3/2015 21:00,347,124,223,0,9
2/3/2015 22:00,302,111,191,0,9
2/3/2015 23:00,163,65,98,-1,9
2/4/2015 0:00,90,15,75,-1,6
2/4/2015 1:00,56,13,43,-3,4
2/4/2015 2:00,15,2,13,-3,6
2/4/2015 3:00,16,8,8,-4,6
2/4/2015 4:00,11,3,8,-4,2
2/4/2015 5:00,31,23,8,-4,2
2/4/2015 6:00,105,79,26,-5,4
2/4/2015 7:00,564,362,202,-5,2
2/4/2015 8:00,782,468,314,-4,2
2/4/2015 9:00,738,438,300,-2,2
2/4/2015 10:00,615,348,267,-1,4
2/4/2015 11:00,608,313,295,2,2
2/4/2015 12:00,711,435,276,2,7
2/4/2015 13:00,720,430,290,3,13
2/4/2015 14:00,743,412,331,3,11
2/4/2015 15:00,801,427,374,2,9
2/4/2015 16:00,839,451,388,1,7
2/4/2015 17:00,941,495,446,-1,7
2/4/2015 18:00,866,406,460,-1,4
2/4/2015 19:00,872,443,429,-2,4
2/4/2015 20:00,551,224,327,-2,4
2/4/2015 21:00,480,176,304,-2,6
2/4/2015 22:00,452,193,259,-2,7
2/4/2015 23:00,329,154,175,-3,6
2/5/2015 0:00,217,108,109,-2,6
2/5/2015 1:00,159,93,66,-2,4
2/5/2015 2:00,114,60,54,-3,6
2/5/2015 3:00,109,50,59,-3,4
2/5/2015 4:00,75,57,18,-2,2
2/5/2015 5:00,56,44,12,-2,6
2/5/2015 6:00,130,88,42,-2,4
2/5/2015 7:00,576,394,182,-2,4
2/5/2015 8:00,774,493,281,-1,4
2/5/2015 9:00,674,424,250,-1,9
2/5/2015 10:00,626,333,293,-1,17
2/5/2015 11:00,689,373,316,0,13
2/5/2015 12:00,657,353,304,0,15
2/5/2015 13:00,753,400,353,0,17
2/5/2015 14:00,788,387,401,0,15
2/5/2015 15:00,810,437,373,0,17
2/5/2015 16:00,951,497,454,0,19
2/5/2015 17:00,966,520,446,0,15
2/5/2015 18:00,811,392,419,0,17
2/5/2015 19:00,644,289,355,0,19
2/5/2015 20:00,493,215,278,-1,15
2/5/2015 21:00,398,185,213,-1,15
2/5/2015 22:00,294,131,163,-2,17
2/5/2015 23:00,192,77,115,-2,17
2/6/2015 0:00,151,64,87,-3,13
2/6/2015 1:00,52,15,37,-4,11
2/6/2015 2:00,56,6,50,-3,15
2/6/2015 3:00,54,8,46,-3,17
2/6/2015 4:00,35,6,29,-3,20
2/6/2015 5:00,44,21,23,-3,19
2/6/2015 6:00,96,67,29,-3,7
2/6/2015 7:00,543,344,199,-3,13
2/6/2015 8:00,732,477,255,-3,17
2/6/2015 9:00,572,355,217,-2,15
2/6/2015 10:00,593,370,223,-1,20
2/6/2015 11:00,544,271,273,0,22
2/6/2015 12:00,602,321,281,0,26
2/6/2015 13:00,746,419,327,1,22
2/6/2015 14:00,725,372,353,1,26
2/6/2015 15:00,743,405,338,2,20
2/6/2015 16:00,748,352,396,1,20
2/6/2015 17:00,796,374,422,0,20
2/6/2015 18:00,703,312,391,0,15
2/6/2015 19:00,668,347,321,-1,13
2/6/2015 20:00,619,247,372,-2,9
2/6/2015 21:00,450,191,259,-2,9
2/6/2015 22:00,333,159,174,-2,2
2/6/2015 23:00,412,229,183,-4,7
2/7/2015 0:00,272,142,130,-4,6
2/7/2015 1:00,175,85,90,-4,2
2/7/2015 2:00,137,43,94,-4,6
2/7/2015 3:00,128,49,79,-4,4
2/7/2015 4:00,88,39,49,-5,6
2/7/2015 5:00,64,21,43,-6,2
2/7/2015 6:00,31,9,22,-7,4
2/7/2015 7:00,79,57,22,-6,4
2/7/2015 8:00,230,182,48,-5,2
2/7/2015 9:00,364,270,94,-2,6
2/7/2015 10:00,468,309,159,-1,6
2/7/2015 11:00,423,259,164,1,6
2/7/2015 12:00,509,331,178,1,9
2/7/2015 13:00,537,310,227,2,17
2/7/2015 14:00,460,205,255,2,13
2/7/2015 15:00,442,186,256,2,13
2/7/2015 16:00,466,195,271,2,11
2/7/2015 17:00,435,156,279,3,11
2/7/2015 18:00,437,211,226,3,11
2/7/2015 19:00,401,180,221,4,15
2/7/2015 20:00,349,168,181,4,13
2/7/2015 21:00,259,116,143,4,15
2/7/2015 22:00,187,95,92,4,19
2/7/2015 23:00,211,101,110,4,19
2/8/2015 0:00,165,79,86,4,15
2/8/2015 1:00,149,60,89,4,17
2/8/2015 2:00,102,27,75,3,22
2/8/2015 3:00,72,26,46,4,22
2/8/2015 4:00,49,15,34,4,22
2/8/2015 5:00,31,15,16,3,20
2/8/2015 6:00,20,9,11,3,20
2/8/2015 7:00,27,14,13,2,20
2/8/2015 8:00,72,61,11,3,17
2/8/2015 9:00,243,200,43,3,15
2/8/2015 10:00,266,176,90,4,19
2/8/2015 11:00,233,138,95,4,20
2/8/2015 12:00,334,153,181,4,19
2/8/2015 13:00,324,147,177,4,13
2/8/2015 14:00,440,230,210,5,17
2/8/2015 15:00,415,236,179,4,13
2/8/2015 16:00,408,196,212,4,15
2/8/2015 17:00,441,251,190,3,9
2/8/2015 18:00,401,228,173,2,9
2/8/2015 19:00,366,162,204,1,7
2/8/2015 20:00,266,91,175,2,9
2/8/2015 21:00,144,54,90,3,11
2/8/2015 22:00,156,44,112,2,13
2/8/2015 23:00,93,45,48,3,9
2/9/2015 0:00,48,28,20,4,13
2/9/2015 1:00,24,11,13,4,13
2/9/2015 2:00,11,3,8,4,15
2/9/2015 3:00,12,9,3,4,17
2/9/2015 4:00,12,6,6,4,19
2/9/2015 5:00,44,33,11,4,15
2/9/2015 6:00,108,80,28,4,17
2/9/2015 7:00,535,385,150,5,15
2/9/2015 8:00,808,535,273,5,15
2/9/2015 9:00,557,330,227,5,17
2/9/2015 10:00,451,241,210,6,19
2/9/2015 11:00,489,280,209,6,20
2/9/2015 12:00,557,277,280,6,19
2/9/2015 13:00,633,348,285,6,15
2/9/2015 14:00,580,305,275,6,19
2/9/2015 15:00,623,319,304,6,15
2/9/2015 16:00,697,326,371,6,15
2/9/2015 17:00,766,393,373,6,13
2/9/2015 18:00,692,340,352,6,15
2/9/2015 19:00,550,254,296,6,13
2/9/2015 20:00,376,164,212,6,11
2/9/2015 21:00,254,81,173,6,13
2/9/2015 22:00,196,70,126,6,11
2/9/2015 23:00,159,45,114,6,11
2/10/2015 0:00,99,28,71,5,11
2/10/2015 1:00,38,10,28,5,13
2/10/2015 2:00,19,10,9,5,11
2/10/2015 3:00,7,5,2,5,9
2/10/2015 4:00,8,2,6,5,9
2/10/2015 5:00,39,25,14,5,9
2/10/2015 6:00,115,81,34,5,11
2/10/2015 7:00,614,413,201,5,9
2/10/2015 8:00,752,509,243,5,6
2/10/2015 9:00,668,403,265,5,9
2/10/2015 10:00,463,262,201,6,9
2/10/2015 11:00,512,255,257,6,11
2/10/2015 12:00,548,299,249,6,9
2/10/2015 13:00,610,314,296,6,7
2/10/2015 14:00,611,311,300,6,6
2/10/2015 15:00,655,329,326,6,6
2/10/2015 16:00,706,363,343,6,11
2/10/2015 17:00,930,499,431,6,6
2/10/2015 18:00,810,368,442,5,7
2/10/2015 19:00,593,260,333,5,4
2/10/2015 20:00,493,214,279,5,6
2/10/2015 21:00,291,94,197,5,7
2/10/2015 22:00,266,108,158,5,2
2/10/2015 23:00,180,60,120,4,2
2/11/2015 0:00,97,25,72,4,2
2/11/2015 1:00,65,12,53,5,6
2/11/2015 2:00,34,11,23,5,4
2/11/2015 3:00,17,5,12,5,4
2/11/2015 4:00,16,7,9,4,7
2/11/2015 5:00,49,31,18,4,7
2/11/2015 6:00,107,79,28,4,6
2/11/2015 7:00,617,433,184,4,9
2/11/2015 8:00,815,553,262,4,13
2/11/2015 9:00,640,416,224,4,7
2/11/2015 10:00,561,341,220,4,7
2/11/2015 11:00,542,312,230,4,9
2/11/2015 12:00,621,317,304,4,9
2/11/2015 13:00,691,360,331,4,7
2/11/2015 14:00,648,317,331,4,6
2/11/2015 15:00,609,322,287,4,9
2/11/2015 16:00,715,369,346,4,6
2/11/2015 17:00,869,435,434,4,4
2/11/2015 18:00,811,366,445,2,4
2/11/2015 19:00,683,330,353,0,2
2/11/2015 20:00,451,202,249,-1,4
2/11/2015 21:00,283,121,162,0,4
2/11/2015 22:00,287,100,187,-2,4
2/11/2015 23:00,227,89,138,-2,4
2/12/2015 0:00,135,56,79,-3,2
2/12/2015 1:00,93,31,62,-3,2
2/12/2015 2:00,72,19,53,-3,2
2/12/2015 3:00,47,18,29,-3,2
2/12/2015 4:00,35,12,23,-2,2
2/12/2015 5:00,56,33,23,-1,2
2/12/2015 6:00,112,78,34,-1,6
2/12/2015 7:00,561,390,171,-1,6
2/12/2015 8:00,721,458,263,-1,6
2/12/2015 9:00,595,365,230,-1,6
2/12/2015 10:00,479,320,159,0,6
2/12/2015 11:00,490,284,206,0,4
2/12/2015 12:00,516,281,235,1,7
2/12/2015 13:00,636,355,281,2,7
2/12/2015 14:00,635,345,290,2,6
2/12/2015 15:00,633,325,308,2,6
2/12/2015 16:00,792,422,370,2,6
2/12/2015 17:00,764,432,332,2,6
2/12/2015 18:00,675,307,368,2,4
2/12/2015 19:00,525,246,279,2,6
2/12/2015 20:00,447,230,217,1,6
2/12/2015 21:00,330,150,180,1,7
2/12/2015 22:00,277,100,177,0,6
2/12/2015 23:00,198,72,126,0,7
2/13/2015 0:00,171,55,116,-1,7
2/13/2015 1:00,134,35,99,-1,7
2/13/2015 2:00,83,13,70,-1,6
2/13/2015 3:00,52,6,46,-1,6
2/13/2015 4:00,21,3,18,-2,6
2/13/2015 5:00,45,28,17,-2,6
2/13/2015 6:00,90,57,33,-2,6
2/13/2015 7:00,478,312,166,-2,6
2/13/2015 8:00,664,430,234,-1,7
2/13/2015 9:00,516,332,184,0,6
2/13/2015 10:00,506,310,196,2,7
2/13/2015 11:00,510,255,255,4,7
2/13/2015 12:00,593,329,264,6,7
2/13/2015 13:00,704,380,324,8,9
2/13/2015 14:00,721,373,348,9,7
2/13/2015 15:00,677,403,274,9,11
2/13/2015 16:00,722,401,321,8,11
2/13/2015 17:00,691,328,363,6,9
2/13/2015 18:00,549,271,278,5,7
2/13/2015 19:00,511,245,266,4,11
2/13/2015 20:00,469,217,252,3,7
2/13/2015 21:00,264,124,140,2,11
2/13/2015 22:00,247,98,149,2,7
2/13/2015 23:00,200,82,118,2,11
2/14/2015 0:00,205,98,107,2,9
2/14/2015 1:00,210,94,116,2,9
2/14/2015 2:00,88,31,57,2,9
2/14/2015 3:00,74,23,51,3,7
2/14/2015 4:00,80,25,55,3,11
2/14/2015 5:00,80,28,52,3,9
2/14/2015 6:00,36,23,13,2,9
2/14/2015 7:00,90,53,37,2,9
2/14/2015 8:00,224,174,50,3,11
2/14/2015 9:00,316,252,64,4,13
2/14/2015 10:00,400,308,92,6,9
2/14/2015 11:00,424,259,165,8,11
2/14/2015 12:00,456,269,187,9,11
2/14/2015 13:00,485,270,215,10,9
2/14/2015 14:00,472,220,252,11,13
2/14/2015 15:00,431,230,201,10,15
2/14/2015 16:00,396,187,209,10,13
2/14/2015 17:00,423,203,220,8,11
2/14/2015 18:00,407,196,211,7,13
2/14/2015 19:00,342,151,191,6,7
2/14/2015 20:00,309,127,182,6,6
2/14/2015 21:00,230,116,114,5,6
2/14/2015 22:00,200,87,113,3,2
2/14/2015 23:00,140,59,81,3,6
2/15/2015 0:00,151,64,87,2,2
2/15/2015 1:00,122,58,64,1,7
2/15/2015 2:00,131,55,76,1,9
2/15/2015 3:00,79,43,36,1,9
2/15/2015 4:00,50,23,27,1,13
2/15/2015 5:00,41,12,29,0,15
2/15/2015 6:00,23,8,15,1,11
2/15/2015 7:00,28,22,6,0,13
2/15/2015 8:00,56,37,19,0,19
2/15/2015 9:00,208,157,51,0,22
2/15/2015 10:00,257,185,72,1,20
2/15/2015 11:00,212,133,79,2,19
2/15/2015 12:00,260,153,107,3,20
2/15/2015 13:00,306,169,137,3,19
2/15/2015 14:00,383,228,155,3,17
2/15/2015 15:00,346,183,163,3,19
2/15/2015 16:00,319,150,169,3,15
2/15/2015 17:00,365,172,193,2,15
2/15/2015 18:00,290,122,168,1,13
2/15/2015 19:00,286,125,161,1,11
2/15/2015 20:00,207,67,140,2,15
2/15/2015 21:00,124,49,75,1,11
2/15/2015 22:00,118,44,74,1,9
2/15/2015 23:00,86,40,46,1,11
2/16/2015 0:00,46,14,32,2,11
2/16/2015 1:00,38,18,20,1,6
2/16/2015 2:00,17,3,14,1,6
2/16/2015 3:00,8,6,2,-1,6
2/16/2015 4:00,6,3,3,0,6
2/16/2015 5:00,35,24,11,0,6
2/16/2015 6:00,65,49,16,-1,4
2/16/2015 7:00,182,126,56,-1,6
2/16/2015 8:00,250,130,120,0,6
2/16/2015 9:00,282,190,92,1,6
2/16/2015 10:00,282,171,111,3,7
2/16/2015 11:00,432,272,160,4,7
2/16/2015 12:00,624,485,139,6,7
2/16/2015 13:00,567,349,218,7,6
2/16/2015 14:00,713,307,406,8,7
2/16/2015 15:00,530,251,279,8,9
2/16/2015 16:00,525,205,320,7,6
2/16/2015 17:00,430,163,267,5,2
2/16/2015 18:00,417,158,259,2,2
2/16/2015 19:00,293,111,182,0,2
2/16/2015 20:00,233,101,132,-1,4
2/16/2015 21:00,136,48,88,0,4
2/16/2015 22:00,156,57,99,-2,2
2/16/2015 23:00,107,27,80,0,4
2/17/2015 0:00,63,25,38,-2,6
2/17/2015 1:00,27,7,20,-3,6
2/17/2015 2:00,15,6,9,-3,4
2/17/2015 3:00,8,4,4,-3,4
2/17/2015 4:00,6,3,3,-3,2
2/17/2015 5:00,55,35,20,0,4
2/17/2015 6:00,130,94,36,0,2
2/17/2015 7:00,418,264,154,0,2
2/17/2015 8:00,698,484,214,1,6
2/17/2015 9:00,512,326,186,1,9
2/17/2015 10:00,402,222,180,1,11
2/17/2015 11:00,489,286,203,2,9
2/17/2015 12:00,511,288,223,3,6
2/17/2015 13:00,509,263,246,3,6
2/17/2015 14:00,521,279,242,3,6
2/17/2015 15:00,549,283,266,4,6
2/17/2015 16:00,673,341,332,4,6
2/17/2015 17:00,804,345,459,4,6
2/17/2015 18:00,658,307,351,4,6
2/17/2015 19:00,532,263,269,4,2
2/17/2015 20:00,381,186,195,3,4
2/17/2015 21:00,240,102,138,2,2
2/17/2015 22:00,266,91,175,-1,2
2/17/2015 23:00,140,46,94,-1,2
2/18/2015 0:00,61,18,43,-1,4
2/18/2015 1:00,34,4,30,-1,4
2/18/2015 2:00,10,2,8,-1,0
2/18/2015 3:00,7,6,1,-1,7
2/18/2015 4:00,6,2,4,-1,6
2/18/2015 5:00,43,30,13,0,6
2/18/2015 6:00,143,106,37,0,7
2/18/2015 7:00,567,403,164,0,9
2/18/2015 8:00,781,521,260,0,7
2/18/2015 9:00,535,333,202,1,7
2/18/2015 10:00,565,344,221,1,7
2/18/2015 11:00,470,260,210,2,9
2/18/2015 12:00,595,320,275,3,11
2/18/2015 13:00,592,286,306,5,13
2/18/2015 14:00,631,339,292,5,13
2/18/2015 15:00,621,294,327,4,13
2/18/2015 16:00,689,347,342,4,11
2/18/2015 17:00,841,434,407,3,6
2/18/2015 18:00,796,398,398,1,6
2/18/2015 19:00,638,323,315,1,6
2/18/2015 20:00,432,164,268,1,9
2/18/2015 21:00,276,130,146,1,6
2/18/2015 22:00,318,112,206,0,7
2/18/2015 23:00,218,79,139,0,7
2/19/2015 0:00,109,43,66,1,9
2/19/2015 1:00,68,21,47,2,11
2/19/2015 2:00,35,12,23,1,7
2/19/2015 3:00,27,6,21,0,6
2/19/2015 4:00,25,7,18,-1,7
2/19/2015 5:00,61,33,28,1,13
2/19/2015 6:00,134,102,32,1,9
2/19/2015 7:00,579,405,174,1,11
2/19/2015 8:00,767,488,279,2,17
2/19/2015 9:00,600,376,224,2,17
2/19/2015 10:00,492,281,211,3,19
2/19/2015 11:00,456,261,195,3,13
2/19/2015 12:00,537,292,245,3,19
2/19/2015 13:00,604,315,289,3,20
2/19/2015 14:00,600,308,292,3,17
2/19/2015 15:00,613,322,291,4,15
2/19/2015 16:00,697,357,340,4,15
2/19/2015 17:00,859,417,442,3,11
2/19/2015 18:00,768,374,394,3,13
2/19/2015 19:00,594,284,310,2,15
2/19/2015 20:00,411,188,223,1,15
2/19/2015 21:00,239,96,143,2,15
2/19/2015 22:00,268,92,176,2,19
2/19/2015 23:00,171,60,111,2,19
2/20/2015 0:00,99,26,73,2,19
2/20/2015 1:00,55,14,41,2,19
2/20/2015 2:00,25,7,18,2,15
2/20/2015 3:00,12,8,4,2,17
2/20/2015 4:00,11,3,8,3,17
2/20/2015 5:00,33,23,10,3,19
2/20/2015 6:00,126,96,30,3,19
2/20/2015 7:00,515,355,160,4,17
2/20/2015 8:00,637,410,227,5,20
2/20/2015 9:00,492,305,187,5,20
2/20/2015 10:00,432,273,159,6,20
2/20/2015 11:00,441,230,211,6,20
2/20/2015 12:00,500,269,231,7,20
2/20/2015 13:00,556,271,285,7,22
2/20/2015 14:00,547,242,305,6,17
2/20/2015 15:00,545,282,263,6,13
2/20/2015 16:00,514,260,254,6,13
2/20/2015 17:00,439,199,240,6,11
2/20/2015 18:00,471,194,277,6,11
2/20/2015 19:00,352,187,165,6,11
2/20/2015 20:00,314,187,127,6,11
2/20/2015 21:00,206,96,110,6,11
2/20/2015 22:00,182,67,115,6,11
2/20/2015 23:00,174,64,110,6,13
2/21/2015 0:00,122,34,88,6,15
2/21/2015 1:00,122,39,83,6,13
2/21/2015 2:00,74,20,54,6,11
2/21/2015 3:00,66,20,46,6,13
2/21/2015 4:00,27,7,20,6,13
2/21/2015 5:00,34,12,22,6,17
2/21/2015 6:00,35,21,14,6,19
2/21/2015 7:00,55,41,14,3,26
2/21/2015 8:00,114,84,30,2,22
2/21/2015 9:00,297,221,76,3,17
2/21/2015 10:00,360,263,97,4,19
2/21/2015 11:00,350,253,97,5,19
2/21/2015 12:00,428,295,133,5,22
2/21/2015 13:00,388,190,198,4,11
2/21/2015 14:00,395,219,176,5,19
2/21/2015 15:00,299,146,153,3,24
2/21/2015 16:00,329,124,205,4,17
2/21/2015 17:00,339,137,202,4,13
2/21/2015 18:00,367,181,186,3,7
2/21/2015 19:00,300,163,137,3,13
2/21/2015 20:00,325,156,169,1,9
2/21/2015 21:00,210,104,106,0,6
2/21/2015 22:00,167,87,80,0,6
2/21/2015 23:00,174,70,104,-1,4
2/22/2015 0:00,164,80,84,-1,4
2/22/2015 1:00,133,47,86,-2,4
2/22/2015 2:00,95,29,66,-2,4
2/22/2015 3:00,89,19,70,-3,4
2/22/2015 4:00,29,11,18,0,6
2/22/2015 5:00,32,11,21,0,9
2/22/2015 6:00,24,11,13,1,6
2/22/2015 7:00,23,13,10,0,7
2/22/2015 8:00,64,43,21,1,11
2/22/2015 9:00,178,120,58,1,9
2/22/2015 10:00,228,160,68,3,9
2/22/2015 11:00,194,109,85,4,11
2/22/2015 12:00,260,145,115,5,15
2/22/2015 13:00,319,182,137,6,15
2/22/2015 14:00,317,189,128,5,17
2/22/2015 15:00,367,220,147,5,15
2/22/2015 16:00,384,210,174,5,13
2/22/2015 17:00,320,160,160,4,7
2/22/2015 18:00,280,131,149,2,7
2/22/2015 19:00,300,132,168,2,9
2/22/2015 20:00,168,53,115,3,15
2/22/2015 21:00,86,33,53,3,20
2/22/2015 22:00,134,43,91,3,17
2/22/2015 23:00,71,29,42,4,20
2/23/2015 0:00,45,19,26,4,22
2/23/2015 1:00,18,7,11,4,28
2/23/2015 2:00,12,5,7,3,30
2/23/2015 3:00,8,2,6,2,26
2/23/2015 4:00,3,0,3,2,20
2/23/2015 5:00,35,26,9,2,22
2/23/2015 6:00,111,83,28,3,20
2/23/2015 7:00,468,331,137,3,20
2/23/2015 8:00,621,403,218,3,22
2/23/2015 9:00,452,276,176,3,19
2/23/2015 10:00,346,216,130,3,15
2/23/2015 11:00,369,182,187,3,15
2/23/2015 12:00,458,256,202,4,13
2/23/2015 13:00,539,273,266,5,17
2/23/2015 14:00,497,249,248,6,22
2/23/2015 15:00,529,250,279,7,17
2/23/2015 16:00,645,338,307,6,13
2/23/2015 17:00,813,392,421,6,9
2/23/2015 18:00,692,325,367,3,6
2/23/2015 19:00,520,260,260,5,13
2/23/2015 20:00,356,166,190,4,19
2/23/2015 21:00,270,114,156,4,13
2/23/2015 22:00,211,80,131,3,11
2/23/2015 23:00,135,61,74,4,13
2/24/2015 0:00,69,19,50,4,17
2/24/2015 1:00,58,9,49,4,17
2/24/2015 2:00,33,16,17,4,15
2/24/2015 3:00,18,3,15,3,15
2/24/2015 4:00,10,4,6,3,17
2/24/2015 5:00,39,27,12,3,19
2/24/2015 6:00,128,90,38,3,20
2/24/2015 7:00,542,369,173,3,22
2/24/2015 8:00,750,502,248,4,22
2/24/2015 9:00,499,328,171,4,22
2/24/2015 10:00,498,266,232,5,24
2/24/2015 11:00,407,215,192,6,24
2/24/2015 12:00,494,252,242,6,19
2/24/2015 13:00,573,270,303,7,19
2/24/2015 14:00,543,269,274,6,19
2/24/2015 15:00,556,265,291,7,20
2/24/2015 16:00,661,327,334,5,17
2/24/2015 17:00,778,372,406,6,11
2/24/2015 18:00,766,358,408,5,13
2/24/2015 19:00,599,318,281,5,15
2/24/2015 20:00,448,216,232,4,15
2/24/2015 21:00,264,134,130,4,9
2/24/2015 22:00,318,110,208,4,9
2/24/2015 23:00,177,57,120,3,4
2/25/2015 0:00,85,38,47,4,13
2/25/2015 1:00,66,16,50,3,7
2/25/2015 2:00,20,5,15,3,15
2/25/2015 3:00,16,7,9,3,13
2/25/2015 4:00,22,7,15,2,9
2/25/2015 5:00,41,29,12,2,9
2/25/2015 6:00,117,90,27,1,9
2/25/2015 7:00,558,386,172,1,7
2/25/2015 8:00,703,451,252,2,11
2/25/2015 9:00,638,400,238,4,15
2/25/2015 10:00,484,292,192,5,15
2/25/2015 11:00,489,291,198,6,13
2/25/2015 12:00,557,314,243,6,17
2/25/2015 13:00,590,286,304,7,13
2/25/2015 14:00,582,293,289,8,13
2/25/2015 15:00,623,310,313,8,13
2/25/2015 16:00,652,319,333,8,15
2/25/2015 17:00,825,426,399,6,19
2/25/2015 18:00,738,359,379,6,13
2/25/2015 19:00,621,322,299,5,7
2/25/2015 20:00,466,227,239,5,6
2/25/2015 21:00,296,157,139,5,9
2/25/2015 22:00,304,124,180,5,9
2/25/2015 23:00,220,114,106,5,7
2/26/2015 0:00,149,57,92,5,6
2/26/2015 1:00,87,17,70,5,6
2/26/2015 2:00,60,7,53,5,7
2/26/2015 3:00,74,22,52,5,6
2/26/2015 4:00,67,12,55,4,4
2/26/2015 5:00,58,29,29,4,7
2/26/2015 6:00,154,109,45,4,9
2/26/2015 7:00,588,406,182,3,9
2/26/2015 8:00,727,468,259,4,11
2/26/2015 9:00,587,357,230,5,13
2/26/2015 10:00,447,260,187,7,13
2/26/2015 11:00,442,246,196,8,15
2/26/2015 12:00,494,273,221,9,19
2/26/2015 13:00,558,293,265,9,22
2/26/2015 14:00,631,330,301,9,19
2/26/2015 15:00,714,372,342,9,20
2/26/2015 16:00,739,359,380,9,17
2/26/2015 17:00,827,375,452,9,15
2/26/2015 18:00,748,347,401,8,19
2/26/2015 19:00,601,283,318,8,15
2/26/2015 20:00,410,194,216,8,17
2/26/2015 21:00,257,104,153,6,15
2/26/2015 22:00,263,99,164,6,13
2/26/2015 23:00,225,114,111,6,11
2/27/2015 0:00,101,46,55,6,9
2/27/2015 1:00,51,25,26,6,6
2/27/2015 2:00,50,7,43,6,4
2/27/2015 3:00,38,9,29,6,4
2/27/2015 4:00,44,8,36,6,4
2/27/2015 5:00,44,19,25,5,13
2/27/2015 6:00,99,73,26,5,20
2/27/2015 7:00,410,284,126,4,15
2/27/2015 8:00,523,337,186,5,13
2/27/2015 9:00,454,286,168,5,17
2/27/2015 10:00,390,246,144,6,13
2/27/2015 11:00,401,240,161,6,17
2/27/2015 12:00,503,294,209,6,15
2/27/2015 13:00,563,277,286,7,15
2/27/2015 14:00,557,301,256,7,20
2/27/2015 15:00,542,295,247,7,13
2/27/2015 16:00,554,288,266,7,13
2/27/2015 17:00,502,273,229,5,9
2/27/2015 18:00,511,252,259,4,4
2/27/2015 19:00,460,241,219,2,6
2/27/2015 20:00,376,211,165,3,7
2/27/2015 21:00,272,137,135,2,7
2/27/2015 22:00,251,93,158,1,6
2/27/2015 23:00,207,89,118,0,4
2/28/2015 0:00,172,74,98,0,6
2/28/2015 1:00,117,41,76,0,2
2/28/2015 2:00,116,30,86,-1,4
2/28/2015 3:00,85,19,66,-2,4
2/28/2015 4:00,45,6,39,-2,7
2/28/2015 5:00,35,21,14,-2,6
2/28/2015 6:00,49,33,16,-1,7
2/28/2015 7:00,61,49,12,-1,9
2/28/2015 8:00,163,110,53,1,11
2/28/2015 9:00,287,207,80,3,13
2/28/2015 10:00,382,291,91,4,15
2/28/2015 11:00,409,268,141,6,20
2/28/2015 12:00,478,299,179,6,20
2/28/2015 13:00,475,284,191,7,22
2/28/2015 14:00,468,253,215,8,17
2/28/2015 15:00,478,240,238,8,17
2/28/2015 16:00,374,191,183,8,20
2/28/2015 17:00,426,178,248,7,15
2/28/2015 18:00,403,155,248,6,15
2/28/2015 19:00,358,183,175,5,17
2/28/2015 20:00,284,140,144,5,17
2/28/2015 21:00,236,144,92,5,15
2/28/2015 22:00,182,89,93,6,17
2/28/2015 23:00,158,70,88,6,17
3/1/2015 0:00,154,58,96,6,17
3/1/2015 1:00,153,72,81,6,20
3/1/2015 2:00,106,41,65,6,20
3/1/2015 3:00,78,13,65,5,19
3/1/2015 4:00,48,5,43,5,19
3/1/2015 5:00,30,10,20,5,22
3/1/2015 6:00,29,12,17,5,22
3/1/2015 7:00,31,20,11,6,20
3/1/2015 8:00,52,37,15,7,20
3/1/2015 9:00,103,69,34,7,22
3/1/2015 10:00,148,98,50,9,24
3/1/2015 11:00,157,92,65,9,32
3/1/2015 12:00,186,100,86,9,30
3/1/2015 13:00,171,97,74,9,32
3/1/2015 14:00,168,105,63,10,37
3/1/2015 15:00,190,108,82,10,28
3/1/2015 16:00,216,135,81,10,26
3/1/2015 17:00,238,114,124,9,20
3/1/2015 18:00,215,105,110,8,13
3/1/2015 19:00,239,105,134,8,13
3/1/2015 20:00,174,57,117,7,11
3/1/2015 21:00,109,36,73,7,15
3/1/2015 22:00,124,62,62,7,13
3/1/2015 23:00,55,15,40,7,20
3/2/2015 0:00,32,15,17,6,15
3/2/2015 1:00,11,3,8,6,33
3/2/2015 2:00,14,4,10,6,28
3/2/2015 3:00,7,4,3,6,28
3/2/2015 4:00,8,3,5,5,32
3/2/2015 5:00,36,24,12,5,30
3/2/2015 6:00,118,91,27,4,30
3/2/2015 7:00,545,375,170,4,24
3/2/2015 8:00,631,383,248,4,28
3/2/2015 9:00,478,281,197,5,32
3/2/2015 10:00,405,241,164,6,37
3/2/2015 11:00,454,260,194,7,35
3/2/2015 12:00,493,294,199,8,35
3/2/2015 13:00,520,275,245,8,28
3/2/2015 14:00,502,239,263,9,37
3/2/2015 15:00,570,262,308,8,30
3/2/2015 16:00,608,302,306,5,41
3/2/2015 17:00,632,277,355,3,19
3/2/2015 18:00,652,288,364,3,19
3/2/2015 19:00,444,205,239,3,17
3/2/2015 20:00,296,151,145,2,20
3/2/2015 21:00,214,76,138,2,15
3/2/2015 22:00,146,52,94,3,26
3/2/2015 23:00,87,37,50,3,28
3/3/2015 0:00,49,25,24,3,24
3/3/2015 1:00,29,6,23,3,19
3/3/2015 2:00,14,10,4,3,20
3/3/2015 3:00,3,1,2,3,20
3/3/2015 4:00,13,6,7,2,17
3/3/2015 5:00,37,25,12,2,17
3/3/2015 6:00,129,94,35,3,17
3/3/2015 7:00,571,393,178,3,15
3/3/2015 8:00,672,406,266,3,19
3/3/2015 9:00,541,333,208,5,20
3/3/2015 10:00,378,227,151,5,20
3/3/2015 11:00,394,222,172,6,19
3/3/2015 12:00,419,219,200,5,26
3/3/2015 13:00,466,244,222,5,19
3/3/2015 14:00,401,171,230,4,26
3/3/2015 15:00,421,191,230,5,15
3/3/2015 16:00,536,281,255,6,20
3/3/2015 17:00,600,289,311,6,19
3/3/2015 18:00,606,284,322,4,19
3/3/2015 19:00,470,258,212,3,13
3/3/2015 20:00,377,174,203,2,9
3/3/2015 21:00,197,87,110,2,7
3/3/2015 22:00,277,108,169,3,7
3/3/2015 23:00,115,46,69,3,7
3/4/2015 0:00,57,8,49,1,9
3/4/2015 1:00,31,11,20,1,11
3/4/2015 2:00,22,8,14,1,9
3/4/2015 3:00,9,4,5,2,11
3/4/2015 4:00,11,5,6,2,15
3/4/2015 5:00,38,25,13,2,17
3/4/2015 6:00,143,104,39,2,22
3/4/2015 7:00,569,388,181,2,19
3/4/2015 8:00,633,391,242,3,19
3/4/2015 9:00,523,335,188,4,20
3/4/2015 10:00,415,258,157,4,26
3/4/2015 11:00,438,257,181,5,24
3/4/2015 12:00,481,260,221,6,20
3/4/2015 13:00,472,240,232,6,33
3/4/2015 14:00,492,246,246,6,26
3/4/2015 15:00,532,235,297,6,20
3/4/2015 16:00,627,302,325,6,33
3/4/2015 17:00,678,335,343,4,28
3/4/2015 18:00,697,327,370,4,24
3/4/2015 19:00,600,308,292,4,22
3/4/2015 20:00,343,136,207,5,19
3/4/2015 21:00,254,116,138,5,20
3/4/2015 22:00,273,128,145,5,17
3/4/2015 23:00,183,88,95,4,17
3/5/2015 0:00,75,30,45,4,15
3/5/2015 1:00,66,23,43,4,9
3/5/2015 2:00,40,11,29,3,11
3/5/2015 3:00,31,9,22,2,9
3/5/2015 4:00,26,9,17,1,11
3/5/2015 5:00,61,36,25,2,9
3/5/2015 6:00,142,103,39,3,9
3/5/2015 7:00,563,389,174,3,9
3/5/2015 8:00,621,405,216,4,13
3/5/2015 9:00,529,313,216,4,11
3/5/2015 10:00,452,276,176,5,13
3/5/2015 11:00,395,232,163,5,11
3/5/2015 12:00,494,285,209,8,13
3/5/2015 13:00,557,299,258,9,17
3/5/2015 14:00,573,289,284,8,19
3/5/2015 15:00,634,332,302,8,17
3/5/2015 16:00,703,369,334,8,11
3/5/2015 17:00,790,390,400,7,11
3/5/2015 18:00,701,326,375,6,9
3/5/2015 19:00,558,260,298,5,6
3/5/2015 20:00,405,210,195,3,4
3/5/2015 21:00,271,129,142,2,2
3/5/2015 22:00,246,104,142,2,6
3/5/2015 23:00,190,55,135,2,6
3/6/2015 0:00,67,16,51,1,4
3/6/2015 1:00,48,12,36,4,7
3/6/2015 2:00,24,6,18,4,4
3/6/2015 3:00,14,6,8,4,4
3/6/2015 4:00,14,5,9,5,6
3/6/2015 5:00,37,26,11,5,7
3/6/2015 6:00,147,107,40,5,7
3/6/2015 7:00,534,368,166,4,6
3/6/2015 8:00,595,386,209,5,7
3/6/2015 9:00,520,334,186,5,7
3/6/2015 10:00,430,254,176,5,9
3/6/2015 11:00,418,238,180,6,9
3/6/2015 12:00,501,265,236,7,11
3/6/2015 13:00,571,290,281,7,15
3/6/2015 14:00,582,305,277,8,17
3/6/2015 15:00,596,310,286,8,13
3/6/2015 16:00,566,300,266,8,9
3/6/2015 17:00,618,334,284,8,13
3/6/2015 18:00,595,293,302,7,7
3/6/2015 19:00,510,286,224,7,7
3/6/2015 20:00,352,212,140,7,9
3/6/2015 21:00,335,163,172,5,7
3/6/2015 22:00,196,90,106,3,6
3/6/2015 23:00,222,63,159,4,7
3/7/2015 0:00,155,58,97,3,7
3/7/2015 1:00,128,29,99,3,7
3/7/2015 2:00,98,22,76,3,9
3/7/2015 3:00,91,28,63,3,11
3/7/2015 4:00,55,12,43,3,11
3/7/2015 5:00,40,14,26,3,9
3/7/2015 6:00,46,24,22,3,9
3/7/2015 7:00,78,58,20,4,11
3/7/2015 8:00,138,108,30,5,13
3/7/2015 9:00,284,205,79,6,11
3/7/2015 10:00,394,303,91,8,17
3/7/2015 11:00,386,261,125,9,17
3/7/2015 12:00,567,367,200,12,17
3/7/2015 13:00,520,325,195,13,19
3/7/2015 14:00,596,305,291,14,19
3/7/2015 15:00,446,218,228,14,15
3/7/2015 16:00,474,225,249,15,17
3/7/2015 17:00,443,183,260,14,13
3/7/2015 18:00,481,212,269,12,11
3/7/2015 19:00,385,209,176,10,9
3/7/2015 20:00,329,167,162,10,11
3/7/2015 21:00,243,145,98,9,9
3/7/2015 22:00,175,81,94,9,13
3/7/2015 23:00,266,111,155,8,13
3/8/2015 0:00,169,68,101,7,6
3/8/2015 1:00,161,59,102,5,7
3/8/2015 2:00,104,33,71,3,7
3/8/2015 3:00,95,18,77,2,6
3/8/2015 4:00,53,14,39,2,7
3/8/2015 5:00,38,16,22,1,6
3/8/2015 6:00,36,23,13,3,7
3/8/2015 7:00,43,29,14,2,6
3/8/2015 8:00,58,40,18,6,9
3/8/2015 9:00,170,129,41,10,13
3/8/2015 10:00,329,207,122,12,11
3/8/2015 11:00,332,206,126,14,13
3/8/2015 12:00,424,247,177,16,13
3/8/2015 13:00,496,306,190,17,19
3/8/2015 14:00,659,416,243,18,19
3/8/2015 15:00,661,382,279,18,17
3/8/2015 16:00,573,261,312,17,11
3/8/2015 17:00,542,253,289,16,9
3/8/2015 18:00,495,196,299,12,7
3/8/2015 19:00,318,129,189,10,4
3/8/2015 20:00,216,71,145,8,2
3/8/2015 21:00,129,48,81,9,13
3/8/2015 22:00,145,52,93,7,7
3/8/2015 23:00,60,18,42,6,6
3/9/2015 0:00,36,12,24,5,2
3/9/2015 1:00,20,5,15,6,4
3/9/2015 2:00,6,2,4,6,2
3/9/2015 3:00,7,5,2,6,4
3/9/2015 4:00,10,4,6,7,4
3/9/2015 5:00,43,32,11,7,4
3/9/2015 6:00,138,103,35,7,6
3/9/2015 7:00,616,436,180,7,7
3/9/2015 8:00,682,408,274,8,6
3/9/2015 9:00,517,330,187,9,4
3/9/2015 10:00,441,267,174,10,6
3/9/2015 11:00,416,234,182,11,9
3/9/2015 12:00,535,308,227,10,6
3/9/2015 13:00,539,270,269,11,7
3/9/2015 14:00,544,279,265,11,6
3/9/2015 15:00,662,360,302,12,6
3/9/2015 16:00,774,373,401,11,4
3/9/2015 17:00,940,451,489,10,6
3/9/2015 18:00,811,377,434,8,4
3/9/2015 19:00,633,309,324,6,2
3/9/2015 20:00,380,181,199,4,4
3/9/2015 21:00,274,126,148,4,4
3/9/2015 22:00,231,72,159,4,2
3/9/2015 23:00,147,52,95,6,6
3/10/2015 0:00,94,17,77,5,4
3/10/2015 1:00,34,4,30,5,4
3/10/2015 2:00,11,3,8,5,4
3/10/2015 3:00,1,1,0,7,6
3/10/2015 4:00,9,3,6,7,6
3/10/2015 5:00,34,24,10,8,7
3/10/2015 6:00,129,93,36,8,9
3/10/2015 7:00,582,434,148,8,11
3/10/2015 8:00,700,431,269,8,9
3/10/2015 9:00,527,328,199,9,9
3/10/2015 10:00,435,259,176,10,13
3/10/2015 11:00,417,263,154,11,15
3/10/2015 12:00,557,301,256,11,13
3/10/2015 13:00,594,323,271,12,15
3/10/2015 14:00,618,300,318,12,19
3/10/2015 15:00,634,350,284,12,13
3/10/2015 16:00,778,378,400,11,15
3/10/2015 17:00,899,386,513,10,7
3/10/2015 18:00,836,355,481,8,7
3/10/2015 19:00,704,338,366,6,9
3/10/2015 20:00,489,225,264,6,11
3/10/2015 21:00,289,133,156,4,9
3/10/2015 22:00,348,130,218,3,7
3/10/2015 23:00,170,46,124,2,4
3/11/2015 0:00,88,34,54,0,6
3/11/2015 1:00,51,19,32,0,6
3/11/2015 2:00,31,17,14,-1,6
3/11/2015 3:00,12,10,2,1,4
3/11/2015 4:00,16,6,10,2,6
3/11/2015 5:00,53,42,11,1,6
3/11/2015 6:00,167,134,33,1,6
3/11/2015 7:00,643,454,189,1,2
3/11/2015 8:00,781,501,280,2,6
3/11/2015 9:00,637,402,235,2,2
3/11/2015 10:00,506,304,202,3,4
3/11/2015 11:00,502,317,185,4,6
3/11/2015 12:00,567,316,251,6,6
3/11/2015 13:00,629,325,304,8,7
3/11/2015 14:00,661,350,311,8,7
3/11/2015 15:00,753,362,391,9,7
3/11/2015 16:00,838,438,400,9,4
3/11/2015 17:00,980,493,487,8,6
3/11/2015 18:00,854,395,459,5,6
3/11/2015 19:00,732,358,374,3,4
3/11/2015 20:00,529,249,280,2,2
3/11/2015 21:00,303,140,163,1,2
3/11/2015 22:00,323,131,192,0,6
3/11/2015 23:00,218,95,123,-1,4
3/12/2015 0:00,158,73,85,0,7
3/12/2015 1:00,96,31,65,0,2
3/12/2015 2:00,52,12,40,0,2
3/12/2015 3:00,31,8,23,-1,2
3/12/2015 4:00,40,7,33,-2,2
3/12/2015 5:00,66,35,31,-3,2
3/12/2015 6:00,141,104,37,-3,4
3/12/2015 7:00,618,443,175,-2,2
3/12/2015 8:00,739,452,287,2,4
3/12/2015 9:00,630,385,245,6,4
3/12/2015 10:00,456,271,185,8,7
3/12/2015 11:00,520,317,203,10,4
3/12/2015 12:00,577,312,265,11,9
3/12/2015 13:00,669,352,317,11,19
3/12/2015 14:00,678,339,339,11,19
3/12/2015 15:00,789,407,382,11,15
3/12/2015 16:00,815,430,385,10,15
3/12/2015 17:00,971,455,516,8,20
3/12/2015 18:00,831,377,454,7,17
3/12/2015 19:00,634,309,325,6,13
3/12/2015 20:00,428,194,234,5,11
3/12/2015 21:00,323,150,173,4,15
3/12/2015 22:00,300,115,185,3,11
3/12/2015 23:00,164,61,103,3,13
3/13/2015 0:00,108,32,76,3,13
3/13/2015 1:00,58,15,43,2,11
3/13/2015 2:00,32,9,23,2,11
3/13/2015 3:00,14,2,12,2,13
3/13/2015 4:00,18,6,12,1,11
3/13/2015 5:00,50,35,15,0,11
3/13/2015 6:00,147,111,36,-1,7
3/13/2015 7:00,566,389,177,1,7
3/13/2015 8:00,637,407,230,3,17
3/13/2015 9:00,537,317,220,5,13
3/13/2015 10:00,427,277,150,5,17
3/13/2015 11:00,414,232,182,6,17
3/13/2015 12:00,571,321,250,6,17
3/13/2015 13:00,612,302,310,7,15
3/13/2015 14:00,670,337,333,8,17
3/13/2015 15:00,729,401,328,7,24
3/13/2015 16:00,623,318,305,8,20
3/13/2015 17:00,659,337,322,6,20
3/13/2015 18:00,622,284,338,5,17
3/13/2015 19:00,523,269,254,4,15
3/13/2015 20:00,389,217,172,4,15
3/13/2015 21:00,287,148,139,3,13
3/13/2015 22:00,235,101,134,2,11
3/13/2015 23:00,199,79,120,1,7
3/14/2015 0:00,187,88,99,1,9
3/14/2015 1:00,133,52,81,2,4
3/14/2015 2:00,107,24,83,4,15
3/14/2015 3:00,74,20,54,4,15
3/14/2015 4:00,50,10,40,3,15
3/14/2015 5:00,47,22,25,3,13
3/14/2015 6:00,54,43,11,3,13
3/14/2015 7:00,77,58,19,2,19
3/14/2015 8:00,150,98,52,3,17
3/14/2015 9:00,306,242,64,3,17
3/14/2015 10:00,353,259,94,3,19
3/14/2015 11:00,369,240,129,4,15
3/14/2015 12:00,421,263,158,4,17
3/14/2015 13:00,458,242,216,4,13
3/14/2015 14:00,419,204,215,4,17
3/14/2015 15:00,304,119,185,4,11
3/14/2015 16:00,222,105,117,4,7
3/14/2015 17:00,280,108,172,5,13
3/14/2015 18:00,328,139,189,5,13
3/14/2015 19:00,276,138,138,5,17
3/14/2015 20:00,304,167,137,5,13
3/14/2015 21:00,221,136,85,5,15
3/14/2015 22:00,157,89,68,5,13
3/14/2015 23:00,152,68,84,5,11
3/15/2015 0:00,130,70,60,5,13
3/15/2015 1:00,113,41,72,5,15
3/15/2015 2:00,90,20,70,5,13
3/15/2015 3:00,72,14,58,5,11
3/15/2015 4:00,30,8,22,5,15
3/15/2015 5:00,51,19,32,4,17
3/15/2015 6:00,24,14,10,4,15
3/15/2015 7:00,35,25,10,4,15
3/15/2015 8:00,52,35,17,5,20
3/15/2015 9:00,136,102,34,4,20
3/15/2015 10:00,176,121,55,5,19
3/15/2015 11:00,199,112,87,5,19
3/15/2015 12:00,208,124,84,6,22
3/15/2015 13:00,224,120,104,7,22
3/15/2015 14:00,278,138,140,7,26
3/15/2015 15:00,238,114,124,7,22
3/15/2015 16:00,248,111,137,7,26
3/15/2015 17:00,288,165,123,6,26
3/15/2015 18:00,260,109,151,6,20
3/15/2015 19:00,246,114,132,5,17
3/15/2015 20:00,184,78,106,5,17
3/15/2015 21:00,108,42,66,6,17
3/15/2015 22:00,110,41,69,6,15
3/15/2015 23:00,63,25,38,5,15
3/16/2015 0:00,41,13,28,6,17
3/16/2015 1:00,21,9,12,6,13
3/16/2015 2:00,9,3,6,5,9
3/16/2015 3:00,11,4,7,5,13
3/16/2015 4:00,6,4,2,4,13
3/16/2015 5:00,42,30,12,4,9
3/16/2015 6:00,163,118,45,4,11
3/16/2015 7:00,632,449,183,5,13
3/16/2015 8:00,753,425,328,7,19
3/16/2015 9:00,541,326,215,8,19
3/16/2015 10:00,472,272,200,9,22
3/16/2015 11:00,486,274,212,11,22
3/16/2015 12:00,640,364,276,12,19
3/16/2015 13:00,608,293,315,12,19
3/16/2015 14:00,624,310,314,12,19
3/16/2015 15:00,759,399,360,12,22
3/16/2015 16:00,878,450,428,11,20
3/16/2015 17:00,972,492,480,11,11
3/16/2015 18:00,896,398,498,10,9
3/16/2015 19:00,633,316,317,9,7
3/16/2015 20:00,436,201,235,8,9
3/16/2015 21:00,279,138,141,8,11
3/16/2015 22:00,261,88,173,8,9
3/16/2015 23:00,141,39,102,7,7
3/17/2015 0:00,82,20,62,7,7
3/17/2015 1:00,43,10,33,4,7
3/17/2015 2:00,19,5,14,3,2
3/17/2015 3:00,8,3,5,2,6
3/17/2015 4:00,7,3,4,2,4
3/17/2015 5:00,44,29,15,1,4
3/17/2015 6:00,175,135,40,1,6
3/17/2015 7:00,660,462,198,1,4
3/17/2015 8:00,850,497,353,6,4
3/17/2015 9:00,609,371,238,11,9
3/17/2015 10:00,470,286,184,13,11
3/17/2015 11:00,497,302,195,14,11
3/17/2015 12:00,658,376,282,14,11
3/17/2015 13:00,694,351,343,16,9
3/17/2015 14:00,752,407,345,16,13
3/17/2015 15:00,786,405,381,16,15
3/17/2015 16:00,969,511,458,16,13
3/17/2015 17:00,1055,518,537,14,13
3/17/2015 18:00,986,466,520,13,11
3/17/2015 19:00,739,359,380,12,9
3/17/2015 20:00,556,262,294,9,7
3/17/2015 21:00,366,185,181,9,7
3/17/2015 22:00,355,129,226,8,7
3/17/2015 23:00,175,61,114,5,6
3/18/2015 0:00,107,36,71,4,4
3/18/2015 1:00,64,12,52,4,2
3/18/2015 2:00,23,10,13,3,2
3/18/2015 3:00,9,5,4,2,2
3/18/2015 4:00,15,7,8,1,2
3/18/2015 5:00,39,28,11,1,2
3/18/2015 6:00,165,132,33,1,2
3/18/2015 7:00,715,506,209,2,0
3/18/2015 8:00,889,522,367,6,6
3/18/2015 9:00,628,408,220,10,4
3/18/2015 10:00,518,330,188,12,9
3/18/2015 11:00,519,327,192,15,11
3/18/2015 12:00,680,390,290,15,9
3/18/2015 13:00,736,406,330,16,9
3/18/2015 14:00,798,441,357,17,13
3/18/2015 15:00,863,436,427,16,13
3/18/2015 16:00,911,474,437,16,15
3/18/2015 17:00,1049,520,529,15,13
3/18/2015 18:00,981,457,524,12,7
3/18/2015 19:00,826,389,437,12,13
3/18/2015 20:00,545,252,293,10,9
3/18/2015 21:00,348,163,185,10,7
3/18/2015 22:00,348,152,196,7,6
3/18/2015 23:00,310,149,161,6,9
3/19/2015 0:00,160,61,99,6,9
3/19/2015 1:00,93,26,67,6,11
3/19/2015 2:00,57,8,49,6,9
3/19/2015 3:00,68,13,55,6,11
3/19/2015 4:00,47,14,33,6,9
3/19/2015 5:00,57,32,25,6,9
3/19/2015 6:00,156,113,43,5,9
3/19/2015 7:00,641,444,197,5,7
3/19/2015 8:00,742,433,309,5,7
3/19/2015 9:00,593,386,207,6,2
3/19/2015 10:00,457,256,201,6,4
3/19/2015 11:00,459,254,205,6,6
3/19/2015 12:00,568,327,241,7,6
3/19/2015 13:00,615,315,300,8,2
3/19/2015 14:00,612,315,297,9,7
3/19/2015 15:00,730,356,374,10,9
3/19/2015 16:00,854,454,400,10,7
3/19/2015 17:00,919,474,445,9,7
3/19/2015 18:00,863,415,448,7,7
3/19/2015 19:00,635,329,306,6,4
3/19/2015 20:00,443,218,225,4,4
3/19/2015 21:00,302,112,190,3,2
3/19/2015 22:00,282,90,192,1,2
3/19/2015 23:00,226,71,155,0,6
3/20/2015 0:00,101,31,70,-1,6
3/20/2015 1:00,63,20,43,1,4
3/20/2015 2:00,24,2,22,2,4
3/20/2015 3:00,9,4,5,1,2
3/20/2015 4:00,13,7,6,0,0
3/20/2015 5:00,51,33,18,0,4
3/20/2015 6:00,151,115,36,0,4
3/20/2015 7:00,551,389,162,0,2
3/20/2015 8:00,635,396,239,0,2
3/20/2015 9:00,526,316,210,1,4
3/20/2015 10:00,433,259,174,0,4
3/20/2015 11:00,416,235,181,1,7
3/20/2015 12:00,512,291,221,1,7
3/20/2015 13:00,532,249,283,2,6
3/20/2015 14:00,622,303,319,4,2
3/20/2015 15:00,562,296,266,5,4
3/20/2015 16:00,606,322,284,5,6
3/20/2015 17:00,688,369,319,4,9
3/20/2015 18:00,633,315,318,3,6
3/20/2015 19:00,495,231,264,1,7
3/20/2015 20:00,412,213,199,1,7
3/20/2015 21:00,291,153,138,0,2
3/20/2015 22:00,224,105,119,0,6
3/20/2015 23:00,250,115,135,0,2
3/21/2015 0:00,218,95,123,2,7
3/21/2015 1:00,168,66,102,3,11
3/21/2015 2:00,117,30,87,3,11
3/21/2015 3:00,77,20,57,3,11
3/21/2015 4:00,57,17,40,3,11
3/21/2015 5:00,34,13,21,4,13
3/21/2015 6:00,36,22,14,4,15
3/21/2015 7:00,66,41,25,4,13
3/21/2015 8:00,111,79,32,5,13
3/21/2015 9:00,277,218,59,6,13
3/21/2015 10:00,301,212,89,6,11
3/21/2015 11:00,379,265,114,7,11
3/21/2015 12:00,446,299,147,7,15
3/21/2015 13:00,466,303,163,6,7
3/21/2015 14:00,382,204,178,7,7
3/21/2015 15:00,375,164,211,7,7
3/21/2015 16:00,394,188,206,5,13
3/21/2015 17:00,327,145,182,6,13
3/21/2015 18:00,343,135,208,5,11
3/21/2015 19:00,297,128,169,5,13
3/21/2015 20:00,331,166,165,5,13
3/21/2015 21:00,215,121,94,5,17
3/21/2015 22:00,188,96,92,5,26
3/21/2015 23:00,149,58,91,4,15
3/22/2015 0:00,130,65,65,4,26
3/22/2015 1:00,182,72,110,4,26
3/22/2015 2:00,118,31,87,3,28
3/22/2015 3:00,73,20,53,3,22
3/22/2015 4:00,56,20,36,3,20
3/22/2015 5:00,48,22,26,2,20
3/22/2015 6:00,34,14,20,1,15
3/22/2015 7:00,46,35,11,1,24
3/22/2015 8:00,71,53,18,1,17
3/22/2015 9:00,161,122,39,2,17
3/22/2015 10:00,228,160,68,3,17
3/22/2015 11:00,185,115,70,5,15
3/22/2015 12:00,281,152,129,6,13
3/22/2015 13:00,374,216,158,6,13
3/22/2015 14:00,420,239,181,7,13
3/22/2015 15:00,451,230,221,7,9
3/22/2015 16:00,419,252,167,7,7
3/22/2015 17:00,443,233,210,7,11
3/22/2015 18:00,373,171,202,5,7
3/22/2015 19:00,283,99,184,4,7
3/22/2015 20:00,288,110,178,3,6
3/22/2015 21:00,168,62,106,2,4
3/22/2015 22:00,132,58,74,1,4
3/22/2015 23:00,79,33,46,1,6
3/23/2015 0:00,38,10,28,-1,4
3/23/2015 1:00,22,2,20,-1,4
3/23/2015 2:00,9,1,8,-1,4
3/23/2015 3:00,10,7,3,-2,4
3/23/2015 4:00,7,4,3,-2,4
3/23/2015 5:00,46,34,12,-2,4
3/23/2015 6:00,137,102,35,-2,6
3/23/2015 7:00,647,451,196,-1,4
3/23/2015 8:00,739,407,332,1,6
3/23/2015 9:00,580,336,244,4,7
3/23/2015 10:00,546,297,249,6,7
3/23/2015 11:00,542,327,215,8,9
3/23/2015 12:00,608,328,280,9,11
3/23/2015 13:00,601,315,286,10,13
3/23/2015 14:00,698,365,333,10,11
3/23/2015 15:00,848,465,383,11,15
3/23/2015 16:00,952,500,452,11,11
3/23/2015 17:00,1027,539,488,10,15
3/23/2015 18:00,889,421,468,9,9
3/23/2015 19:00,674,322,352,7,7
3/23/2015 20:00,431,206,225,6,4
3/23/2015 21:00,312,131,181,5,2
3/23/2015 22:00,303,103,200,5,9
3/23/2015 23:00,187,76,111,5,6
3/24/2015 0:00,75,19,56,5,2
3/24/2015 1:00,51,10,41,4,2
3/24/2015 2:00,40,6,34,4,2
3/24/2015 3:00,13,2,11,3,2
3/24/2015 4:00,9,5,4,1,2
3/24/2015 5:00,55,36,19,0,0
3/24/2015 6:00,159,118,41,0,2
3/24/2015 7:00,593,409,184,1,6
3/24/2015 8:00,862,493,369,4,2
3/24/2015 9:00,705,454,251,6,6
3/24/2015 10:00,542,301,241,8,7
3/24/2015 11:00,563,311,252,8,7
3/24/2015 12:00,624,330,294,9,6
3/24/2015 13:00,691,350,341,10,7
3/24/2015 14:00,698,367,331,10,4
3/24/2015 15:00,779,403,376,11,9
3/24/2015 16:00,953,529,424,10,11
3/24/2015 17:00,982,505,477,9,6
3/24/2015 18:00,940,456,484,7,4
3/24/2015 19:00,734,390,344,5,6
3/24/2015 20:00,488,254,234,4,4
3/24/2015 21:00,293,139,154,4,2
3/24/2015 22:00,308,121,187,5,6
3/24/2015 23:00,177,56,121,6,0
3/25/2015 0:00,105,33,72,7,13
3/25/2015 1:00,73,18,55,7,11
3/25/2015 2:00,31,7,24,6,9
3/25/2015 3:00,18,7,11,7,7
3/25/2015 4:00,17,13,4,8,11
3/25/2015 5:00,41,32,9,6,11
3/25/2015 6:00,161,130,31,6,7
3/25/2015 7:00,629,435,194,6,4
3/25/2015 8:00,846,443,403,8,2
3/25/2015 9:00,701,423,278,10,9
3/25/2015 10:00,541,336,205,11,9
3/25/2015 11:00,569,341,228,12,9
3/25/2015 12:00,695,376,319,12,13
3/25/2015 13:00,756,370,386,10,15
3/25/2015 14:00,693,372,321,10,17
3/25/2015 15:00,710,357,353,8,20
3/25/2015 16:00,870,452,418,8,15
3/25/2015 17:00,904,479,425,7,11
3/25/2015 18:00,827,387,440,7,15
3/25/2015 19:00,710,368,342,7,11
3/25/2015 20:00,480,259,221,6,11
3/25/2015 21:00,371,218,153,6,11
3/25/2015 22:00,349,152,197,6,13
3/25/2015 23:00,271,110,161,5,15
3/26/2015 0:00,216,100,116,5,11
3/26/2015 1:00,110,32,78,5,15
3/26/2015 2:00,117,34,83,4,9
3/26/2015 3:00,63,9,54,4,7
3/26/2015 4:00,51,14,37,4,7
3/26/2015 5:00,68,30,38,5,7
3/26/2015 6:00,153,110,43,5,9
3/26/2015 7:00,633,443,190,5,9
3/26/2015 8:00,822,502,320,6,7
3/26/2015 9:00,603,376,227,6,13
3/26/2015 10:00,548,311,237,6,13
3/26/2015 11:00,518,257,261,7,15
3/26/2015 12:00,590,328,262,8,17
3/26/2015 13:00,627,316,311,8,17
3/26/2015 14:00,624,343,281,8,13
3/26/2015 15:00,767,370,397,8,15
3/26/2015 16:00,843,413,430,6,15
3/26/2015 17:00,803,417,386,6,15
3/26/2015 18:00,730,346,384,5,9
3/26/2015 19:00,594,310,284,5,9
3/26/2015 20:00,371,180,191,5,17
3/26/2015 21:00,269,139,130,5,19
3/26/2015 22:00,237,92,145,5,17
3/26/2015 23:00,195,80,115,5,13
3/27/2015 0:00,119,53,66,6,13
3/27/2015 1:00,76,12,64,7,19
3/27/2015 2:00,74,6,68,7,22
3/27/2015 3:00,33,4,29,7,15
3/27/2015 4:00,13,4,9,6,24
3/27/2015 5:00,39,25,14,6,20
3/27/2015 6:00,137,114,23,6,20
3/27/2015 7:00,506,349,157,6,22
3/27/2015 8:00,599,359,240,6,28
3/27/2015 9:00,531,334,197,7,24
3/27/2015 10:00,439,230,209,8,28
3/27/2015 11:00,404,239,165,8,33
3/27/2015 12:00,523,303,220,8,35
3/27/2015 13:00,556,283,273,9,28
3/27/2015 14:00,537,265,272,8,30
3/27/2015 15:00,552,310,242,6,26
3/27/2015 16:00,562,298,264,7,15
3/27/2015 17:00,578,316,262,7,15
3/27/2015 18:00,533,260,273,7,19
3/27/2015 19:00,500,235,265,7,15
3/27/2015 20:00,374,203,171,6,19
3/27/2015 21:00,311,175,136,6,19
3/27/2015 22:00,239,113,126,6,11
3/27/2015 23:00,214,93,121,6,11
3/28/2015 0:00,190,86,104,4,9
3/28/2015 1:00,146,77,69,3,6
3/28/2015 2:00,147,63,84,2,2
3/28/2015 3:00,85,32,53,0,4
3/28/2015 4:00,72,21,51,0,6
3/28/2015 5:00,76,42,34,0,7
3/28/2015 6:00,52,28,24,-1,6
3/28/2015 7:00,80,57,23,2,7
3/28/2015 8:00,180,116,64,5,7
3/28/2015 9:00,298,230,68,7,15
3/28/2015 10:00,441,311,130,9,13
3/28/2015 11:00,454,319,135,11,15
3/28/2015 12:00,483,285,198,12,19
3/28/2015 13:00,488,263,225,11,19
3/28/2015 14:00,366,156,210,9,13
3/28/2015 15:00,305,142,163,9,17
3/28/2015 16:00,285,110,175,8,13
3/28/2015 17:00,294,133,161,9,17
3/28/2015 18:00,327,131,196,9,19
3/28/2015 19:00,312,160,152,10,17
3/28/2015 20:00,299,143,156,9,17
3/28/2015 21:00,255,136,119,10,19
3/28/2015 22:00,163,84,79,10,17
3/28/2015 23:00,152,72,80,11,22
3/29/2015 0:00,156,60,96,11,20
3/29/2015 1:00,154,68,86,12,26
3/29/2015 3:00,,,,,
3/29/2015 3:00,96,23,73,11,28
3/29/2015 4:00,83,20,63,11,30
3/29/2015 5:00,59,24,35,11,28
3/29/2015 6:00,31,9,22,10,30
3/29/2015 7:00,32,20,12,10,26
3/29/2015 8:00,60,48,12,9,24
3/29/2015 9:00,81,67,14,9,24
3/29/2015 10:00,113,82,31,10,24
3/29/2015 11:00,121,75,46,9,17
3/29/2015 12:00,124,63,61,10,22
3/29/2015 13:00,144,92,52,10,24
3/29/2015 14:00,159,87,72,9,19
3/29/2015 15:00,137,68,69,10,20
3/29/2015 16:00,121,53,68,10,20
3/29/2015 17:00,125,60,65,11,20
3/29/2015 18:00,178,73,105,11,35
3/29/2015 19:00,137,67,70,11,43
3/29/2015 20:00,120,47,73,10,59
3/29/2015 21:00,90,47,43,9,44
3/29/2015 22:00,91,39,52,7,32
3/29/2015 23:00,59,24,35,7,35
3/30/2015 0:00,30,14,16,7,30
3/30/2015 1:00,23,7,16,7,30
3/30/2015 2:00,9,1,8,7,30
3/30/2015 3:00,9,3,6,7,30
3/30/2015 4:00,10,8,2,7,33
3/30/2015 5:00,31,22,9,7,33
3/30/2015 6:00,82,60,22,5,39
3/30/2015 7:00,315,207,108,6,30
3/30/2015 8:00,552,299,253,6,33
3/30/2015 9:00,400,238,162,7,37
3/30/2015 10:00,423,254,169,8,37
3/30/2015 11:00,349,216,133,8,26
3/30/2015 12:00,387,215,172,5,43
3/30/2015 13:00,378,215,163,8,32
3/30/2015 14:00,407,211,196,8,35
3/30/2015 15:00,476,267,209,9,41
3/30/2015 16:00,575,293,282,8,35
3/30/2015 17:00,685,366,319,8,35
3/30/2015 18:00,647,334,313,7,26
3/30/2015 19:00,485,249,236,6,20
3/30/2015 20:00,361,171,190,6,13
3/30/2015 21:00,223,114,109,6,11
3/30/2015 22:00,150,46,104,6,11
3/30/2015 23:00,137,52,85,6,13
3/31/2015 0:00,98,22,76,5,24
3/31/2015 1:00,58,22,36,4,20
3/31/2015 2:00,37,13,24,4,19
3/31/2015 3:00,18,8,10,4,20
3/31/2015 4:00,26,9,17,4,17
3/31/2015 5:00,26,20,6,8,17
3/31/2015 6:00,70,47,23,11,48
3/31/2015 7:00,209,130,79,8,44
3/31/2015 8:00,327,179,148,9,39
3/31/2015 9:00,321,172,149,9,41
3/31/2015 10:00,307,173,134,8,61
3/31/2015 11:00,252,149,103,9,44
3/31/2015 12:00,299,178,121,8,46
3/31/2015 13:00,295,179,116,8,52
3/31/2015 14:00,314,175,139,8,52
3/31/2015 15:00,355,208,147,9,46
3/31/2015 16:00,388,184,204,9,44
3/31/2015 17:00,437,236,201,9,43
3/31/2015 18:00,416,214,202,8,44
3/31/2015 19:00,380,220,160,6,35
3/31/2015 20:00,262,139,123,6,32
3/31/2015 21:00,162,76,86,6,30
3/31/2015 22:00,175,78,97,4,39
3/31/2015 23:00,117,41,76,5,22
4/1/2015 0:00,78,29,49,5,24
4/1/2015 1:00,65,9,56,5,30
4/1/2015 2:00,21,4,17,4,44
4/1/2015 3:00,16,5,11,4,28
4/1/2015 4:00,13,6,7,2,30
4/1/2015 5:00,42,33,9,2,33
4/1/2015 6:00,59,43,16,3,26
4/1/2015 7:00,276,170,106,3,32
4/1/2015 8:00,429,259,170,3,26
4/1/2015 9:00,471,263,208,5,26
4/1/2015 10:00,443,269,174,6,30
4/1/2015 11:00,359,214,145,7,37
4/1/2015 12:00,411,246,165,7,33
4/1/2015 13:00,387,215,172,6,13
4/1/2015 14:00,380,188,192,6,26
4/1/2015 15:00,368,204,164,7,33
4/1/2015 16:00,486,250,236,6,24
4/1/2015 17:00,504,254,250,6,30
4/1/2015 18:00,519,288,231,5,22
4/1/2015 19:00,448,252,196,4,15
4/1/2015 20:00,297,170,127,4,20
4/1/2015 21:00,256,137,119,5,15
4/1/2015 22:00,200,85,115,5,37
4/1/2015 23:00,187,107,80,5,24
4/2/2015 0:00,131,66,65,5,26
4/2/2015 1:00,114,51,63,5,28
4/2/2015 2:00,94,24,70,5,32
4/2/2015 3:00,67,11,56,5,30
4/2/2015 4:00,58,7,51,3,20
4/2/2015 5:00,53,30,23,2,7
4/2/2015 6:00,71,42,29,0,7
4/2/2015 7:00,214,123,91,1,13
4/2/2015 8:00,385,223,162,2,15
4/2/2015 9:00,404,229,175,4,22
4/2/2015 10:00,350,221,129,4,24
4/2/2015 11:00,379,236,143,6,28
4/2/2015 12:00,406,232,174,7,26
4/2/2015 13:00,369,207,162,6,26
4/2/2015 14:00,417,219,198,7,26
4/2/2015 15:00,438,256,182,5,22
4/2/2015 16:00,479,263,216,7,24
4/2/2015 17:00,553,282,271,8,32
4/2/2015 18:00,449,214,235,6,19
4/2/2015 19:00,430,236,194,5,15
4/2/2015 20:00,307,164,143,5,11
4/2/2015 21:00,221,131,90,5,19
4/2/2015 22:00,142,63,79,5,19
4/2/2015 23:00,141,65,76,5,20
4/3/2015 0:00,113,27,86,4,20
4/3/2015 1:00,80,18,62,4,13
4/3/2015 2:00,65,7,58,4,19
4/3/2015 3:00,27,15,12,4,22
4/3/2015 4:00,23,8,15,4,13
4/3/2015 5:00,22,11,11,4,11
4/3/2015 6:00,38,19,19,4,11
4/3/2015 7:00,28,22,6,4,9
4/3/2015 8:00,47,29,18,5,9
4/3/2015 9:00,104,76,28,5,13
4/3/2015 10:00,129,80,49,6,17
4/3/2015 11:00,122,66,56,7,11
4/3/2015 12:00,171,116,55,8,9
4/3/2015 13:00,163,92,71,8,11
4/3/2015 14:00,298,185,113,9,13
4/3/2015 15:00,223,136,87,10,11
4/3/2015 16:00,273,150,123,9,7
4/3/2015 17:00,276,133,143,10,4
4/3/2015 18:00,243,139,104,9,6
4/3/2015 19:00,227,140,87,8,6
4/3/2015 20:00,146,70,76,6,2
4/3/2015 21:00,105,46,59,4,2
4/3/2015 22:00,119,51,68,3,7
4/3/2015 23:00,75,31,44,3,9
4/4/2015 0:00,67,22,45,4,7
4/4/2015 1:00,38,11,27,3,9
4/4/2015 2:00,27,9,18,3,11
4/4/2015 3:00,24,7,17,3,9
4/4/2015 4:00,11,4,7,3,11
4/4/2015 5:00,25,12,13,3,9
4/4/2015 6:00,25,20,5,3,7
4/4/2015 7:00,51,40,11,3,7
4/4/2015 8:00,96,66,30,3,7
4/4/2015 9:00,192,156,36,4,9
4/4/2015 10:00,317,224,93,5,9
4/4/2015 11:00,319,209,110,6,15
4/4/2015 12:00,366,226,140,8,17
4/4/2015 13:00,364,216,148,7,15
4/4/2015 14:00,318,166,152,9,15
4/4/2015 15:00,305,158,147,8,17
4/4/2015 16:00,288,129,159,8,13
4/4/2015 17:00,288,144,144,8,11
4/4/2015 18:00,266,120,146,8,11
4/4/2015 19:00,228,112,116,6,11
4/4/2015 20:00,188,100,88,5,7
4/4/2015 21:00,154,79,75,4,7
4/4/2015 22:00,121,65,56,3,7
4/4/2015 23:00,130,53,77,2,7
4/5/2015 0:00,113,55,58,2,7
4/5/2015 1:00,82,32,50,2,6
4/5/2015 2:00,63,11,52,1,6
4/5/2015 3:00,52,11,41,1,4
4/5/2015 4:00,38,18,20,0,4
4/5/2015 5:00,19,10,9,-1,4
4/5/2015 6:00,19,10,9,-1,4
4/5/2015 7:00,36,24,12,-1,4
4/5/2015 8:00,33,23,10,2,4
4/5/2015 9:00,106,77,29,4,4
4/5/2015 10:00,110,68,42,7,2
4/5/2015 11:00,140,87,53,8,7
4/5/2015 12:00,156,95,61,9,11
4/5/2015 13:00,185,103,82,9,11
4/5/2015 14:00,189,100,89,11,4
4/5/2015 15:00,223,114,109,10,6
4/5/2015 16:00,167,83,84,10,9
4/5/2015 17:00,212,120,92,10,9
4/5/2015 18:00,185,90,95,9,15
4/5/2015 19:00,161,81,80,8,7
4/5/2015 20:00,187,94,93,7,6
4/5/2015 21:00,104,53,51,6,7
4/5/2015 22:00,98,55,43,5,6
4/5/2015 23:00,91,43,48,5,7
4/6/2015 0:00,70,31,39,5,11
4/6/2015 1:00,55,22,33,5,9
4/6/2015 2:00,35,8,27,5,6
4/6/2015 3:00,18,5,13,5,6
4/6/2015 4:00,12,3,9,4,6
4/6/2015 5:00,25,11,14,4,4
4/6/2015 6:00,22,10,12,4,7
4/6/2015 7:00,22,14,8,5,4
4/6/2015 8:00,28,15,13,5,4
4/6/2015 9:00,73,42,31,5,4
4/6/2015 10:00,100,57,43,5,2
4/6/2015 11:00,153,99,54,6,4
4/6/2015 12:00,148,69,79,7,4
4/6/2015 13:00,145,76,69,8,6
4/6/2015 14:00,210,123,87,9,6
4/6/2015 15:00,218,114,104,11,9
4/6/2015 16:00,223,120,103,11,6
4/6/2015 17:00,266,140,126,11,6
4/6/2015 18:00,259,148,111,10,9
4/6/2015 19:00,259,140,119,8,7
4/6/2015 20:00,229,103,126,6,6
4/6/2015 21:00,175,67,108,4,2
4/6/2015 22:00,143,51,92,3,2
4/6/2015 23:00,72,24,48,2,2
4/7/2015 0:00,52,17,35,1,4
4/7/2015 1:00,21,10,11,0,2
4/7/2015 2:00,14,3,11,0,2
4/7/2015 3:00,5,2,3,-1,2
4/7/2015 4:00,6,5,1,-1,2
4/7/2015 5:00,50,35,15,-1,2
4/7/2015 6:00,125,90,35,-1,4
4/7/2015 7:00,481,309,172,-1,7
4/7/2015 8:00,816,470,346,1,4
4/7/2015 9:00,834,449,385,5,6
4/7/2015 10:00,873,430,443,8,6
4/7/2015 11:00,799,490,309,10,19
4/7/2015 12:00,850,504,346,11,17
4/7/2015 13:00,992,581,411,11,20
4/7/2015 14:00,994,543,451,11,22
4/7/2015 15:00,977,573,404,12,19
4/7/2015 16:00,1026,515,511,12,17
4/7/2015 17:00,1142,573,569,12,17
4/7/2015 18:00,1023,464,559,12,13
4/7/2015 19:00,713,356,357,11,11
4/7/2015 20:00,650,323,327,9,7
4/7/2015 21:00,395,188,207,8,9
4/7/2015 22:00,325,157,168,7,9
4/7/2015 23:00,384,226,158,8,9
4/8/2015 0:00,225,140,85,8,9
4/8/2015 1:00,156,50,106,8,6
4/8/2015 2:00,92,20,72,8,6
4/8/2015 3:00,106,16,90,8,6
4/8/2015 4:00,40,13,27,8,6
4/8/2015 5:00,51,31,20,7,6
4/8/2015 6:00,127,97,30,7,6
4/8/2015 7:00,651,485,166,7,6
4/8/2015 8:00,947,547,400,8,9
4/8/2015 9:00,979,593,386,8,9
4/8/2015 10:00,1063,533,530,9,7
4/8/2015 11:00,940,581,359,9,7
4/8/2015 12:00,949,522,427,9,7
4/8/2015 13:00,1045,601,444,11,7
4/8/2015 14:00,959,502,457,11,4
4/8/2015 15:00,929,508,421,11,7
4/8/2015 16:00,1030,473,557,12,4
4/8/2015 17:00,1064,540,524,12,6
4/8/2015 18:00,1061,489,572,11,4
4/8/2015 19:00,939,551,388,11,6
4/8/2015 20:00,675,360,315,11,7
4/8/2015 21:00,501,240,261,10,7
4/8/2015 22:00,391,177,214,10,7
4/8/2015 23:00,458,262,196,9,7
4/9/2015 0:00,386,227,159,9,6
4/9/2015 1:00,231,66,165,6,4
4/9/2015 2:00,153,21,132,4,4
4/9/2015 3:00,201,16,185,4,4
4/9/2015 4:00,122,21,101,5,6
4/9/2015 5:00,92,34,58,4,6
4/9/2015 6:00,141,89,52,3,4
4/9/2015 7:00,597,377,220,3,4
4/9/2015 8:00,1079,563,516,8,6
4/9/2015 9:00,899,574,325,9,4
4/9/2015 10:00,951,528,423,12,4
4/9/2015 11:00,884,542,342,14,4
4/9/2015 12:00,1036,593,443,15,4
4/9/2015 13:00,1129,601,528,16,11
4/9/2015 14:00,1019,590,429,17,6
4/9/2015 15:00,1188,685,503,17,6
4/9/2015 16:00,1232,699,533,18,4
4/9/2015 17:00,1244,639,605,18,2
4/9/2015 18:00,1165,558,607,17,6
4/9/2015 19:00,954,456,498,16,2
4/9/2015 20:00,632,282,350,13,0
4/9/2015 21:00,376,152,224,11,4
4/9/2015 22:00,379,138,241,11,4
4/9/2015 23:00,365,126,239,9,2
4/10/2015 0:00,188,52,136,8,2
4/10/2015 1:00,86,22,64,7,2
4/10/2015 2:00,72,21,51,6,2
4/10/2015 3:00,28,4,24,6,2
4/10/2015 4:00,27,10,17,5,2
4/10/2015 5:00,53,33,20,4,2
4/10/2015 6:00,128,100,28,4,4
4/10/2015 7:00,477,323,154,5,4
4/10/2015 8:00,926,553,373,9,4
4/10/2015 9:00,803,473,330,12,4
4/10/2015 10:00,814,499,315,15,6
4/10/2015 11:00,838,515,323,17,6
4/10/2015 12:00,998,571,427,18,4
4/10/2015 13:00,957,516,441,19,9
4/10/2015 14:00,1025,579,446,20,7
4/10/2015 15:00,1017,595,422,20,9
4/10/2015 16:00,1017,547,470,21,7
4/10/2015 17:00,1080,549,531,20,7
4/10/2015 18:00,1055,509,546,20,2
4/10/2015 19:00,864,401,463,19,4
4/10/2015 20:00,747,326,421,13,2
4/10/2015 21:00,568,237,331,10,6
4/10/2015 22:00,453,180,273,9,6
4/10/2015 23:00,372,151,221,9,6
4/11/2015 0:00,324,136,188,10,6
4/11/2015 1:00,266,110,156,11,6
4/11/2015 2:00,172,47,125,12,11
4/11/2015 3:00,168,41,127,11,11
4/11/2015 4:00,106,18,88,12,9
4/11/2015 5:00,71,30,41,13,9
4/11/2015 6:00,63,37,26,13,13
4/11/2015 7:00,103,74,29,13,13
4/11/2015 8:00,199,133,66,13,15
4/11/2015 9:00,382,298,84,15,20
4/11/2015 10:00,529,394,135,16,26
4/11/2015 11:00,567,363,204,16,28
4/11/2015 12:00,615,347,268,16,28
4/11/2015 13:00,582,323,259,15,39
4/11/2015 14:00,407,203,204,13,22
4/11/2015 15:00,386,189,197,13,24
4/11/2015 16:00,428,172,256,14,30
4/11/2015 17:00,473,257,216,14,22
4/11/2015 18:00,392,152,240,13,17
4/11/2015 19:00,341,185,156,8,22
4/11/2015 20:00,397,172,225,7,17
4/11/2015 21:00,306,143,163,6,13
4/11/2015 22:00,275,131,144,6,9
4/11/2015 23:00,211,83,128,6,9
4/12/2015 0:00,210,88,122,6,9
4/12/2015 1:00,231,109,122,5,9
4/12/2015 2:00,146,67,79,4,6
4/12/2015 3:00,189,89,100,3,6
4/12/2015 4:00,107,41,66,3,6
4/12/2015 5:00,72,22,50,2,4
4/12/2015 6:00,44,24,20,2,6
4/12/2015 7:00,49,34,15,3,6
4/12/2015 8:00,73,53,20,5,6
4/12/2015 9:00,183,128,55,8,13
4/12/2015 10:00,336,233,103,10,19
4/12/2015 11:00,342,199,143,12,19
4/12/2015 12:00,485,258,227,13,22
4/12/2015 13:00,588,297,291,14,20
4/12/2015 14:00,662,412,250,14,24
4/12/2015 15:00,613,362,251,14,26
4/12/2015 16:00,634,341,293,15,24
4/12/2015 17:00,603,309,294,15,20
4/12/2015 18:00,539,291,248,15,22
4/12/2015 19:00,530,224,306,14,17
4/12/2015 20:00,427,143,284,13,11
4/12/2015 21:00,247,81,166,13,15
4/12/2015 22:00,256,86,170,14,19
4/12/2015 23:00,113,46,67,14,26
4/13/2015 0:00,59,16,43,13,30
4/13/2015 1:00,19,11,8,12,35
4/13/2015 2:00,7,2,5,8,28
4/13/2015 3:00,4,2,2,7,19
4/13/2015 4:00,3,2,1,7,15
4/13/2015 5:00,51,38,13,7,19
4/13/2015 6:00,166,127,39,5,9
4/13/2015 7:00,806,589,217,6,9
4/13/2015 8:00,1189,682,507,7,13
4/13/2015 9:00,1011,641,370,8,15
4/13/2015 10:00,1026,546,480,9,15
4/13/2015 11:00,1035,566,469,10,13
4/13/2015 12:00,1082,562,520,11,19
4/13/2015 13:00,1221,669,552,12,20
4/13/2015 14:00,1168,588,580,12,15
4/13/2015 15:00,1378,748,630,12,17
4/13/2015 16:00,1395,681,714,12,19
4/13/2015 17:00,1698,847,851,13,15
4/13/2015 18:00,1437,671,766,12,13
4/13/2015 19:00,1147,618,529,11,9
4/13/2015 20:00,821,312,509,9,7
4/13/2015 21:00,462,192,270,8,7
4/13/2015 22:00,435,149,286,6,4
4/13/2015 23:00,257,89,168,5,2
4/14/2015 0:00,113,35,78,4,2
4/14/2015 1:00,75,22,53,3,2
4/14/2015 2:00,21,6,15,4,4
4/14/2015 3:00,8,8,0,3,6
4/14/2015 4:00,7,5,2,2,4
4/14/2015 5:00,56,50,6,2,6
4/14/2015 6:00,190,137,53,2,4
4/14/2015 7:00,973,693,280,5,4
4/14/2015 8:00,1545,926,619,8,7
4/14/2015 9:00,1268,700,568,10,15
4/14/2015 10:00,1363,670,693,13,15
4/14/2015 11:00,1182,658,524,15,19
4/14/2015 12:00,1276,668,608,17,26
4/14/2015 13:00,1379,762,617,18,28
4/14/2015 14:00,1358,662,696,18,26
4/14/2015 15:00,1400,788,612,20,30
4/14/2015 16:00,1605,814,791,21,30
4/14/2015 17:00,1707,929,778,20,37
4/14/2015 18:00,1621,718,903,19,28
4/14/2015 19:00,1328,678,650,18,24
4/14/2015 20:00,955,489,466,15,15
4/14/2015 21:00,624,266,358,13,9
4/14/2015 22:00,537,155,382,12,7
4/14/2015 23:00,286,100,186,12,4
4/15/2015 0:00,144,37,107,11,4
4/15/2015 1:00,113,19,94,9,7
4/15/2015 2:00,29,19,10,9,7
4/15/2015 3:00,13,5,8,8,7
4/15/2015 4:00,14,8,6,8,6
4/15/2015 5:00,54,40,14,6,6
4/15/2015 6:00,204,150,54,5,2
4/15/2015 7:00,1122,861,261,10,7
4/15/2015 8:00,1436,802,634,13,9
4/15/2015 9:00,1251,789,462,15,15
4/15/2015 10:00,1360,754,606,17,17
4/15/2015 11:00,1188,713,475,19,19
4/15/2015 12:00,1366,713,653,21,28
4/15/2015 13:00,1335,791,544,22,26
4/15/2015 14:00,1374,715,659,23,33
4/15/2015 15:00,1495,789,706,23,33
4/15/2015 16:00,1555,804,751,22,28
4/15/2015 17:00,1656,831,825,21,22
4/15/2015 18:00,1604,733,871,21,19
4/15/2015 19:00,1421,700,721,20,13
4/15/2015 20:00,1143,432,711,17,9
4/15/2015 21:00,802,278,524,15,15
4/15/2015 22:00,730,282,448,12,9
4/15/2015 23:00,500,188,312,10,15
4/16/2015 0:00,287,141,146,8,7
4/16/2015 1:00,176,46,130,7,9
4/16/2015 2:00,154,23,131,8,9
4/16/2015 3:00,110,13,97,8,6
4/16/2015 4:00,103,21,82,8,4
4/16/2015 5:00,61,32,29,8,4
4/16/2015 6:00,154,111,43,8,7
4/16/2015 7:00,851,580,271,9,13
4/16/2015 8:00,1340,765,575,9,11
4/16/2015 9:00,1018,616,402,9,11
4/16/2015 10:00,1099,592,507,10,9
4/16/2015 11:00,971,577,394,11,9
4/16/2015 12:00,1108,524,584,11,7
4/16/2015 13:00,1291,644,647,12,11
4/16/2015 14:00,1143,492,651,12,7
4/16/2015 15:00,1245,705,540,13,7
4/16/2015 16:00,1309,692,617,13,7
4/16/2015 17:00,1407,717,690,12,11
4/16/2015 18:00,1368,612,756,11,15
4/16/2015 19:00,1097,515,582,11,11
4/16/2015 20:00,770,372,398,10,7
4/16/2015 21:00,501,263,238,9,13
4/16/2015 22:00,467,206,261,9,9
4/16/2015 23:00,275,103,172,8,11
4/17/2015 0:00,173,67,106,8,13
4/17/2015 1:00,78,19,59,7,6
4/17/2015 2:00,51,6,45,7,9
4/17/2015 3:00,57,7,50,6,9
4/17/2015 4:00,65,9,56,5,4
4/17/2015 5:00,67,31,36,5,6
4/17/2015 6:00,179,139,40,4,6
4/17/2015 7:00,730,501,229,6,6
4/17/2015 8:00,1101,641,460,7,6
4/17/2015 9:00,920,535,385,7,9
4/17/2015 10:00,865,460,405,9,9
4/17/2015 11:00,807,488,319,10,11
4/17/2015 12:00,1056,568,488,10,11
4/17/2015 13:00,1110,554,556,10,11
4/17/2015 14:00,945,482,463,11,15
4/17/2015 15:00,943,523,420,12,17
4/17/2015 16:00,837,468,369,12,13
4/17/2015 17:00,915,484,431,12,13
4/17/2015 18:00,905,452,453,11,17
4/17/2015 19:00,830,407,423,10,13
4/17/2015 20:00,724,375,349,8,7
4/17/2015 21:00,518,246,272,7,6
4/17/2015 22:00,391,175,216,7,11
4/17/2015 23:00,328,122,206,5,9
4/18/2015 0:00,332,127,205,4,9
4/18/2015 1:00,284,112,172,4,9
4/18/2015 2:00,197,67,130,3,7
4/18/2015 3:00,155,63,92,2,6
4/18/2015 4:00,87,30,57,2,2
4/18/2015 5:00,68,38,30,0,4
4/18/2015 6:00,56,37,19,0,4
4/18/2015 7:00,129,104,25,3,4
4/18/2015 8:00,226,155,71,7,7
4/18/2015 9:00,456,347,109,9,11
4/18/2015 10:00,536,383,153,10,19
4/18/2015 11:00,649,412,237,12,19
4/18/2015 12:00,764,490,274,13,13
4/18/2015 13:00,737,457,280,12,9
4/18/2015 14:00,712,362,350,13,11
4/18/2015 15:00,729,379,350,13,9
4/18/2015 16:00,791,389,402,13,9
4/18/2015 17:00,777,352,425,13,9
4/18/2015 18:00,908,416,492,14,7
4/18/2015 19:00,712,349,363,12,9
4/18/2015 20:00,677,314,363,9,7
4/18/2015 21:00,490,245,245,9,7
4/18/2015 22:00,398,163,235,7,13
4/18/2015 23:00,329,151,178,6,11
4/19/2015 0:00,281,106,175,5,9
4/19/2015 1:00,249,97,152,4,6
4/19/2015 2:00,215,71,144,3,4
4/19/2015 3:00,164,44,120,2,0
4/19/2015 4:00,115,35,80,2,2
4/19/2015 5:00,74,26,48,1,2
4/19/2015 6:00,49,31,18,1,2
4/19/2015 7:00,44,31,13,1,2
4/19/2015 8:00,105,68,37,4,2
4/19/2015 9:00,225,158,67,6,7
4/19/2015 10:00,368,259,109,8,4
4/19/2015 11:00,364,232,132,10,6
4/19/2015 12:00,506,290,216,12,4
4/19/2015 13:00,608,355,253,13,6
4/19/2015 14:00,660,404,256,14,6
4/19/2015 15:00,759,434,325,15,2
4/19/2015 16:00,733,435,298,15,2
4/19/2015 17:00,741,409,332,15,11
4/19/2015 18:00,690,339,351,15,9
4/19/2015 19:00,597,260,337,14,13
4/19/2015 20:00,516,209,307,11,9
4/19/2015 21:00,308,123,185,9,11
4/19/2015 22:00,277,95,182,8,6
4/19/2015 23:00,167,51,116,8,4
4/20/2015 0:00,57,13,44,7,4
4/20/2015 1:00,36,6,30,5,4
4/20/2015 2:00,18,4,14,5,4
4/20/2015 3:00,6,3,3,4,4
4/20/2015 4:00,7,6,1,4,4
4/20/2015 5:00,56,36,20,3,6
4/20/2015 6:00,162,121,41,3,4
4/20/2015 7:00,818,596,222,7,2
4/20/2015 8:00,1163,649,514,10,4
4/20/2015 9:00,1025,652,373,12,6
4/20/2015 10:00,1135,599,536,13,11
4/20/2015 11:00,1013,593,420,15,15
4/20/2015 12:00,1228,609,619,16,11
4/20/2015 13:00,1247,633,614,17,7
4/20/2015 14:00,1230,608,622,18,13
4/20/2015 15:00,1430,791,639,18,11
4/20/2015 16:00,1634,858,776,19,13
4/20/2015 17:00,1873,1006,867,18,13
4/20/2015 18:00,1867,945,922,18,13
4/20/2015 19:00,1535,852,683,17,13
4/20/2015 20:00,982,454,528,14,9
4/20/2015 21:00,659,256,403,12,9
4/20/2015 22:00,475,162,313,11,7
4/20/2015 23:00,279,84,195,10,4
4/21/2015 0:00,180,30,150,8,4
4/21/2015 1:00,195,17,178,7,6
4/21/2015 2:00,97,10,87,6,4
4/21/2015 3:00,40,5,35,5,6
4/21/2015 4:00,27,8,19,4,7
4/21/2015 5:00,64,37,27,4,7
4/21/2015 6:00,188,141,47,4,6
4/21/2015 7:00,954,671,283,6,4
4/21/2015 8:00,1493,902,591,9,6
4/21/2015 9:00,1229,714,515,12,7
4/21/2015 10:00,1362,705,657,14,11
4/21/2015 11:00,1151,578,573,16,9
4/21/2015 12:00,1249,669,580,18,11
4/21/2015 13:00,1293,723,570,19,13
4/21/2015 14:00,1429,673,756,20,17
4/21/2015 15:00,1495,872,623,20,20
4/21/2015 16:00,1781,902,879,19,22
4/21/2015 17:00,1974,1061,913,18,22
4/21/2015 18:00,1833,886,947,17,15
4/21/2015 19:00,1518,792,726,15,17
4/21/2015 20:00,1206,565,641,11,20
4/21/2015 21:00,652,260,392,8,17
4/21/2015 22:00,634,183,451,7,19
4/21/2015 23:00,399,111,288,6,7
4/22/2015 0:00,200,83,117,5,6
4/22/2015 1:00,81,20,61,4,7
4/22/2015 2:00,41,3,38,5,6
4/22/2015 3:00,44,6,38,5,6
4/22/2015 4:00,34,13,21,6,7
4/22/2015 5:00,54,35,19,6,9
4/22/2015 6:00,167,128,39,6,11
4/22/2015 7:00,972,765,207,6,15
4/22/2015 8:00,1471,847,624,7,13
4/22/2015 9:00,1053,617,436,8,17
4/22/2015 10:00,1315,689,626,9,19
4/22/2015 11:00,1023,647,376,9,17
4/22/2015 12:00,1199,606,593,11,17
4/22/2015 13:00,1151,653,498,12,20
4/22/2015 14:00,1271,606,665,12,17
4/22/2015 15:00,1164,603,561,13,13
4/22/2015 16:00,1425,668,757,13,13
4/22/2015 17:00,1400,760,640,13,9
4/22/2015 18:00,1550,755,795,14,9
4/22/2015 19:00,1308,764,544,13,7
4/22/2015 20:00,1008,505,503,12,9
4/22/2015 21:00,712,269,443,10,9
4/22/2015 22:00,682,252,430,8,9
4/22/2015 23:00,423,160,263,7,7
4/23/2015 0:00,344,169,175,5,7
4/23/2015 1:00,165,71,94,4,0
4/23/2015 2:00,129,49,80,3,4
4/23/2015 3:00,125,19,106,2,2
4/23/2015 4:00,95,23,72,5,7
4/23/2015 5:00,103,48,55,5,7
4/23/2015 6:00,175,128,47,5,6
4/23/2015 7:00,778,542,236,5,6
4/23/2015 8:00,1390,814,576,5,7
4/23/2015 9:00,921,590,331,6,4
4/23/2015 10:00,1072,532,540,7,4
4/23/2015 11:00,900,538,362,8,4
4/23/2015 12:00,1115,512,603,10,4
4/23/2015 13:00,1160,634,526,12,11
4/23/2015 14:00,1318,663,655,12,9
4/23/2015 15:00,1212,690,522,13,7
4/23/2015 16:00,1474,781,693,15,6
4/23/2015 17:00,1592,839,753,15,9
4/23/2015 18:00,1599,774,825,16,4
4/23/2015 19:00,1367,719,648,15,2
4/23/2015 20:00,1031,501,530,12,0
4/23/2015 21:00,708,321,387,9,4
4/23/2015 22:00,541,218,323,7,4
4/23/2015 23:00,438,120,318,6,2
4/24/2015 0:00,227,57,170,5,2
4/24/2015 1:00,127,39,88,4,2
4/24/2015 2:00,79,30,49,3,2
4/24/2015 3:00,30,9,21,3,2
4/24/2015 4:00,31,16,15,2,2
4/24/2015 5:00,59,43,16,2,2
4/24/2015 6:00,143,110,33,2,4
4/24/2015 7:00,739,511,228,5,4
4/24/2015 8:00,1063,615,448,8,7
4/24/2015 9:00,841,523,318,11,7
4/24/2015 10:00,889,485,404,14,4
4/24/2015 11:00,930,550,380,16,13
4/24/2015 12:00,1145,623,522,17,15
4/24/2015 13:00,1154,589,565,19,17
4/24/2015 14:00,1113,533,580,19,17
4/24/2015 15:00,1141,625,516,20,15
4/24/2015 16:00,1003,536,467,20,20
4/24/2015 17:00,1166,665,501,20,11
4/24/2015 18:00,1123,612,511,19,17
4/24/2015 19:00,1056,632,424,18,6
4/24/2015 20:00,1016,623,393,16,6
4/24/2015 21:00,708,325,383,14,4
4/24/2015 22:00,654,188,466,13,4
4/24/2015 23:00,546,170,376,11,6
4/25/2015 0:00,425,146,279,10,6
4/25/2015 1:00,275,110,165,11,6
4/25/2015 2:00,174,51,123,10,6
4/25/2015 3:00,149,27,122,12,13
4/25/2015 4:00,120,44,76,12,6
4/25/2015 5:00,63,30,33,12,7
4/25/2015 6:00,74,53,21,12,6
4/25/2015 7:00,113,81,32,12,9
4/25/2015 8:00,225,164,61,12,11
4/25/2015 9:00,372,240,132,12,7
4/25/2015 10:00,306,201,105,11,19
4/25/2015 11:00,394,250,144,11,13
4/25/2015 12:00,491,280,211,13,15
4/25/2015 13:00,575,349,226,14,17
4/25/2015 14:00,552,323,229,14,15
4/25/2015 15:00,555,289,266,15,11
4/25/2015 16:00,540,271,269,15,17
4/25/2015 17:00,559,305,254,15,15
4/25/2015 18:00,595,273,322,14,19
4/25/2015 19:00,418,188,230,14,15
4/25/2015 20:00,507,267,240,13,11
4/25/2015 21:00,431,217,214,13,9
4/25/2015 22:00,351,152,199,13,9
4/25/2015 23:00,261,105,156,13,9
4/26/2015 0:00,271,100,171,12,7
4/26/2015 1:00,196,79,117,11,7
4/26/2015 2:00,157,54,103,10,6
4/26/2015 3:00,174,66,108,11,6
4/26/2015 4:00,87,17,70,11,9
4/26/2015 5:00,77,18,59,11,7
4/26/2015 6:00,45,25,20,11,7
4/26/2015 7:00,36,26,10,11,7
4/26/2015 8:00,78,53,25,12,9
4/26/2015 9:00,158,124,34,13,15
4/26/2015 10:00,271,185,86,14,15
4/26/2015 11:00,314,193,121,15,11
4/26/2015 12:00,374,233,141,16,24
4/26/2015 13:00,393,207,186,17,24
4/26/2015 14:00,474,281,193,16,17
4/26/2015 15:00,528,273,255,16,17
4/26/2015 16:00,587,322,265,15,9
4/26/2015 17:00,547,256,291,15,13
4/26/2015 18:00,494,227,267,12,13
4/26/2015 19:00,411,183,228,11,7
4/26/2015 20:00,389,136,253,11,7
4/26/2015 21:00,234,92,142,11,9
4/26/2015 22:00,264,98,166,10,11
4/26/2015 23:00,116,50,66,10,11
4/27/2015 0:00,56,22,34,9,9
4/27/2015 1:00,27,7,20,9,9
4/27/2015 2:00,6,1,5,9,9
4/27/2015 3:00,10,4,6,8,13
4/27/2015 4:00,7,4,3,8,13
4/27/2015 5:00,43,34,9,8,15
4/27/2015 6:00,114,88,26,7,15
4/27/2015 7:00,567,411,156,6,19
4/27/2015 8:00,968,536,432,7,11
4/27/2015 9:00,813,476,337,7,11
4/27/2015 10:00,884,458,426,8,17
4/27/2015 11:00,781,438,343,9,19
4/27/2015 12:00,1018,510,508,9,13
4/27/2015 13:00,1032,510,522,10,13
4/27/2015 14:00,986,496,490,11,13
4/27/2015 15:00,1126,596,530,12,15
4/27/2015 16:00,1238,619,619,12,19
4/27/2015 17:00,1406,691,715,11,15
4/27/2015 18:00,1326,629,697,11,11
4/27/2015 19:00,1000,510,490,10,11
4/27/2015 20:00,763,322,441,9,11
4/27/2015 21:00,434,170,264,7,13
4/27/2015 22:00,395,134,261,6,7
4/27/2015 23:00,235,71,164,5,6
4/28/2015 0:00,119,39,80,4,6
4/28/2015 1:00,52,11,41,2,6
4/28/2015 2:00,21,7,14,1,4
4/28/2015 3:00,8,4,4,0,4
4/28/2015 4:00,11,7,4,-1,2
4/28/2015 5:00,46,35,11,-1,2
4/28/2015 6:00,167,124,43,0,2
4/28/2015 7:00,801,598,203,1,4
4/28/2015 8:00,1488,933,555,4,2
4/28/2015 9:00,1045,583,462,7,11
4/28/2015 10:00,1165,548,617,8,11
4/28/2015 11:00,1029,584,445,10,11
4/28/2015 12:00,1074,543,531,11,19
4/28/2015 13:00,1182,643,539,11,19
4/28/2015 14:00,1008,497,511,6,30
4/28/2015 15:00,1074,541,533,9,17
4/28/2015 16:00,1413,677,736,9,15
4/28/2015 17:00,1493,793,700,9,7
4/28/2015 18:00,1405,657,748,10,24
4/28/2015 19:00,1307,714,593,9,15
4/28/2015 20:00,953,468,485,8,11
4/28/2015 21:00,462,200,262,6,6
4/28/2015 22:00,425,131,294,4,2
4/28/2015 23:00,604,152,452,3,2
4/29/2015 0:00,236,63,173,2,4
4/29/2015 1:00,106,41,65,2,4
4/29/2015 2:00,78,43,35,0,4
4/29/2015 3:00,47,39,8,1,7
4/29/2015 4:00,27,19,8,1,6
4/29/2015 5:00,64,35,29,0,6
4/29/2015 6:00,178,139,39,1,6
4/29/2015 7:00,914,671,243,2,9
4/29/2015 8:00,1341,738,603,5,13
4/29/2015 9:00,1130,693,437,9,9
4/29/2015 10:00,1293,684,609,11,15
4/29/2015 11:00,1006,624,382,12,15
4/29/2015 12:00,1222,664,558,13,19
4/29/2015 13:00,1114,622,492,13,17
4/29/2015 14:00,1191,561,630,14,15
4/29/2015 15:00,1079,574,505,14,19
4/29/2015 16:00,1328,610,718,14,11
4/29/2015 17:00,1366,720,646,14,13
4/29/2015 18:00,1440,698,742,14,15
4/29/2015 19:00,1174,609,565,13,13
4/29/2015 20:00,789,337,452,12,6
4/29/2015 21:00,538,226,312,11,7
4/29/2015 22:00,516,193,323,10,6
4/29/2015 23:00,333,94,239,9,7
4/30/2015 0:00,181,46,135,9,9
4/30/2015 1:00,98,31,67,9,7
4/30/2015 2:00,51,12,39,9,26
4/30/2015 3:00,36,10,26,8,6
4/30/2015 4:00,27,10,17,8,7
4/30/2015 5:00,47,35,12,8,7
4/30/2015 6:00,132,92,40,8,9
4/30/2015 7:00,625,445,180,8,11
4/30/2015 8:00,1276,706,570,10,15
4/30/2015 9:00,942,590,352,11,20
4/30/2015 10:00,1137,607,530,11,22
4/30/2015 11:00,871,511,360,12,24
4/30/2015 12:00,1081,525,556,12,19
4/30/2015 13:00,1070,557,513,13,20
4/30/2015 14:00,1115,531,584,13,17
4/30/2015 15:00,1111,623,488,13,11
4/30/2015 16:00,1211,625,586,14,22
4/30/2015 17:00,1158,586,572,7,26
4/30/2015 18:00,881,401,480,9,6
4/30/2015 19:00,793,421,372,8,6
4/30/2015 20:00,676,377,299,9,7
4/30/2015 21:00,604,341,263,8,7
4/30/2015 22:00,443,284,159,7,7
4/30/2015 23:00,320,203,117,5,6
5/1/2015 0:00,361,204,157,4,6
5/1/2015 1:00,350,155,195,3,4
5/1/2015 2:00,268,63,205,2,2
5/1/2015 3:00,264,49,215,1,2
5/1/2015 4:00,156,28,128,1,2
5/1/2015 5:00,110,28,82,3,7
5/1/2015 6:00,56,22,34,3,6
5/1/2015 7:00,71,51,20,5,9
5/1/2015 8:00,78,55,23,7,11
5/1/2015 9:00,209,133,76,9,7
5/1/2015 10:00,321,186,135,9,9
5/1/2015 11:00,441,260,181,10,9
5/1/2015 12:00,481,292,189,11,9
5/1/2015 13:00,509,306,203,12,6
5/1/2015 14:00,585,368,217,12,4
5/1/2015 15:00,459,249,210,12,6
5/1/2015 16:00,501,288,213,13,7
5/1/2015 17:00,540,319,221,12,9
5/1/2015 18:00,535,264,271,12,7
5/1/2015 19:00,489,263,226,12,11
5/1/2015 20:00,445,189,256,9,6
5/1/2015 21:00,308,125,183,8,9
5/1/2015 22:00,315,134,181,7,9
5/1/2015 23:00,282,89,193,6,7
5/2/2015 0:00,188,52,136,5,7
5/2/2015 1:00,138,29,109,4,2
5/2/2015 2:00,120,35,85,4,2
5/2/2015 3:00,60,27,33,3,2
5/2/2015 4:00,30,14,16,2,2
5/2/2015 5:00,43,31,12,1,2
5/2/2015 6:00,53,43,10,1,2
5/2/2015 7:00,114,90,24,4,2
5/2/2015 8:00,171,123,48,7,4
5/2/2015 9:00,350,283,67,9,4
5/2/2015 10:00,527,392,135,10,2
5/2/2015 11:00,626,422,204,11,4
5/2/2015 12:00,704,433,271,11,6
5/2/2015 13:00,653,384,269,12,4
5/2/2015 14:00,633,288,345,14,6
5/2/2015 15:00,700,349,351,14,6
5/2/2015 16:00,559,249,310,15,7
5/2/2015 17:00,573,248,325,15,4
5/2/2015 18:00,616,254,362,15,4
5/2/2015 19:00,590,277,313,14,4
5/2/2015 20:00,431,201,230,12,6
5/2/2015 21:00,307,135,172,10,6
5/2/2015 22:00,220,95,125,10,9
5/2/2015 23:00,267,85,182,10,9
5/3/2015 0:00,189,61,128,11,9
5/3/2015 1:00,157,61,96,10,11
5/3/2015 2:00,123,32,91,9,11
5/3/2015 3:00,97,27,70,9,11
5/3/2015 4:00,23,4,19,9,9
5/3/2015 5:00,45,20,25,8,9
5/3/2015 6:00,40,23,17,9,9
5/3/2015 7:00,49,31,18,11,11
5/3/2015 8:00,73,60,13,12,17
5/3/2015 9:00,191,154,37,14,11
5/3/2015 10:00,334,229,105,16,13
5/3/2015 11:00,310,209,101,17,15
5/3/2015 12:00,448,293,155,18,15
5/3/2015 13:00,538,350,188,18,15
5/3/2015 14:00,563,319,244,18,13
5/3/2015 15:00,498,233,265,17,13
5/3/2015 16:00,368,139,229,15,15
5/3/2015 17:00,327,100,227,14,11
5/3/2015 18:00,347,107,240,14,13
5/3/2015 19:00,258,102,156,15,11
5/3/2015 20:00,207,67,140,15,15
5/3/2015 21:00,125,42,83,15,11
5/3/2015 22:00,163,65,98,15,11
5/3/2015 23:00,107,37,70,15,13
5/4/2015 0:00,58,18,40,15,13
5/4/2015 1:00,21,7,14,14,13
5/4/2015 2:00,7,2,5,14,13
5/4/2015 3:00,3,3,0,13,13
5/4/2015 4:00,10,6,4,13,13
5/4/2015 5:00,50,38,12,13,13
5/4/2015 6:00,139,105,34,13,11
5/4/2015 7:00,701,525,176,13,9
5/4/2015 8:00,1046,580,466,15,11
5/4/2015 9:00,860,528,332,14,9
5/4/2015 10:00,983,532,451,16,15
5/4/2015 11:00,797,451,346,17,20
5/4/2015 12:00,1052,505,547,17,15
5/4/2015 13:00,1014,499,515,18,13
5/4/2015 14:00,1098,505,593,18,15
5/4/2015 15:00,1131,595,536,19,17
5/4/2015 16:00,1378,662,716,19,9
5/4/2015 17:00,1501,759,742,19,13
5/4/2015 18:00,1494,686,808,19,7
5/4/2015 19:00,1070,551,519,19,2
5/4/2015 20:00,871,381,490,17,7
5/4/2015 21:00,603,260,343,16,7
5/4/2015 22:00,503,179,324,16,9
5/4/2015 23:00,245,70,175,17,11
5/5/2015 0:00,116,43,73,16,9
5/5/2015 1:00,46,9,37,15,11
5/5/2015 2:00,10,4,6,14,13
5/5/2015 3:00,9,3,6,14,13
5/5/2015 4:00,7,4,3,14,13
5/5/2015 5:00,54,41,13,14,9
5/5/2015 6:00,165,125,40,15,13
5/5/2015 7:00,802,588,214,18,17
5/5/2015 8:00,1382,817,565,19,19
5/5/2015 9:00,962,501,461,20,22
5/5/2015 10:00,1088,521,567,19,17
5/5/2015 11:00,896,512,384,20,24
5/5/2015 12:00,1032,539,493,22,26
5/5/2015 13:00,1094,573,521,24,33
5/5/2015 14:00,1099,557,542,23,24
5/5/2015 15:00,920,481,439,19,24
5/5/2015 16:00,1184,533,651,15,35
5/5/2015 17:00,1301,704,597,17,43
5/5/2015 18:00,1243,551,692,17,33
5/5/2015 19:00,1259,639,620,16,24
5/5/2015 20:00,861,437,424,15,11
5/5/2015 21:00,542,259,283,13,7
5/5/2015 22:00,483,160,323,11,7
5/5/2015 23:00,300,78,222,11,9
5/6/2015 0:00,155,53,102,10,9
5/6/2015 1:00,76,15,61,11,11
5/6/2015 2:00,22,11,11,11,9
5/6/2015 3:00,11,5,6,11,11
5/6/2015 4:00,11,10,1,11,11
5/6/2015 5:00,64,42,22,11,11
5/6/2015 6:00,178,139,39,11,11
5/6/2015 7:00,819,603,216,12,17
5/6/2015 8:00,1383,779,604,13,19
5/6/2015 9:00,1047,624,423,14,24
5/6/2015 10:00,1218,607,611,15,26
5/6/2015 11:00,955,598,357,16,22
5/6/2015 12:00,1090,565,525,16,26
5/6/2015 13:00,1098,553,545,17,24
5/6/2015 14:00,1136,519,617,17,28
5/6/2015 15:00,990,474,516,12,33
5/6/2015 16:00,1213,598,615,16,28
5/6/2015 17:00,1406,743,663,17,33
5/6/2015 18:00,1278,629,649,12,54
5/6/2015 19:00,1070,584,486,13,15
5/6/2015 20:00,915,467,448,12,11
5/6/2015 21:00,442,201,241,10,17
5/6/2015 22:00,536,203,333,10,13
5/6/2015 23:00,512,175,337,11,15
5/7/2015 0:00,182,75,107,11,24
5/7/2015 1:00,150,29,121,11,20
5/7/2015 2:00,100,15,85,11,20
5/7/2015 3:00,73,21,52,10,17
5/7/2015 4:00,45,18,27,10,22
5/7/2015 5:00,53,34,19,10,22
5/7/2015 6:00,169,131,38,10,22
5/7/2015 7:00,741,522,219,10,20
5/7/2015 8:00,1303,767,536,11,20
5/7/2015 9:00,843,491,352,11,22
5/7/2015 10:00,949,482,467,11,20
5/7/2015 11:00,695,378,317,12,19
5/7/2015 12:00,906,411,495,13,22
5/7/2015 13:00,942,499,443,13,28
5/7/2015 14:00,933,443,490,14,24
5/7/2015 15:00,1060,582,478,15,30
5/7/2015 16:00,1239,605,634,15,15
5/7/2015 17:00,1181,600,581,14,20
5/7/2015 18:00,1184,566,618,14,13
5/7/2015 19:00,1052,527,525,14,15
5/7/2015 20:00,672,317,355,13,7
5/7/2015 21:00,642,338,304,10,4
5/7/2015 22:00,392,198,194,9,4
5/7/2015 23:00,407,215,192,8,2
5/8/2015 0:00,258,155,103,8,6
5/8/2015 1:00,140,30,110,8,4
5/8/2015 2:00,153,6,147,8,2
5/8/2015 3:00,130,5,125,7,2
5/8/2015 4:00,66,19,47,8,4
5/8/2015 5:00,87,42,45,8,4
5/8/2015 6:00,178,138,40,8,4
5/8/2015 7:00,673,495,178,10,6
5/8/2015 8:00,1037,614,423,11,6
5/8/2015 9:00,860,492,368,13,6
5/8/2015 10:00,910,511,399,14,9
5/8/2015 11:00,815,483,332,16,7
5/8/2015 12:00,1006,529,477,17,4
5/8/2015 13:00,1099,546,553,17,7
5/8/2015 14:00,1100,548,552,18,7
5/8/2015 15:00,1021,517,504,18,7
5/8/2015 16:00,1010,551,459,19,4
5/8/2015 17:00,1026,545,481,19,4
5/8/2015 18:00,1071,509,562,18,0
5/8/2015 19:00,923,447,476,17,4
5/8/2015 20:00,659,329,330,16,4
5/8/2015 21:00,477,250,227,14,2
5/8/2015 22:00,466,177,289,12,2
5/8/2015 23:00,343,122,221,11,2
5/9/2015 0:00,305,134,171,12,2
5/9/2015 1:00,286,116,170,12,2
5/9/2015 2:00,164,45,119,12,4
5/9/2015 3:00,159,49,110,12,6
5/9/2015 4:00,60,12,48,13,7
5/9/2015 5:00,83,30,53,14,9
5/9/2015 6:00,66,43,23,14,11
5/9/2015 7:00,146,116,30,15,13
5/9/2015 8:00,303,195,108,15,17
5/9/2015 9:00,423,291,132,15,24
5/9/2015 10:00,498,343,155,16,24
5/9/2015 11:00,553,366,187,17,32
5/9/2015 12:00,629,402,227,17,35
5/9/2015 13:00,702,420,282,17,30
5/9/2015 14:00,736,389,347,18,28
5/9/2015 15:00,673,326,347,18,32
5/9/2015 16:00,669,305,364,18,39
5/9/2015 17:00,629,272,357,17,37
5/9/2015 18:00,533,226,307,16,26
5/9/2015 19:00,523,232,291,13,15
5/9/2015 20:00,430,194,236,13,19
5/9/2015 21:00,284,135,149,12,26
5/9/2015 22:00,285,125,160,12,17
5/9/2015 23:00,248,111,137,12,20
5/10/2015 0:00,241,90,151,12,22
5/10/2015 1:00,245,102,143,11,20
5/10/2015 2:00,127,41,86,10,20
5/10/2015 3:00,142,48,94,9,20
5/10/2015 4:00,72,26,46,9,19
5/10/2015 5:00,46,20,26,8,13
5/10/2015 6:00,44,18,26,8,11
5/10/2015 7:00,60,44,16,9,13
5/10/2015 8:00,135,95,40,9,17
5/10/2015 9:00,261,208,53,11,15
5/10/2015 10:00,325,236,89,11,13
5/10/2015 11:00,350,214,136,13,11
5/10/2015 12:00,494,333,161,14,13
5/10/2015 13:00,634,410,224,15,9
5/10/2015 14:00,670,435,235,16,6
5/10/2015 15:00,711,396,315,17,9
5/10/2015 16:00,548,284,264,17,7
5/10/2015 17:00,817,304,513,17,6
5/10/2015 18:00,638,275,363,17,6
5/10/2015 19:00,503,198,305,17,6
5/10/2015 20:00,405,163,242,15,4
5/10/2015 21:00,255,69,186,13,6
5/10/2015 22:00,230,69,161,13,4
5/10/2015 23:00,124,51,73,12,6
5/11/2015 0:00,60,24,36,12,6
5/11/2015 1:00,44,11,33,12,9
5/11/2015 2:00,15,7,8,11,7
5/11/2015 3:00,7,2,5,11,7
5/11/2015 4:00,15,10,5,10,9
5/11/2015 5:00,51,36,15,10,7
5/11/2015 6:00,162,113,49,11,6
5/11/2015 7:00,757,544,213,11,7
5/11/2015 8:00,1209,668,541,14,7
5/11/2015 9:00,939,562,377,17,9
5/11/2015 10:00,1011,556,455,20,7
5/11/2015 11:00,919,517,402,20,17
5/11/2015 12:00,1117,600,517,22,15
5/11/2015 13:00,1146,610,536,24,24
5/11/2015 14:00,1133,518,615,24,17
5/11/2015 15:00,1201,617,584,25,17
5/11/2015 16:00,1506,739,767,25,15
5/11/2015 17:00,1664,829,835,25,17
5/11/2015 18:00,1570,711,859,25,13
5/11/2015 19:00,1328,661,667,24,6
5/11/2015 20:00,968,373,595,21,6
5/11/2015 21:00,768,371,397,19,6
5/11/2015 22:00,553,194,359,17,6
5/11/2015 23:00,334,105,229,17,6
5/12/2015 0:00,161,53,108,15,2
5/12/2015 1:00,57,11,46,13,2
5/12/2015 2:00,39,11,28,13,4
5/12/2015 3:00,19,6,13,13,2
5/12/2015 4:00,20,9,11,13,6
5/12/2015 5:00,44,30,14,13,2
5/12/2015 6:00,200,142,58,15,6
5/12/2015 7:00,826,582,244,16,2
5/12/2015 8:00,1436,863,573,17,7
5/12/2015 9:00,1061,590,471,19,7
5/12/2015 10:00,1380,696,684,20,17
5/12/2015 11:00,1024,594,430,21,26
5/12/2015 12:00,1196,622,574,21,24
5/12/2015 13:00,1184,592,592,22,32
5/12/2015 14:00,1268,556,712,21,30
5/12/2015 15:00,1108,572,536,20,37
5/12/2015 16:00,1494,707,787,19,19
5/12/2015 17:00,1591,822,769,18,32
5/12/2015 18:00,1401,665,736,17,19
5/12/2015 19:00,1237,676,561,15,19
5/12/2015 20:00,971,455,516,14,22
5/12/2015 21:00,552,205,347,12,9
5/12/2015 22:00,504,178,326,10,6
5/12/2015 23:00,439,115,324,11,7
5/13/2015 0:00,166,43,123,10,7
5/13/2015 1:00,72,21,51,11,9
5/13/2015 2:00,42,11,31,10,9
5/13/2015 3:00,11,3,8,10,7
5/13/2015 4:00,15,11,4,9,7
5/13/2015 5:00,50,36,14,6,4
5/13/2015 6:00,184,145,39,8,6
5/13/2015 7:00,938,694,244,10,11
5/13/2015 8:00,1377,800,577,12,13
5/13/2015 9:00,1106,626,480,14,15
5/13/2015 10:00,1280,650,630,15,15
5/13/2015 11:00,1131,705,426,15,22
5/13/2015 12:00,1344,707,637,17,20
5/13/2015 13:00,1243,633,610,17,22
5/13/2015 14:00,1201,573,628,18,22
5/13/2015 15:00,1173,590,583,18,19
5/13/2015 16:00,1375,636,739,17,15
5/13/2015 17:00,1349,705,644,18,13
5/13/2015 18:00,1271,558,713,16,17
5/13/2015 19:00,1109,530,579,15,19
5/13/2015 20:00,915,443,472,14,15
5/13/2015 21:00,755,373,382,12,13
5/13/2015 22:00,577,240,337,10,15
5/13/2015 23:00,557,230,327,9,11
5/14/2015 0:00,474,257,217,8,7
5/14/2015 1:00,499,270,229,7,6
5/14/2015 2:00,339,135,204,6,4
5/14/2015 3:00,248,108,140,7,4
5/14/2015 4:00,168,73,95,7,7
5/14/2015 5:00,104,46,58,8,6
5/14/2015 6:00,67,40,27,8,6
5/14/2015 7:00,91,67,24,9,6
5/14/2015 8:00,128,76,52,9,7
5/14/2015 9:00,219,153,66,10,9
5/14/2015 10:00,286,183,103,10,6
5/14/2015 11:00,357,185,172,11,4
5/14/2015 12:00,374,203,171,11,4
5/14/2015 13:00,413,239,174,12,9
5/14/2015 14:00,556,303,253,14,6
5/14/2015 15:00,707,424,283,14,6
5/14/2015 16:00,588,308,280,14,9
5/14/2015 17:00,641,352,289,15,13
5/14/2015 18:00,768,359,409,15,11
5/14/2015 19:00,582,294,288,14,13
5/14/2015 20:00,441,219,222,12,11
5/14/2015 21:00,366,150,216,10,9
5/14/2015 22:00,317,133,184,8,7
5/14/2015 23:00,226,77,149,8,7
5/15/2015 0:00,160,46,114,8,4
5/15/2015 1:00,77,21,56,8,11
5/15/2015 2:00,40,9,31,7,11
5/15/2015 3:00,10,5,5,7,13
5/15/2015 4:00,17,7,10,6,11
5/15/2015 5:00,27,16,11,5,9
5/15/2015 6:00,134,100,34,6,11
5/15/2015 7:00,350,262,88,8,11
5/15/2015 8:00,679,426,253,9,15
5/15/2015 9:00,665,404,261,10,13
5/15/2015 10:00,881,566,315,11,15
5/15/2015 11:00,789,474,315,12,15
5/15/2015 12:00,900,517,383,13,11
5/15/2015 13:00,893,531,362,13,9
5/15/2015 14:00,907,453,454,14,6
5/15/2015 15:00,886,483,403,15,9
5/15/2015 16:00,892,433,459,16,9
5/15/2015 17:00,919,399,520,16,11
5/15/2015 18:00,827,337,490,16,9
5/15/2015 19:00,719,331,388,15,9
5/15/2015 20:00,569,256,313,13,11
5/15/2015 21:00,465,213,252,11,4
5/15/2015 22:00,388,178,210,10,6
5/15/2015 23:00,298,124,174,8,6
5/16/2015 0:00,215,78,137,7,6
5/16/2015 1:00,209,69,140,6,4
5/16/2015 2:00,153,48,105,5,4
5/16/2015 3:00,79,21,58,4,2
5/16/2015 4:00,59,14,45,4,2
5/16/2015 5:00,63,39,24,4,2
5/16/2015 6:00,68,46,22,6,4
5/16/2015 7:00,187,159,28,8,9
5/16/2015 8:00,345,291,54,9,13
5/16/2015 9:00,404,318,86,10,15
5/16/2015 10:00,524,303,221,10,13
5/16/2015 11:00,512,322,190,10,13
5/16/2015 12:00,488,288,200,10,13
5/16/2015 13:00,487,241,246,10,15
5/16/2015 14:00,491,237,254,11,17
5/16/2015 15:00,492,239,253,12,15
5/16/2015 16:00,442,219,223,12,15
5/16/2015 17:00,336,126,210,13,17
5/16/2015 18:00,386,147,239,13,17
5/16/2015 19:00,408,219,189,13,20
5/16/2015 20:00,349,186,163,12,22
5/16/2015 21:00,237,140,97,10,15
5/16/2015 22:00,214,107,107,7,11
5/16/2015 23:00,192,77,115,6,9
5/17/2015 0:00,201,100,101,6,7
5/17/2015 1:00,187,53,134,5,7
5/17/2015 2:00,143,36,107,5,7
5/17/2015 3:00,92,19,73,3,2
5/17/2015 4:00,62,18,44,4,4
5/17/2015 5:00,55,16,39,3,2
5/17/2015 6:00,37,23,14,4,7
5/17/2015 7:00,47,33,14,9,9
5/17/2015 8:00,96,68,28,11,17
5/17/2015 9:00,216,175,41,13,17
5/17/2015 10:00,258,191,67,12,17
5/17/2015 11:00,289,174,115,14,22
5/17/2015 12:00,319,165,154,14,19
5/17/2015 13:00,347,194,153,15,30
5/17/2015 14:00,449,257,192,15,20
5/17/2015 15:00,461,239,222,16,24
5/17/2015 16:00,418,201,217,16,20
5/17/2015 17:00,517,247,270,16,17
5/17/2015 18:00,452,211,241,16,19
5/17/2015 19:00,422,185,237,15,17
5/17/2015 20:00,331,123,208,13,13
5/17/2015 21:00,187,69,118,11,7
5/17/2015 22:00,221,82,139,9,2
5/17/2015 23:00,155,41,114,6,4
5/18/2015 0:00,68,31,37,6,4
5/18/2015 1:00,28,6,22,6,2
5/18/2015 2:00,9,4,5,5,4
5/18/2015 3:00,10,3,7,5,4
5/18/2015 4:00,12,6,6,6,2
5/18/2015 5:00,42,27,15,5,2
5/18/2015 6:00,152,126,26,7,4
5/18/2015 7:00,720,523,197,8,7
5/18/2015 8:00,1164,677,487,10,9
5/18/2015 9:00,895,550,345,12,9
5/18/2015 10:00,1025,565,460,15,11
5/18/2015 11:00,775,428,347,15,22
5/18/2015 12:00,1050,520,530,16,26
5/18/2015 13:00,1018,522,496,17,24
5/18/2015 14:00,1069,523,546,18,26
5/18/2015 15:00,1097,531,566,18,20
5/18/2015 16:00,1268,577,691,19,24
5/18/2015 17:00,1524,766,758,19,22
5/18/2015 18:00,1397,641,756,19,20
5/18/2015 19:00,1107,579,528,19,15
5/18/2015 20:00,808,361,447,18,24
5/18/2015 21:00,524,255,269,13,37
5/18/2015 22:00,450,157,293,13,19
5/18/2015 23:00,237,70,167,13,17
5/19/2015 0:00,138,36,102,12,13
5/19/2015 1:00,67,10,57,11,11
5/19/2015 2:00,32,4,28,10,13
5/19/2015 3:00,17,5,12,10,13
5/19/2015 4:00,16,10,6,10,17
5/19/2015 5:00,41,31,10,10,19
5/19/2015 6:00,155,120,35,10,22
5/19/2015 7:00,719,477,242,10,22
5/19/2015 8:00,1264,753,511,10,20
5/19/2015 9:00,930,566,364,11,30
5/19/2015 10:00,1176,627,549,11,28
5/19/2015 11:00,883,463,420,13,28
5/19/2015 12:00,1074,574,500,15,28
5/19/2015 13:00,1078,579,499,15,30
5/19/2015 14:00,1113,485,628,15,28
5/19/2015 15:00,1094,589,505,12,30
5/19/2015 16:00,1253,618,635,11,17
5/19/2015 17:00,1345,718,627,12,17
5/19/2015 18:00,1362,591,771,13,19
5/19/2015 19:00,1199,686,513,12,20
5/19/2015 20:00,817,464,353,12,11
5/19/2015 21:00,526,246,280,10,6
5/19/2015 22:00,524,201,323,9,9
5/19/2015 23:00,353,115,238,8,7
5/20/2015 0:00,147,39,108,8,9
5/20/2015 1:00,83,29,54,8,7
5/20/2015 2:00,32,6,26,7,7
5/20/2015 3:00,28,8,20,7,7
5/20/2015 4:00,34,14,20,7,9
5/20/2015 5:00,62,38,24,6,9
5/20/2015 6:00,167,135,32,7,9
5/20/2015 7:00,858,659,199,8,13
5/20/2015 8:00,1423,805,618,9,13
5/20/2015 9:00,1085,624,461,11,17
5/20/2015 10:00,1278,637,641,12,19
5/20/2015 11:00,977,577,400,12,22
5/20/2015 12:00,1255,686,569,14,15
5/20/2015 13:00,1014,548,466,15,17
5/20/2015 14:00,1081,556,525,14,19
5/20/2015 15:00,980,500,480,10,30
5/20/2015 16:00,1226,548,678,13,7
5/20/2015 17:00,1276,656,620,14,17
5/20/2015 18:00,1262,627,635,13,19
5/20/2015 19:00,1032,557,475,12,7
5/20/2015 20:00,867,413,454,10,26
5/20/2015 21:00,619,303,316,8,4
5/20/2015 22:00,542,222,320,8,7
5/20/2015 23:00,401,165,236,7,4
5/21/2015 0:00,359,143,216,6,6
5/21/2015 1:00,191,63,128,6,6
5/21/2015 2:00,122,37,85,5,6
5/21/2015 3:00,101,27,74,4,6
5/21/2015 4:00,98,31,67,5,6
5/21/2015 5:00,64,42,22,6,6
5/21/2015 6:00,173,134,39,7,7
5/21/2015 7:00,729,513,216,8,9
5/21/2015 8:00,1309,749,560,9,13
5/21/2015 9:00,938,591,347,11,11
5/21/2015 10:00,1157,621,536,12,13
5/21/2015 11:00,871,489,382,13,15
5/21/2015 12:00,1098,532,566,14,13
5/21/2015 13:00,1060,578,482,16,17
5/21/2015 14:00,1223,620,603,15,20
5/21/2015 15:00,1183,663,520,17,13
5/21/2015 16:00,1445,696,749,17,9
5/21/2015 17:00,1318,690,628,17,13
5/21/2015 18:00,1338,642,696,15,9
5/21/2015 19:00,1043,516,527,15,7
5/21/2015 20:00,690,331,359,14,6
5/21/2015 21:00,526,274,252,13,4
5/21/2015 22:00,412,195,217,13,7
5/21/2015 23:00,393,143,250,12,6
5/22/2015 0:00,182,59,123,10,4
5/22/2015 1:00,111,23,88,9,2
5/22/2015 2:00,75,18,57,8,2
5/22/2015 3:00,81,9,72,7,2
5/22/2015 4:00,70,17,53,7,4
5/22/2015 5:00,60,30,30,7,4
5/22/2015 6:00,135,107,28,8,4
5/22/2015 7:00,641,429,212,11,6
5/22/2015 8:00,1013,614,399,12,7
5/22/2015 9:00,809,506,303,15,13
5/22/2015 10:00,832,478,354,16,15
5/22/2015 11:00,758,468,290,17,13
5/22/2015 12:00,935,479,456,18,13
5/22/2015 13:00,899,462,437,19,13
5/22/2015 14:00,963,465,498,19,15
5/22/2015 15:00,948,485,463,19,11
5/22/2015 16:00,860,446,414,20,13
5/22/2015 17:00,888,428,460,19,11
5/22/2015 18:00,892,418,474,19,9
5/22/2015 19:00,694,346,348,19,9
5/22/2015 20:00,552,234,318,18,4
5/22/2015 21:00,378,185,193,16,4
5/22/2015 22:00,302,125,177,16,7
5/22/2015 23:00,309,120,189,15,9
5/23/2015 0:00,248,109,139,15,6
5/23/2015 1:00,176,64,112,15,6
5/23/2015 2:00,168,69,99,14,2
5/23/2015 3:00,107,24,83,13,6
5/23/2015 4:00,85,32,53,13,7
5/23/2015 5:00,54,30,24,13,2
5/23/2015 6:00,63,45,18,13,6
5/23/2015 7:00,130,103,27,14,2
5/23/2015 8:00,247,177,70,14,7
5/23/2015 9:00,417,319,98,16,7
5/23/2015 10:00,530,363,167,16,9
5/23/2015 11:00,595,413,182,16,13
5/23/2015 12:00,628,411,217,15,15
5/23/2015 13:00,577,314,263,14,17
5/23/2015 14:00,639,340,299,13,11
5/23/2015 15:00,578,247,331,13,13
5/23/2015 16:00,461,199,262,13,11
5/23/2015 17:00,538,209,329,14,7
5/23/2015 18:00,488,228,260,15,9
5/23/2015 19:00,477,251,226,14,7
5/23/2015 20:00,359,170,189,14,6
5/23/2015 21:00,229,105,124,12,7
5/23/2015 22:00,247,135,112,11,9
5/23/2015 23:00,263,120,143,10,11
5/24/2015 0:00,188,79,109,8,7
5/24/2015 1:00,188,65,123,6,4
5/24/2015 2:00,115,29,86,5,4
5/24/2015 3:00,77,14,63,6,2
5/24/2015 4:00,54,10,44,7,2
5/24/2015 5:00,54,22,32,7,2
5/24/2015 6:00,37,22,15,8,6
5/24/2015 7:00,39,23,16,10,7
5/24/2015 8:00,79,55,24,12,6
5/24/2015 9:00,201,134,67,12,4
5/24/2015 10:00,295,183,112,15,4
5/24/2015 11:00,348,201,147,15,6
5/24/2015 12:00,331,155,176,16,11
5/24/2015 13:00,409,254,155,16,7
5/24/2015 14:00,458,251,207,17,7
5/24/2015 15:00,402,230,172,18,7
5/24/2015 16:00,454,231,223,19,7
5/24/2015 17:00,468,260,208,20,7
5/24/2015 18:00,451,248,203,19,9
5/24/2015 19:00,413,214,199,19,13
5/24/2015 20:00,317,159,158,18,11
5/24/2015 21:00,266,95,171,14,4
5/24/2015 22:00,261,105,156,11,4
5/24/2015 23:00,172,62,110,10,6
5/25/2015 0:00,177,76,101,10,4
5/25/2015 1:00,115,34,81,10,6
5/25/2015 2:00,90,19,71,11,6
5/25/2015 3:00,65,14,51,11,4
5/25/2015 4:00,23,10,13,11,4
5/25/2015 5:00,30,10,20,11,6
5/25/2015 6:00,36,15,21,12,7
5/25/2015 7:00,31,22,9,11,7
5/25/2015 8:00,57,35,22,11,7
5/25/2015 9:00,116,63,53,12,7
5/25/2015 10:00,154,95,59,11,13
5/25/2015 11:00,231,127,104,13,9
5/25/2015 12:00,209,122,87,14,9
5/25/2015 13:00,281,163,118,16,11
5/25/2015 14:00,295,164,131,17,20
5/25/2015 15:00,391,214,177,16,17
5/25/2015 16:00,367,192,175,16,17
5/25/2015 17:00,432,213,219,15,17
5/25/2015 18:00,349,185,164,15,13
5/25/2015 19:00,304,166,138,14,11
5/25/2015 20:00,264,136,128,13,9
5/25/2015 21:00,176,72,104,12,9
5/25/2015 22:00,180,68,112,12,11
5/25/2015 23:00,109,37,72,11,13
5/26/2015 0:00,58,14,44,11,7
5/26/2015 1:00,65,9,56,10,7
5/26/2015 2:00,31,5,26,10,11
5/26/2015 3:00,8,4,4,10,11
5/26/2015 4:00,12,6,6,9,9
5/26/2015 5:00,40,24,16,8,9
5/26/2015 6:00,137,96,41,8,9
5/26/2015 7:00,457,321,136,10,9
5/26/2015 8:00,816,501,315,11,13
5/26/2015 9:00,578,302,276,12,13
5/26/2015 10:00,552,316,236,12,15
5/26/2015 11:00,558,299,259,11,11
5/26/2015 12:00,548,308,240,13,19
5/26/2015 13:00,560,286,274,12,9
5/26/2015 14:00,615,311,304,13,17
5/26/2015 15:00,624,316,308,14,15
5/26/2015 16:00,820,397,423,14,19
5/26/2015 17:00,851,436,415,14,19
5/26/2015 18:00,877,427,450,11,19
5/26/2015 19:00,736,355,381,12,17
5/26/2015 20:00,481,225,256,11,13
5/26/2015 21:00,336,168,168,11,13
5/26/2015 22:00,282,95,187,10,9
5/26/2015 23:00,148,46,102,10,11
5/27/2015 0:00,84,27,57,10,11
5/27/2015 1:00,52,11,41,9,6
5/27/2015 2:00,25,6,19,9,6
5/27/2015 3:00,16,6,10,9,7
5/27/2015 4:00,13,9,4,9,7
5/27/2015 5:00,43,29,14,9,7
5/27/2015 6:00,153,117,36,10,11
5/27/2015 7:00,658,483,175,10,9
5/27/2015 8:00,960,569,391,11,9
5/27/2015 9:00,676,419,257,12,11
5/27/2015 10:00,712,427,285,13,9
5/27/2015 11:00,650,374,276,14,9
5/27/2015 12:00,638,357,281,15,7
5/27/2015 13:00,769,394,375,16,9
5/27/2015 14:00,742,369,373,16,11
5/27/2015 15:00,830,421,409,16,15
5/27/2015 16:00,794,414,380,16,13
5/27/2015 17:00,1035,521,514,16,13
5/27/2015 18:00,985,512,473,16,9
5/27/2015 19:00,807,395,412,16,7
5/27/2015 20:00,591,274,317,15,7
5/27/2015 21:00,451,210,241,14,7
5/27/2015 22:00,374,151,223,14,9
5/27/2015 23:00,282,95,187,13,13
5/28/2015 0:00,185,69,116,13,11
5/28/2015 1:00,171,50,121,13,9
5/28/2015 2:00,103,27,76,12,7
5/28/2015 3:00,85,33,52,12,13
5/28/2015 4:00,73,34,39,13,15
5/28/2015 5:00,75,43,32,13,15
5/28/2015 6:00,153,115,38,13,19
5/28/2015 7:00,623,466,157,14,19
5/28/2015 8:00,777,455,322,15,20
5/28/2015 9:00,726,417,309,15,20
5/28/2015 10:00,589,319,270,16,26
5/28/2015 11:00,530,294,236,15,24
5/28/2015 12:00,633,328,305,16,24
5/28/2015 13:00,653,327,326,17,24
5/28/2015 14:00,798,415,383,15,22
5/28/2015 15:00,670,319,351,15,17
5/28/2015 16:00,840,423,417,15,15
5/28/2015 17:00,941,483,458,14,11
5/28/2015 18:00,987,531,456,15,19
5/28/2015 19:00,868,457,411,14,11
5/28/2015 20:00,634,319,315,13,17
5/28/2015 21:00,350,159,191,11,9
5/28/2015 22:00,468,187,281,10,4
5/28/2015 23:00,295,73,222,8,2
5/29/2015 0:00,157,46,111,6,2
5/29/2015 1:00,81,17,64,6,2
5/29/2015 2:00,28,9,19,6,2
5/29/2015 3:00,16,2,14,5,2
5/29/2015 4:00,20,6,14,6,6
5/29/2015 5:00,49,37,12,6,6
5/29/2015 6:00,146,109,37,8,4
5/29/2015 7:00,597,430,167,9,6
5/29/2015 8:00,775,487,288,11,11
5/29/2015 9:00,721,423,298,14,11
5/29/2015 10:00,578,351,227,15,17
5/29/2015 11:00,594,349,245,14,19
5/29/2015 12:00,700,371,329,15,17
5/29/2015 13:00,778,388,390,15,22
5/29/2015 14:00,824,396,428,16,24
5/29/2015 15:00,757,399,358,17,26
5/29/2015 16:00,772,421,351,17,24
5/29/2015 17:00,847,445,402,16,28
5/29/2015 18:00,882,468,414,16,22
5/29/2015 19:00,808,428,380,16,26
5/29/2015 20:00,684,395,289,15,22
5/29/2015 21:00,532,283,249,11,37
5/29/2015 22:00,364,153,211,10,20
5/29/2015 23:00,336,111,225,9,19
5/30/2015 0:00,287,94,193,9,20
5/30/2015 1:00,208,65,143,9,15
5/30/2015 2:00,137,38,99,9,9
5/30/2015 3:00,113,42,71,8,19
5/30/2015 4:00,43,14,29,8,15
5/30/2015 5:00,54,25,29,8,11
5/30/2015 6:00,54,34,20,9,15
5/30/2015 7:00,84,62,22,10,19
5/30/2015 8:00,190,124,66,11,24
5/30/2015 9:00,360,254,106,12,28
5/30/2015 10:00,471,334,137,13,32
5/30/2015 11:00,419,244,175,10,37
5/30/2015 12:00,494,314,180,12,20
5/30/2015 13:00,505,301,204,10,32
5/30/2015 14:00,412,214,198,11,17
5/30/2015 15:00,478,261,217,12,20
5/30/2015 16:00,434,200,234,12,9
5/30/2015 17:00,496,248,248,15,13
5/30/2015 18:00,534,261,273,14,19
5/30/2015 19:00,602,348,254,14,15
5/30/2015 20:00,385,205,180,13,9
5/30/2015 21:00,301,178,123,10,7
5/30/2015 22:00,387,162,225,7,4
5/30/2015 23:00,256,118,138,6,0
5/31/2015 0:00,303,125,178,5,2
5/31/2015 1:00,226,83,143,5,4
5/31/2015 2:00,196,66,130,6,4
5/31/2015 3:00,120,36,84,7,6
5/31/2015 4:00,91,27,64,7,6
5/31/2015 5:00,60,14,46,7,6
5/31/2015 6:00,64,27,37,8,7
5/31/2015 7:00,31,24,7,9,9
5/31/2015 8:00,87,51,36,13,13
5/31/2015 9:00,218,156,62,15,17
5/31/2015 10:00,361,207,154,15,15
5/31/2015 11:00,276,159,117,17,13
5/31/2015 12:00,301,172,129,19,20
5/31/2015 13:00,356,195,161,19,20
5/31/2015 14:00,440,240,200,19,24
5/31/2015 15:00,396,212,184,19,17
5/31/2015 16:00,386,178,208,17,30
5/31/2015 17:00,367,189,178,16,22
5/31/2015 18:00,352,183,169,16,19
5/31/2015 19:00,372,158,214,15,20
5/31/2015 20:00,239,72,167,15,19
5/31/2015 21:00,154,55,99,15,20
5/31/2015 22:00,196,62,134,15,20
5/31/2015 23:00,112,30,82,15,22
6/1/2015 0:00,31,14,17,15,22
6/1/2015 1:00,21,0,21,12,26
6/1/2015 2:00,13,2,11,10,11
6/1/2015 3:00,4,2,2,10,7
6/1/2015 4:00,10,6,4,10,9
6/1/2015 5:00,44,35,9,9,7
6/1/2015 6:00,155,119,36,10,11
6/1/2015 7:00,682,505,177,11,13
6/1/2015 8:00,1050,569,481,12,15
6/1/2015 9:00,881,506,375,13,13
6/1/2015 10:00,969,503,466,13,13
6/1/2015 11:00,855,483,372,14,11
6/1/2015 12:00,1083,576,507,14,11
6/1/2015 13:00,999,549,450,14,11
6/1/2015 14:00,1059,497,562,15,11
6/1/2015 15:00,1054,550,504,16,17
6/1/2015 16:00,1393,634,759,17,15
6/1/2015 17:00,1472,757,715,16,9
6/1/2015 18:00,1417,651,766,16,9
6/1/2015 19:00,1082,519,563,16,7
6/1/2015 20:00,735,302,433,14,4
6/1/2015 21:00,571,252,319,12,2
6/1/2015 22:00,517,190,327,12,2
6/1/2015 23:00,274,88,186,12,7
6/2/2015 0:00,121,43,78,12,9
6/2/2015 1:00,54,11,43,13,9
6/2/2015 2:00,23,4,19,12,9
6/2/2015 3:00,13,10,3,12,11
6/2/2015 4:00,13,8,5,12,17
6/2/2015 5:00,46,34,12,12,17
6/2/2015 6:00,173,127,46,13,17
6/2/2015 7:00,759,536,223,14,22
6/2/2015 8:00,1331,792,539,15,30
6/2/2015 9:00,951,515,436,15,30
6/2/2015 10:00,1156,585,571,15,26
6/2/2015 11:00,814,468,346,16,28
6/2/2015 12:00,1036,530,506,15,33
6/2/2015 13:00,1036,587,449,16,30
6/2/2015 14:00,1018,489,529,18,35
6/2/2015 15:00,1043,564,479,19,35
6/2/2015 16:00,1385,617,768,19,24
6/2/2015 17:00,1437,784,653,19,22
6/2/2015 18:00,1311,610,701,19,24
6/2/2015 19:00,1093,558,535,19,30
6/2/2015 20:00,761,374,387,20,26
6/2/2015 21:00,529,254,275,20,28
6/2/2015 22:00,360,126,234,20,32
6/2/2015 23:00,263,73,190,20,28
6/3/2015 0:00,211,74,137,19,24
6/3/2015 1:00,72,25,47,19,32
6/3/2015 2:00,47,11,36,15,28
6/3/2015 3:00,23,2,21,15,20
6/3/2015 4:00,32,19,13,15,19
6/3/2015 5:00,42,34,8,15,22
6/3/2015 6:00,172,136,36,15,20
6/3/2015 7:00,820,631,189,15,22
6/3/2015 8:00,1253,683,570,16,32
6/3/2015 9:00,1031,568,463,16,37
6/3/2015 10:00,1227,579,648,16,32
6/3/2015 11:00,943,584,359,17,30
6/3/2015 12:00,1171,588,583,17,33
6/3/2015 13:00,1104,563,541,17,26
6/3/2015 14:00,1104,509,595,17,24
6/3/2015 15:00,1129,598,531,17,20
6/3/2015 16:00,1261,591,670,17,19
6/3/2015 17:00,1193,651,542,18,24
6/3/2015 18:00,1243,580,663,17,13
6/3/2015 19:00,1062,609,453,17,11
6/3/2015 20:00,965,464,501,16,6
6/3/2015 21:00,715,375,340,14,4
6/3/2015 22:00,530,264,266,13,6
6/3/2015 23:00,425,194,231,10,4
6/4/2015 0:00,392,198,194,9,4
6/4/2015 1:00,337,155,182,8,2
6/4/2015 2:00,287,85,202,8,2
6/4/2015 3:00,270,49,221,7,2
6/4/2015 4:00,174,39,135,8,2
6/4/2015 5:00,101,31,70,9,4
6/4/2015 6:00,47,20,27,11,4
6/4/2015 7:00,94,62,32,13,7
6/4/2015 8:00,174,119,55,15,6
6/4/2015 9:00,259,169,90,16,7
6/4/2015 10:00,393,241,152,18,4
6/4/2015 11:00,424,223,201,19,2
6/4/2015 12:00,493,278,215,20,9
6/4/2015 13:00,634,335,299,20,6
6/4/2015 14:00,689,405,284,21,4
6/4/2015 15:00,689,370,319,21,9
6/4/2015 16:00,725,420,305,21,7
6/4/2015 17:00,815,401,414,22,9
6/4/2015 18:00,774,409,365,22,11
6/4/2015 19:00,675,358,317,21,15
6/4/2015 20:00,550,249,301,20,13
6/4/2015 21:00,458,167,291,18,9
6/4/2015 22:00,408,106,302,17,9
6/4/2015 23:00,286,84,202,17,9
6/5/2015 0:00,176,46,130,16,7
6/5/2015 1:00,92,23,69,16,9
6/5/2015 2:00,38,13,25,15,9
6/5/2015 3:00,22,3,19,15,9
6/5/2015 4:00,14,7,7,15,7
6/5/2015 5:00,36,26,10,15,7
6/5/2015 6:00,118,89,29,15,7
6/5/2015 7:00,468,338,130,17,7
6/5/2015 8:00,737,467,270,19,11
6/5/2015 9:00,750,442,308,22,7
6/5/2015 10:00,918,549,369,24,9
6/5/2015 11:00,783,469,314,26,7
6/5/2015 12:00,1053,549,504,27,4
6/5/2015 13:00,1045,542,503,29,9
6/5/2015 14:00,992,482,510,30,7
6/5/2015 15:00,918,490,428,31,6
6/5/2015 16:00,867,442,425,32,6
6/5/2015 17:00,969,493,476,32,9
6/5/2015 18:00,948,460,488,32,11
6/5/2015 19:00,914,531,383,30,6
6/5/2015 20:00,682,356,326,26,4
6/5/2015 21:00,518,267,251,24,4
6/5/2015 22:00,506,193,313,25,30
6/5/2015 23:00,491,107,384,23,15
6/6/2015 0:00,292,73,219,22,4
6/6/2015 1:00,254,58,196,21,4
6/6/2015 2:00,122,35,87,18,4
6/6/2015 3:00,94,21,73,18,7
6/6/2015 4:00,73,19,54,18,6
6/6/2015 5:00,51,18,33,18,7
6/6/2015 6:00,51,33,18,18,4
6/6/2015 7:00,128,95,33,19,17
6/6/2015 8:00,212,152,60,19,19
6/6/2015 9:00,384,285,99,17,20
6/6/2015 10:00,484,340,144,18,17
6/6/2015 11:00,529,346,183,19,19
6/6/2015 12:00,529,327,202,19,22
6/6/2015 13:00,617,342,275,20,15
6/6/2015 14:00,682,351,331,21,17
6/6/2015 15:00,680,344,336,21,19
6/6/2015 16:00,653,306,347,22,17
6/6/2015 17:00,686,356,330,21,15
6/6/2015 18:00,688,339,349,21,13
6/6/2015 19:00,687,373,314,21,17
6/6/2015 20:00,668,349,319,19,11
6/6/2015 21:00,397,194,203,15,9
6/6/2015 22:00,346,141,205,14,6
6/6/2015 23:00,490,168,322,13,6
6/7/2015 0:00,370,120,250,11,6
6/7/2015 1:00,276,104,172,9,2
6/7/2015 2:00,174,40,134,9,4
6/7/2015 3:00,124,25,99,8,4
6/7/2015 4:00,78,12,66,7,2
6/7/2015 5:00,37,8,29,7,2
6/7/2015 6:00,38,11,27,9,2
6/7/2015 7:00,49,34,15,13,6
6/7/2015 8:00,81,56,25,15,7
6/7/2015 9:00,237,168,69,17,9
6/7/2015 10:00,374,261,113,18,9
6/7/2015 11:00,407,232,175,19,13
6/7/2015 12:00,490,275,215,20,6
6/7/2015 13:00,555,324,231,20,7
6/7/2015 14:00,667,360,307,21,9
6/7/2015 15:00,625,329,296,20,7
6/7/2015 16:00,586,318,268,20,11
6/7/2015 17:00,634,306,328,21,13
6/7/2015 18:00,589,285,304,19,15
6/7/2015 19:00,580,271,309,19,17
6/7/2015 20:00,480,157,323,18,11
6/7/2015 21:00,333,112,221,15,15
6/7/2015 22:00,278,64,214,13,15
6/7/2015 23:00,146,44,102,12,15
6/8/2015 0:00,81,25,56,11,13
6/8/2015 1:00,38,5,33,9,7
6/8/2015 2:00,5,2,3,8,7
6/8/2015 3:00,2,1,1,7,2
6/8/2015 4:00,13,9,4,6,2
6/8/2015 5:00,48,32,16,6,4
6/8/2015 6:00,193,152,41,8,6
6/8/2015 7:00,740,532,208,11,9
6/8/2015 8:00,1082,600,482,12,13
6/8/2015 9:00,866,532,334,13,15
6/8/2015 10:00,1014,579,435,13,17
6/8/2015 11:00,737,418,319,16,15
6/8/2015 12:00,1034,499,535,15,19
6/8/2015 13:00,1024,505,519,16,17
6/8/2015 14:00,1036,502,534,17,17
6/8/2015 15:00,1154,624,530,17,17
6/8/2015 16:00,1395,639,756,18,13
6/8/2015 17:00,1539,783,756,17,17
6/8/2015 18:00,1380,588,792,16,19
6/8/2015 19:00,1120,561,559,16,17
6/8/2015 20:00,850,311,539,14,20
6/8/2015 21:00,558,236,322,12,19
6/8/2015 22:00,443,156,287,11,13
6/8/2015 23:00,289,119,170,10,9
6/9/2015 0:00,125,35,90,9,9
6/9/2015 1:00,52,11,41,9,11
6/9/2015 2:00,31,9,22,8,9
6/9/2015 3:00,14,5,9,8,7
6/9/2015 4:00,8,7,1,7,7
6/9/2015 5:00,49,28,21,7,6
6/9/2015 6:00,192,144,48,8,6
6/9/2015 7:00,791,573,218,9,7
6/9/2015 8:00,1379,820,559,12,17
6/9/2015 9:00,990,535,455,12,15
6/9/2015 10:00,1318,698,620,13,17
6/9/2015 11:00,975,556,419,13,15
6/9/2015 12:00,1160,532,628,13,11
6/9/2015 13:00,1122,626,496,14,9
6/9/2015 14:00,1192,589,603,15,15
6/9/2015 15:00,1046,586,460,16,15
6/9/2015 16:00,1444,706,738,16,11
6/9/2015 17:00,1468,762,706,15,13
6/9/2015 18:00,1424,611,813,16,13
6/9/2015 19:00,1191,582,609,15,11
6/9/2015 20:00,892,410,482,15,7
6/9/2015 21:00,528,227,301,13,7
6/9/2015 22:00,460,140,320,12,7
6/9/2015 23:00,321,91,230,11,9
6/10/2015 0:00,167,32,135,11,13
6/10/2015 1:00,85,21,64,11,11
6/10/2015 2:00,52,17,35,10,6
6/10/2015 3:00,17,5,12,10,6
6/10/2015 4:00,15,10,5,9,4
6/10/2015 5:00,58,40,18,9,7
6/10/2015 6:00,188,147,41,10,6
6/10/2015 7:00,904,675,229,13,7
6/10/2015 8:00,1340,767,573,15,11
6/10/2015 9:00,1027,620,407,16,13
6/10/2015 10:00,1328,638,690,18,19
6/10/2015 11:00,1001,615,386,19,17
6/10/2015 12:00,1280,683,597,19,7
6/10/2015 13:00,1113,565,548,21,13
6/10/2015 14:00,1156,521,635,20,17
6/10/2015 15:00,1074,507,567,20,15
6/10/2015 16:00,1395,640,755,21,17
6/10/2015 17:00,1469,773,696,22,11
6/10/2015 18:00,1545,732,813,21,13
6/10/2015 19:00,1167,602,565,21,19
6/10/2015 20:00,924,397,527,19,13
6/10/2015 21:00,655,268,387,17,7
6/10/2015 22:00,614,204,410,16,13
6/10/2015 23:00,437,182,255,15,15
6/11/2015 0:00,364,197,167,14,11
6/11/2015 1:00,166,76,90,13,13
6/11/2015 2:00,90,20,70,13,11
6/11/2015 3:00,111,17,94,12,9
6/11/2015 4:00,90,17,73,10,7
6/11/2015 5:00,115,51,64,11,4
6/11/2015 6:00,191,132,59,12,13
6/11/2015 7:00,775,571,204,14,11
6/11/2015 8:00,1314,731,583,17,11
6/11/2015 9:00,1036,567,469,20,9
6/11/2015 10:00,1120,599,521,21,13
6/11/2015 11:00,910,525,385,21,13
6/11/2015 12:00,1209,578,631,24,13
6/11/2015 13:00,1189,628,561,23,9
6/11/2015 14:00,1277,614,663,23,13
6/11/2015 15:00,1341,710,631,24,7
6/11/2015 16:00,1600,802,798,24,17
6/11/2015 17:00,1532,784,748,24,17
6/11/2015 18:00,1580,918,662,23,17
6/11/2015 19:00,1304,748,556,22,15
6/11/2015 20:00,857,440,417,21,19
6/11/2015 21:00,602,285,317,20,11
6/11/2015 22:00,618,214,404,18,6
6/11/2015 23:00,361,90,271,15,4
6/12/2015 0:00,420,56,364,15,4
6/12/2015 1:00,366,38,328,13,6
6/12/2015 2:00,120,20,100,12,6
6/12/2015 3:00,62,10,52,12,6
6/12/2015 4:00,43,9,34,12,6
6/12/2015 5:00,61,40,21,11,4
6/12/2015 6:00,201,151,50,14,7
6/12/2015 7:00,672,472,200,17,9
6/12/2015 8:00,1008,551,457,20,11
6/12/2015 9:00,846,481,365,21,11
6/12/2015 10:00,973,531,442,22,9
6/12/2015 11:00,892,504,388,23,6
6/12/2015 12:00,1040,552,488,24,6
6/12/2015 13:00,1103,572,531,25,6
6/12/2015 14:00,1141,560,581,25,4
6/12/2015 15:00,1076,565,511,26,7
6/12/2015 16:00,971,532,439,27,2
6/12/2015 17:00,1162,633,529,28,0
6/12/2015 18:00,1106,639,467,27,6
6/12/2015 19:00,1014,588,426,27,4
6/12/2015 20:00,802,443,359,25,2
6/12/2015 21:00,634,267,367,22,2
6/12/2015 22:00,606,229,377,20,2
6/12/2015 23:00,529,144,385,19,4
6/13/2015 0:00,433,145,288,18,2
6/13/2015 1:00,263,66,197,16,7
6/13/2015 2:00,182,62,120,16,2
6/13/2015 3:00,126,33,93,17,4
6/13/2015 4:00,73,22,51,17,6
6/13/2015 5:00,56,22,34,18,6
6/13/2015 6:00,66,37,29,18,4
6/13/2015 7:00,137,108,29,19,6
6/13/2015 8:00,270,170,100,23,9
6/13/2015 9:00,457,334,123,23,15
6/13/2015 10:00,709,463,246,23,24
6/13/2015 11:00,686,411,275,22,24
6/13/2015 12:00,647,343,304,20,28
6/13/2015 13:00,396,196,200,17,17
6/13/2015 14:00,659,359,300,19,17
6/13/2015 15:00,609,348,261,21,22
6/13/2015 16:00,641,394,247,22,26
6/13/2015 17:00,620,326,294,22,19
6/13/2015 18:00,708,378,330,23,20
6/13/2015 19:00,633,300,333,22,19
6/13/2015 20:00,528,265,263,21,19
6/13/2015 21:00,422,204,218,18,11
6/13/2015 22:00,353,151,202,17,7
6/13/2015 23:00,406,167,239,17,15
6/14/2015 0:00,302,112,190,16,17
6/14/2015 1:00,300,77,223,17,15
6/14/2015 2:00,197,50,147,16,20
6/14/2015 3:00,120,13,107,16,20
6/14/2015 4:00,126,23,103,16,20
6/14/2015 5:00,59,15,44,15,19
6/14/2015 6:00,49,19,30,15,13
6/14/2015 7:00,53,34,19,14,11
6/14/2015 8:00,86,55,31,14,7
6/14/2015 9:00,228,166,62,15,6
6/14/2015 10:00,344,230,114,15,7
6/14/2015 11:00,353,226,127,16,6
6/14/2015 12:00,422,217,205,17,6
6/14/2015 13:00,469,222,247,17,7
6/14/2015 14:00,516,307,209,18,6
6/14/2015 15:00,504,306,198,18,9
6/14/2015 16:00,511,258,253,18,9
6/14/2015 17:00,563,267,296,18,11
6/14/2015 18:00,552,242,310,18,13
6/14/2015 19:00,494,200,294,18,15
6/14/2015 20:00,414,169,245,16,9
6/14/2015 21:00,296,106,190,16,13
6/14/2015 22:00,227,93,134,14,15
6/14/2015 23:00,145,55,90,14,11
6/15/2015 0:00,72,23,49,13,11
6/15/2015 1:00,30,7,23,13,11
6/15/2015 2:00,20,4,16,12,13
6/15/2015 3:00,8,3,5,12,9
6/15/2015 4:00,13,8,5,12,15
6/15/2015 5:00,60,38,22,11,13
6/15/2015 6:00,186,149,37,11,13
6/15/2015 7:00,706,516,190,12,9
6/15/2015 8:00,1121,627,494,12,15
6/15/2015 9:00,938,546,392,13,13
6/15/2015 10:00,979,531,448,14,11
6/15/2015 11:00,829,445,384,15,11
6/15/2015 12:00,1079,512,567,17,11
6/15/2015 13:00,1050,552,498,17,13
6/15/2015 14:00,1137,562,575,17,11
6/15/2015 15:00,1160,602,558,18,9
6/15/2015 16:00,1390,611,779,19,11
6/15/2015 17:00,1536,792,744,19,11
6/15/2015 18:00,1394,660,734,18,15
6/15/2015 19:00,1271,644,627,16,15
6/15/2015 20:00,914,377,537,15,11
6/15/2015 21:00,636,319,317,13,9
6/15/2015 22:00,533,154,379,11,7
6/15/2015 23:00,257,89,168,10,7
6/16/2015 0:00,139,35,104,9,6
6/16/2015 1:00,83,15,68,8,7
6/16/2015 2:00,34,5,29,7,6
6/16/2015 3:00,14,6,8,6,2
6/16/2015 4:00,11,10,1,5,4
6/16/2015 5:00,59,44,15,6,4
6/16/2015 6:00,197,155,42,8,4
6/16/2015 7:00,768,510,258,10,4
6/16/2015 8:00,1363,814,549,12,11
6/16/2015 9:00,961,559,402,13,13
6/16/2015 10:00,1240,620,620,14,9
6/16/2015 11:00,908,511,397,14,11
6/16/2015 12:00,1161,554,607,14,11
6/16/2015 13:00,1165,619,546,15,13
6/16/2015 14:00,1095,517,578,14,13
6/16/2015 15:00,1087,567,520,15,11
6/16/2015 16:00,1416,634,782,13,11
6/16/2015 17:00,1451,759,692,14,9
6/16/2015 18:00,1378,577,801,13,7
6/16/2015 19:00,1179,581,598,14,9
6/16/2015 20:00,830,379,451,14,7
6/16/2015 21:00,584,237,347,13,4
6/16/2015 22:00,497,188,309,10,4
6/16/2015 23:00,336,101,235,8,2
6/17/2015 0:00,158,57,101,7,2
6/17/2015 1:00,97,41,56,6,2
6/17/2015 2:00,39,18,21,6,2
6/17/2015 3:00,27,13,14,5,2
6/17/2015 4:00,18,14,4,4,2
6/17/2015 5:00,51,35,16,5,2
6/17/2015 6:00,206,172,34,7,2
6/17/2015 7:00,848,611,237,11,4
6/17/2015 8:00,1343,751,592,14,9
6/17/2015 9:00,979,590,389,15,13
6/17/2015 10:00,1202,627,575,16,15
6/17/2015 11:00,964,587,377,17,13
6/17/2015 12:00,1179,627,552,19,19
6/17/2015 13:00,1074,557,517,19,19
6/17/2015 14:00,1212,579,633,20,19
6/17/2015 15:00,1102,561,541,21,22
6/17/2015 16:00,1343,614,729,20,19
6/17/2015 17:00,1404,736,668,21,19
6/17/2015 18:00,1350,610,740,21,15
6/17/2015 19:00,1200,646,554,21,15
6/17/2015 20:00,867,385,482,20,9
6/17/2015 21:00,615,271,344,20,13
6/17/2015 22:00,635,268,367,17,17
6/17/2015 23:00,371,127,244,16,7
6/18/2015 0:00,280,83,197,15,7
6/18/2015 1:00,147,33,114,15,9
6/18/2015 2:00,69,13,56,15,7
6/18/2015 3:00,54,11,43,15,7
6/18/2015 4:00,56,17,39,16,7
6/18/2015 5:00,63,43,20,16,9
6/18/2015 6:00,163,118,45,16,15
6/18/2015 7:00,636,456,180,16,11
6/18/2015 8:00,1252,666,586,17,13
6/18/2015 9:00,882,485,397,18,13
6/18/2015 10:00,1057,534,523,17,15
6/18/2015 11:00,829,483,346,17,17
6/18/2015 12:00,994,464,530,19,24
6/18/2015 13:00,989,547,442,19,20
6/18/2015 14:00,1069,508,561,18,26
6/18/2015 15:00,1044,579,465,17,22
6/18/2015 16:00,1196,602,594,17,26
6/18/2015 17:00,1329,674,655,17,24
6/18/2015 18:00,1316,586,730,14,11
6/18/2015 19:00,1019,487,532,14,7
6/18/2015 20:00,733,320,413,14,13
6/18/2015 21:00,641,356,285,13,15
6/18/2015 22:00,539,171,368,13,13
6/18/2015 23:00,351,126,225,13,13
6/19/2015 0:00,235,79,156,12,13
6/19/2015 1:00,113,28,85,12,11
6/19/2015 2:00,90,41,49,12,11
6/19/2015 3:00,21,11,10,11,13
6/19/2015 4:00,30,16,14,10,15
6/19/2015 5:00,44,26,18,10,15
6/19/2015 6:00,131,96,35,10,15
6/19/2015 7:00,483,314,169,11,13
6/19/2015 8:00,861,453,408,12,15
6/19/2015 9:00,783,434,349,13,13
6/19/2015 10:00,763,396,367,15,15
6/19/2015 11:00,736,421,315,15,20
6/19/2015 12:00,874,449,425,15,20
6/19/2015 13:00,918,467,451,13,13
6/19/2015 14:00,813,410,403,12,11
6/19/2015 15:00,795,453,342,13,13
6/19/2015 16:00,761,397,364,13,15
6/19/2015 17:00,678,319,359,13,15
6/19/2015 18:00,749,399,350,13,17
6/19/2015 19:00,712,431,281,12,11
6/19/2015 20:00,613,354,259,12,6
6/19/2015 21:00,492,258,234,12,9
6/19/2015 22:00,468,188,280,12,11
6/19/2015 23:00,313,118,195,11,11
6/20/2015 0:00,309,96,213,11,11
6/20/2015 1:00,162,56,106,11,13
6/20/2015 2:00,135,36,99,10,7
6/20/2015 3:00,100,24,76,10,7
6/20/2015 4:00,69,10,59,9,9
6/20/2015 5:00,76,35,41,9,9
6/20/2015 6:00,68,41,27,10,9
6/20/2015 7:00,144,113,31,11,11
6/20/2015 8:00,353,234,119,12,13
6/20/2015 9:00,538,398,140,13,13
6/20/2015 10:00,602,406,196,14,11
6/20/2015 11:00,619,439,180,14,11
6/20/2015 12:00,725,399,326,14,11
6/20/2015 13:00,762,407,355,14,11
6/20/2015 14:00,715,350,365,15,11
6/20/2015 15:00,641,288,353,14,11
6/20/2015 16:00,659,300,359,14,11
6/20/2015 17:00,662,290,372,15,11
6/20/2015 18:00,616,246,370,15,15
6/20/2015 19:00,516,232,284,14,11
6/20/2015 20:00,459,214,245,14,7
6/20/2015 21:00,406,275,131,13,6
6/20/2015 22:00,470,312,158,13,6
6/20/2015 23:00,454,199,255,13,6
6/21/2015 0:00,315,134,181,12,6
6/21/2015 1:00,235,90,145,12,6
6/21/2015 2:00,175,47,128,11,4
6/21/2015 3:00,129,29,100,11,2
6/21/2015 4:00,104,25,79,11,0
6/21/2015 5:00,66,24,42,11,4
6/21/2015 6:00,53,21,32,11,4
6/21/2015 7:00,73,44,29,12,4
6/21/2015 8:00,99,62,37,13,9
6/21/2015 9:00,212,149,63,13,11
6/21/2015 10:00,311,179,132,15,13
6/21/2015 11:00,346,213,133,16,13
6/21/2015 12:00,364,217,147,16,9
6/21/2015 13:00,369,195,174,16,13
6/21/2015 14:00,273,139,134,16,7
6/21/2015 15:00,217,96,121,16,9
6/21/2015 16:00,300,137,163,15,2
6/21/2015 17:00,302,128,174,16,6
6/21/2015 18:00,292,130,162,18,6
6/21/2015 19:00,328,147,181,17,13
6/21/2015 20:00,275,105,170,17,11
6/21/2015 21:00,202,73,129,15,17
6/21/2015 22:00,138,44,94,13,15
6/21/2015 23:00,145,48,97,12,11
6/22/2015 0:00,59,15,44,11,6
6/22/2015 1:00,36,17,19,11,6
6/22/2015 2:00,7,4,3,11,6
6/22/2015 3:00,11,9,2,11,2
6/22/2015 4:00,9,8,1,11,6
6/22/2015 5:00,39,28,11,11,7
6/22/2015 6:00,134,109,25,12,9
6/22/2015 7:00,481,347,134,13,9
6/22/2015 8:00,827,480,347,12,15
6/22/2015 9:00,545,323,222,12,15
6/22/2015 10:00,725,383,342,13,11
6/22/2015 11:00,631,388,243,14,15
6/22/2015 12:00,892,446,446,15,17
6/22/2015 13:00,866,433,433,14,15
6/22/2015 14:00,878,427,451,14,17
6/22/2015 15:00,869,445,424,14,13
6/22/2015 16:00,1012,535,477,14,15
6/22/2015 17:00,1024,502,522,13,19
6/22/2015 18:00,981,427,554,11,11
6/22/2015 19:00,842,425,417,11,6
6/22/2015 20:00,642,285,357,11,7
6/22/2015 21:00,369,146,223,11,6
6/22/2015 22:00,328,131,197,10,2
6/22/2015 23:00,202,61,141,11,9
6/23/2015 0:00,135,41,94,9,7
6/23/2015 1:00,63,10,53,9,7
6/23/2015 2:00,28,3,25,9,7
6/23/2015 3:00,11,5,6,8,7
6/23/2015 4:00,11,10,1,8,9
6/23/2015 5:00,49,35,14,8,7
6/23/2015 6:00,155,124,31,9,9
6/23/2015 7:00,584,417,167,10,11
6/23/2015 8:00,1335,802,533,12,13
6/23/2015 9:00,949,550,399,12,19
6/23/2015 10:00,1191,642,549,14,15
6/23/2015 11:00,903,515,388,15,15
6/23/2015 12:00,1080,507,573,13,19
6/23/2015 13:00,1054,578,476,15,24
6/23/2015 14:00,1004,463,541,16,30
6/23/2015 15:00,958,530,428,14,19
6/23/2015 16:00,1141,502,639,14,19
6/23/2015 17:00,1239,652,587,14,17
6/23/2015 18:00,1272,582,690,13,13
6/23/2015 19:00,1047,610,437,14,20
6/23/2015 20:00,750,350,400,14,20
6/23/2015 21:00,459,171,288,13,20
6/23/2015 22:00,481,178,303,13,17
6/23/2015 23:00,318,96,222,12,19
6/24/2015 0:00,139,40,99,12,11
6/24/2015 1:00,79,26,53,12,15
6/24/2015 2:00,26,13,13,11,15
6/24/2015 3:00,24,9,15,11,13
6/24/2015 4:00,18,14,4,11,13
6/24/2015 5:00,58,40,18,11,13
6/24/2015 6:00,179,141,38,12,13
6/24/2015 7:00,714,526,188,12,15
6/24/2015 8:00,1257,722,535,13,20
6/24/2015 9:00,869,521,348,13,19
6/24/2015 10:00,1088,510,578,14,19
6/24/2015 11:00,805,506,299,14,17
6/24/2015 12:00,1057,569,488,15,17
6/24/2015 13:00,1033,548,485,16,15
6/24/2015 14:00,1207,548,659,16,15
6/24/2015 15:00,1080,525,555,18,15
6/24/2015 16:00,1382,688,694,18,17
6/24/2015 17:00,1344,609,735,19,13
6/24/2015 18:00,1469,698,771,19,15
6/24/2015 19:00,1180,661,519,18,15
6/24/2015 20:00,864,438,426,17,9
6/24/2015 21:00,666,375,291,16,7
6/24/2015 22:00,526,221,305,16,7
6/24/2015 23:00,466,170,296,15,4
6/25/2015 0:00,272,99,173,13,6
6/25/2015 1:00,206,79,127,12,7
6/25/2015 2:00,91,19,72,12,4
6/25/2015 3:00,80,17,63,11,2
6/25/2015 4:00,43,15,28,11,2
6/25/2015 5:00,58,36,22,11,6
6/25/2015 6:00,168,129,39,12,7
6/25/2015 7:00,615,430,185,14,4
6/25/2015 8:00,1333,764,569,16,7
6/25/2015 9:00,921,567,354,19,11
6/25/2015 10:00,1075,570,505,20,9
6/25/2015 11:00,899,543,356,22,15
6/25/2015 12:00,1115,566,549,22,15
6/25/2015 13:00,1139,590,549,22,17
6/25/2015 14:00,1155,555,600,23,13
6/25/2015 15:00,1223,674,549,24,19
6/25/2015 16:00,1292,662,630,23,13
6/25/2015 17:00,1359,691,668,24,15
6/25/2015 18:00,1400,712,688,23,9
6/25/2015 19:00,1160,604,556,23,11
6/25/2015 20:00,948,440,508,22,6
6/25/2015 21:00,670,275,395,19,2
6/25/2015 22:00,595,209,386,17,4
6/25/2015 23:00,409,114,295,16,4
6/26/2015 0:00,250,50,200,17,6
6/26/2015 1:00,160,37,123,17,4
6/26/2015 2:00,91,22,69,16,4
6/26/2015 3:00,53,11,42,16,2
6/26/2015 4:00,23,10,13,15,4
6/26/2015 5:00,56,36,20,15,4
6/26/2015 6:00,153,118,35,16,4
6/26/2015 7:00,572,375,197,17,4
6/26/2015 8:00,985,541,444,18,2
6/26/2015 9:00,848,490,358,20,2
6/26/2015 10:00,921,468,453,22,7
6/26/2015 11:00,822,482,340,22,4
6/26/2015 12:00,978,512,466,23,6
6/26/2015 13:00,956,493,463,24,11
6/26/2015 14:00,997,524,473,25,13
6/26/2015 15:00,971,525,446,25,22
6/26/2015 16:00,993,520,473,25,17
6/26/2015 17:00,962,479,483,24,20
6/26/2015 18:00,1013,554,459,23,11
6/26/2015 19:00,997,615,382,23,4
6/26/2015 20:00,834,458,376,22,7
6/26/2015 21:00,713,422,291,21,6
6/26/2015 22:00,611,332,279,20,6
6/26/2015 23:00,830,202,628,20,7
6/27/2015 0:00,535,186,349,20,11
6/27/2015 1:00,284,78,206,19,11
6/27/2015 2:00,185,51,134,18,2
6/27/2015 3:00,123,32,91,17,7
6/27/2015 4:00,77,20,57,16,6
6/27/2015 5:00,55,26,29,16,7
6/27/2015 6:00,42,23,19,17,9
6/27/2015 7:00,110,82,28,18,13
6/27/2015 8:00,204,139,65,19,19
6/27/2015 9:00,423,279,144,19,19
6/27/2015 10:00,506,359,147,19,19
6/27/2015 11:00,551,357,194,20,24
6/27/2015 12:00,591,372,219,20,17
6/27/2015 13:00,665,388,277,21,22
6/27/2015 14:00,672,367,305,22,24
6/27/2015 15:00,644,346,298,23,24
6/27/2015 16:00,703,379,324,22,22
6/27/2015 17:00,732,370,362,21,20
6/27/2015 18:00,806,419,387,21,19
6/27/2015 19:00,734,397,337,20,22
6/27/2015 20:00,691,387,304,19,15
6/27/2015 21:00,506,265,241,17,11
6/27/2015 22:00,415,206,209,16,7
6/27/2015 23:00,501,122,379,14,7
6/28/2015 0:00,380,131,249,13,6
6/28/2015 1:00,250,102,148,12,6
6/28/2015 2:00,152,62,90,11,2
6/28/2015 3:00,144,32,112,10,0
6/28/2015 4:00,64,17,47,10,2
6/28/2015 5:00,71,20,51,9,2
6/28/2015 6:00,40,16,24,11,4
6/28/2015 7:00,53,37,16,14,2
6/28/2015 8:00,92,55,37,17,2
6/28/2015 9:00,302,191,111,18,4
6/28/2015 10:00,385,264,121,19,4
6/28/2015 11:00,522,321,201,20,9
6/28/2015 12:00,594,332,262,21,6
6/28/2015 13:00,694,384,310,22,2
6/28/2015 14:00,771,385,386,22,11
6/28/2015 15:00,791,433,358,22,7
6/28/2015 16:00,709,337,372,21,7
6/28/2015 17:00,582,281,301,19,6
6/28/2015 18:00,729,409,320,20,6
6/28/2015 19:00,573,292,281,19,2
6/28/2015 20:00,479,216,263,18,6
6/28/2015 21:00,395,134,261,18,9
6/28/2015 22:00,292,84,208,17,2
6/28/2015 23:00,177,65,112,17,4
6/29/2015 0:00,80,27,53,17,7
6/29/2015 1:00,39,11,28,17,7
6/29/2015 2:00,26,13,13,16,6
6/29/2015 3:00,19,8,11,16,4
6/29/2015 4:00,15,10,5,16,4
6/29/2015 5:00,43,33,10,15,4
6/29/2015 6:00,145,110,35,16,2
6/29/2015 7:00,487,321,166,18,4
6/29/2015 8:00,965,541,424,19,9
6/29/2015 9:00,928,563,365,20,9
6/29/2015 10:00,1036,539,497,21,9
6/29/2015 11:00,765,438,327,22,11
6/29/2015 12:00,1100,558,542,22,11
6/29/2015 13:00,1051,597,454,24,15
6/29/2015 14:00,1133,579,554,23,13
6/29/2015 15:00,1186,652,534,24,11
6/29/2015 16:00,1456,743,713,24,11
6/29/2015 17:00,1554,796,758,25,13
6/29/2015 18:00,1719,813,906,25,11
6/29/2015 19:00,1357,735,622,24,11
6/29/2015 20:00,1073,490,583,21,15
6/29/2015 21:00,753,330,423,19,7
6/29/2015 22:00,591,215,376,19,9
6/29/2015 23:00,392,130,262,17,7
6/30/2015 0:00,179,47,132,16,4
6/30/2015 1:00,69,11,58,15,4
6/30/2015 2:00,37,18,19,14,2
6/30/2015 3:00,21,13,8,12,2
6/30/2015 4:00,19,14,5,12,4
6/30/2015 5:00,55,39,16,12,2
6/30/2015 6:00,179,132,47,15,2
6/30/2015 7:00,554,350,204,18,7
6/30/2015 8:00,1290,765,525,20,6
6/30/2015 9:00,1020,561,459,21,7
6/30/2015 10:00,1320,687,633,22,7
6/30/2015 11:00,986,578,408,23,2
6/30/2015 12:00,1188,569,619,23,4
6/30/2015 13:00,1119,623,496,25,7
6/30/2015 14:00,1226,634,592,25,9
6/30/2015 15:00,1215,583,632,26,7
6/30/2015 16:00,1473,737,736,27,13
6/30/2015 17:00,1565,922,643,27,11
6/30/2015 18:00,1479,691,788,26,15
6/30/2015 19:00,1273,656,617,25,15
6/30/2015 20:00,941,435,506,24,15
6/30/2015 21:00,682,332,350,22,4
6/30/2015 22:00,597,187,410,20,7
6/30/2015 23:00,445,125,320,18,7
7/1/2015 0:00,234,61,173,19,9
7/1/2015 1:00,101,23,78,17,6
7/1/2015 2:00,32,11,21,17,7
7/1/2015 3:00,16,8,8,17,9
7/1/2015 4:00,22,15,7,17,11
7/1/2015 5:00,53,33,20,18,7
7/1/2015 6:00,199,152,47,19,9
7/1/2015 7:00,723,503,220,21,11
7/1/2015 8:00,1273,719,554,23,15
7/1/2015 9:00,1056,608,448,24,9
7/1/2015 10:00,1245,644,601,26,11
7/1/2015 11:00,918,539,379,28,15
7/1/2015 12:00,1227,633,594,29,17
7/1/2015 13:00,1089,577,512,30,17
7/1/2015 14:00,1270,566,704,30,15
7/1/2015 15:00,1190,635,555,31,17
7/1/2015 16:00,1356,732,624,31,15
7/1/2015 17:00,1385,772,613,32,17
7/1/2015 18:00,1491,786,705,31,15
7/1/2015 19:00,1175,665,510,30,17
7/1/2015 20:00,876,402,474,29,15
7/1/2015 21:00,612,234,378,27,13
7/1/2015 22:00,674,210,464,26,11
7/1/2015 23:00,475,114,361,25,13
7/2/2015 0:00,305,95,210,24,11
7/2/2015 1:00,176,68,108,23,9
7/2/2015 2:00,103,40,63,22,11
7/2/2015 3:00,51,9,42,22,13
7/2/2015 4:00,51,20,31,22,11
7/2/2015 5:00,76,50,26,22,9
7/2/2015 6:00,196,143,53,22,11
7/2/2015 7:00,552,357,195,24,13
7/2/2015 8:00,1297,719,578,26,11
7/2/2015 9:00,972,564,408,28,11
7/2/2015 10:00,1048,547,501,30,9
7/2/2015 11:00,868,459,409,31,13
7/2/2015 12:00,1167,552,615,32,11
7/2/2015 13:00,965,489,476,34,11
7/2/2015 14:00,1004,518,486,36,11
7/2/2015 15:00,1161,689,472,36,11
7/2/2015 16:00,1301,739,562,37,9
7/2/2015 17:00,1118,586,532,37,7
7/2/2015 18:00,1135,554,581,36,13
7/2/2015 19:00,1035,580,455,35,11
7/2/2015 20:00,781,386,395,33,7
7/2/2015 21:00,635,297,338,31,11
7/2/2015 22:00,516,212,304,29,4
7/2/2015 23:00,405,133,272,26,2
7/3/2015 0:00,278,76,202,25,24
7/3/2015 1:00,148,35,113,23,20
7/3/2015 2:00,67,16,51,23,19
7/3/2015 3:00,66,12,54,20,11
7/3/2015 4:00,65,15,50,20,9
7/3/2015 5:00,63,30,33,20,6
7/3/2015 6:00,207,147,60,20,2
7/3/2015 7:00,457,295,162,21,2
7/3/2015 8:00,905,511,394,23,7
7/3/2015 9:00,803,431,372,24,2
7/3/2015 10:00,874,486,388,26,4
7/3/2015 11:00,786,453,333,27,7
7/3/2015 12:00,851,423,428,28,11
7/3/2015 13:00,862,450,412,29,7
7/3/2015 14:00,923,466,457,30,7
7/3/2015 15:00,889,488,401,30,11
7/3/2015 16:00,850,460,390,30,11
7/3/2015 17:00,848,464,384,31,11
7/3/2015 18:00,927,487,440,30,15
7/3/2015 19:00,920,565,355,29,13
7/3/2015 20:00,810,444,366,28,6
7/3/2015 21:00,537,285,252,26,9
7/3/2015 22:00,527,213,314,24,9
7/3/2015 23:00,521,177,344,23,7
7/4/2015 0:00,474,139,335,22,4
7/4/2015 1:00,289,69,220,21,6
7/4/2015 2:00,177,51,126,21,7
7/4/2015 3:00,94,39,55,21,4
7/4/2015 4:00,58,14,44,19,2
7/4/2015 5:00,53,18,35,19,2
7/4/2015 6:00,89,55,34,20,2
7/4/2015 7:00,148,104,44,24,6
7/4/2015 8:00,346,235,111,26,9
7/4/2015 9:00,564,391,173,29,9
7/4/2015 10:00,575,375,200,31,9
7/4/2015 11:00,495,316,179,34,7
7/4/2015 12:00,520,302,218,35,11
7/4/2015 13:00,574,327,247,35,15
7/4/2015 14:00,541,283,258,37,15
7/4/2015 15:00,518,277,241,37,20
7/4/2015 16:00,450,229,221,36,17
7/4/2015 17:00,552,307,245,35,24
7/4/2015 18:00,579,297,282,34,17
7/4/2015 19:00,550,272,278,33,13
7/4/2015 20:00,682,390,292,30,13
7/4/2015 21:00,506,244,262,28,6
7/4/2015 22:00,438,206,232,26,9
7/4/2015 23:00,405,165,240,25,11
7/5/2015 0:00,350,92,258,24,9
7/5/2015 1:00,286,106,180,23,7
7/5/2015 2:00,151,53,98,23,9
7/5/2015 3:00,106,17,89,22,6
7/5/2015 4:00,81,12,69,20,7
7/5/2015 5:00,60,15,45,20,6
7/5/2015 6:00,58,28,30,21,9
7/5/2015 7:00,53,32,21,22,7
7/5/2015 8:00,99,51,48,22,4
7/5/2015 9:00,219,148,71,24,11
7/5/2015 10:00,137,93,44,22,6
7/5/2015 11:00,108,68,40,21,9
7/5/2015 12:00,182,122,60,21,9
7/5/2015 13:00,225,123,102,22,9
7/5/2015 14:00,369,221,148,26,7
7/5/2015 15:00,379,223,156,28,9
7/5/2015 16:00,428,242,186,26,13
7/5/2015 17:00,480,233,247,27,9
7/5/2015 18:00,555,282,273,23,33
7/5/2015 19:00,416,172,244,19,17
7/5/2015 20:00,310,120,190,19,9
7/5/2015 21:00,276,109,167,19,9
7/5/2015 22:00,204,74,130,19,11
7/5/2015 23:00,153,39,114,19,11
7/6/2015 0:00,81,33,48,19,17
7/6/2015 1:00,42,8,34,17,13
7/6/2015 2:00,17,6,11,16,9
7/6/2015 3:00,5,2,3,16,11
7/6/2015 4:00,21,18,3,16,13
7/6/2015 5:00,47,27,20,16,11
7/6/2015 6:00,161,117,44,16,13
7/6/2015 7:00,512,331,181,17,15
7/6/2015 8:00,959,567,392,18,15
7/6/2015 9:00,898,526,372,20,15
7/6/2015 10:00,897,468,429,20,17
7/6/2015 11:00,735,429,306,21,19
7/6/2015 12:00,1025,485,540,21,22
7/6/2015 13:00,873,450,423,22,24
7/6/2015 14:00,942,442,500,23,20
7/6/2015 15:00,1001,532,469,23,17
7/6/2015 16:00,1230,630,600,25,13
7/6/2015 17:00,1220,656,564,25,11
7/6/2015 18:00,1256,577,679,24,15
7/6/2015 19:00,1143,512,631,24,11
7/6/2015 20:00,798,319,479,22,7
7/6/2015 21:00,570,243,327,18,4
7/6/2015 22:00,460,154,306,17,2
7/6/2015 23:00,329,106,223,15,2
7/7/2015 0:00,166,41,125,14,0
7/7/2015 1:00,81,15,66,13,2
7/7/2015 2:00,23,11,12,13,2
7/7/2015 3:00,17,7,10,15,6
7/7/2015 4:00,20,15,5,14,4
7/7/2015 5:00,54,36,18,14,4
7/7/2015 6:00,175,124,51,16,7
7/7/2015 7:00,550,364,186,18,4
7/7/2015 8:00,1176,747,429,21,4
7/7/2015 9:00,989,567,422,24,7
7/7/2015 10:00,1090,572,518,25,7
7/7/2015 11:00,959,482,477,27,9
7/7/2015 12:00,1102,526,576,29,13
7/7/2015 13:00,1104,586,518,29,15
7/7/2015 14:00,1089,498,591,29,9
7/7/2015 15:00,958,521,437,29,6
7/7/2015 16:00,1267,594,673,29,6
7/7/2015 17:00,1178,608,570,24,35
7/7/2015 18:00,1216,583,633,26,33
7/7/2015 19:00,1007,533,474,25,26
7/7/2015 20:00,785,383,402,24,24
7/7/2015 21:00,556,236,320,22,19
7/7/2015 22:00,495,135,360,20,9
7/7/2015 23:00,348,89,259,21,20
7/8/2015 0:00,220,37,183,20,20
7/8/2015 1:00,119,22,97,19,26
7/8/2015 2:00,33,7,26,18,22
7/8/2015 3:00,23,2,21,18,22
7/8/2015 4:00,20,16,4,17,19
7/8/2015 5:00,56,44,12,16,19
7/8/2015 6:00,157,130,27,16,26
7/8/2015 7:00,524,350,174,16,24
7/8/2015 8:00,1104,663,441,17,28
7/8/2015 9:00,844,513,331,18,28
7/8/2015 10:00,1072,621,451,18,30
7/8/2015 11:00,860,518,342,18,30
7/8/2015 12:00,935,471,464,17,22
7/8/2015 13:00,809,404,405,17,30
7/8/2015 14:00,947,414,533,17,20
7/8/2015 15:00,783,402,381,17,30
7/8/2015 16:00,999,438,561,16,20
7/8/2015 17:00,953,504,449,18,19
7/8/2015 18:00,953,407,546,17,26
7/8/2015 19:00,836,397,439,17,20
7/8/2015 20:00,704,266,438,17,17
7/8/2015 21:00,480,204,276,16,13
7/8/2015 22:00,472,229,243,16,15
7/8/2015 23:00,359,141,218,15,15
7/9/2015 0:00,186,59,127,15,17
7/9/2015 1:00,119,31,88,13,17
7/9/2015 2:00,112,32,80,13,13
7/9/2015 3:00,48,10,38,11,11
7/9/2015 4:00,33,10,23,11,13
7/9/2015 5:00,71,42,29,11,11
7/9/2015 6:00,160,118,42,12,15
7/9/2015 7:00,497,317,180,12,19
7/9/2015 8:00,1020,615,405,14,22
7/9/2015 9:00,801,494,307,15,24
7/9/2015 10:00,885,480,405,15,20
7/9/2015 11:00,734,389,345,17,24
7/9/2015 12:00,914,396,518,16,17
7/9/2015 13:00,833,433,400,15,13
7/9/2015 14:00,915,427,488,16,19
7/9/2015 15:00,991,568,423,16,24
7/9/2015 16:00,1053,536,517,18,28
7/9/2015 17:00,1066,528,538,17,22
7/9/2015 18:00,1103,504,599,17,20
7/9/2015 19:00,977,476,501,16,19
7/9/2015 20:00,758,389,369,15,13
7/9/2015 21:00,534,270,264,13,9
7/9/2015 22:00,520,243,277,12,11
7/9/2015 23:00,437,115,322,11,9
7/10/2015 0:00,259,57,202,10,6
7/10/2015 1:00,155,28,127,9,7
7/10/2015 2:00,80,13,67,8,6
7/10/2015 3:00,20,2,18,7,6
7/10/2015 4:00,27,14,13,6,2
7/10/2015 5:00,58,38,20,8,6
7/10/2015 6:00,157,123,34,9,0
7/10/2015 7:00,463,294,169,11,4
7/10/2015 8:00,899,542,357,13,2
7/10/2015 9:00,800,481,319,14,6
7/10/2015 10:00,849,500,349,16,7
7/10/2015 11:00,777,443,334,17,9
7/10/2015 12:00,961,493,468,18,9
7/10/2015 13:00,886,438,448,20,13
7/10/2015 14:00,877,399,478,20,20
7/10/2015 15:00,944,487,457,21,7
7/10/2015 16:00,909,470,439,22,13
7/10/2015 17:00,865,443,422,22,9
7/10/2015 18:00,1085,581,504,21,9
7/10/2015 19:00,1004,629,375,21,2
7/10/2015 20:00,864,511,353,20,6
7/10/2015 21:00,611,332,279,18,4
7/10/2015 22:00,565,247,318,16,2
7/10/2015 23:00,576,190,386,13,6
7/11/2015 0:00,501,92,409,14,7
7/11/2015 1:00,344,70,274,14,6
7/11/2015 2:00,201,39,162,13,4
7/11/2015 3:00,101,10,91,13,7
7/11/2015 4:00,69,13,56,12,7
7/11/2015 5:00,46,18,28,13,7
7/11/2015 6:00,61,35,26,14,7
7/11/2015 7:00,142,96,46,14,6
7/11/2015 8:00,242,164,78,16,7
7/11/2015 9:00,437,314,123,19,9
7/11/2015 10:00,530,373,157,21,9
7/11/2015 11:00,620,386,234,22,11
7/11/2015 12:00,663,396,267,24,13
7/11/2015 13:00,733,446,287,26,7
7/11/2015 14:00,775,378,397,27,6
7/11/2015 15:00,734,399,335,27,6
7/11/2015 16:00,703,398,305,29,11
7/11/2015 17:00,704,346,358,28,9
7/11/2015 18:00,830,429,401,28,13
7/11/2015 19:00,893,517,376,27,9
7/11/2015 20:00,763,452,311,25,2
7/11/2015 21:00,569,323,246,21,4
7/11/2015 22:00,492,213,279,22,15
7/11/2015 23:00,500,155,345,21,15
7/12/2015 0:00,565,98,467,19,19
7/12/2015 1:00,333,59,274,17,7
7/12/2015 2:00,203,41,162,18,7
7/12/2015 3:00,102,16,86,17,6
7/12/2015 4:00,69,10,59,16,6
7/12/2015 5:00,54,12,42,16,7
7/12/2015 6:00,33,14,19,17,7
7/12/2015 7:00,50,25,25,17,11
7/12/2015 8:00,102,67,35,18,9
7/12/2015 9:00,218,154,64,16,13
7/12/2015 10:00,248,169,79,16,13
7/12/2015 11:00,219,125,94,17,13
7/12/2015 12:00,265,146,119,18,15
7/12/2015 13:00,316,185,131,19,20
7/12/2015 14:00,374,232,142,19,19
7/12/2015 15:00,364,196,168,18,19
7/12/2015 16:00,332,177,155,18,19
7/12/2015 17:00,389,195,194,17,17
7/12/2015 18:00,420,183,237,17,17
7/12/2015 19:00,462,214,248,18,11
7/12/2015 20:00,367,119,248,16,7
7/12/2015 21:00,231,91,140,17,7
7/12/2015 22:00,262,52,210,17,11
7/12/2015 23:00,130,33,97,17,9
7/13/2015 0:00,99,28,71,17,13
7/13/2015 1:00,43,19,24,17,15
7/13/2015 2:00,13,3,10,17,15
7/13/2015 3:00,7,3,4,16,17
7/13/2015 4:00,15,11,4,17,15
7/13/2015 5:00,44,30,14,17,13
7/13/2015 6:00,150,115,35,17,13
7/13/2015 7:00,373,240,133,17,15
7/13/2015 8:00,718,450,268,17,15
7/13/2015 9:00,722,418,304,16,15
7/13/2015 10:00,695,358,337,16,13
7/13/2015 11:00,563,264,299,17,13
7/13/2015 12:00,575,296,279,16,4
7/13/2015 13:00,586,323,263,17,13
7/13/2015 14:00,593,297,296,17,15
7/13/2015 15:00,627,332,295,18,19
7/13/2015 16:00,780,381,399,19,20
7/13/2015 17:00,826,399,427,19,15
7/13/2015 18:00,773,316,457,18,20
7/13/2015 19:00,645,288,357,18,13
7/13/2015 20:00,484,177,307,17,11
7/13/2015 21:00,321,127,194,17,9
7/13/2015 22:00,226,58,168,17,7
7/13/2015 23:00,187,57,130,17,7
7/14/2015 0:00,89,32,57,17,11
7/14/2015 1:00,43,19,24,17,17
7/14/2015 2:00,23,7,16,17,13
7/14/2015 3:00,13,8,5,17,17
7/14/2015 4:00,16,14,2,17,13
7/14/2015 5:00,47,37,10,17,15
7/14/2015 6:00,119,89,30,17,15
7/14/2015 7:00,485,346,139,17,17
7/14/2015 8:00,703,454,249,18,15
7/14/2015 9:00,725,402,323,18,20
7/14/2015 10:00,679,339,340,20,13
7/14/2015 11:00,660,377,283,20,22
7/14/2015 12:00,716,351,365,21,26
7/14/2015 13:00,830,454,376,22,22
7/14/2015 14:00,881,474,407,21,20
7/14/2015 15:00,741,379,362,21,22
7/14/2015 16:00,916,392,524,23,24
7/14/2015 17:00,1009,500,509,23,22
7/14/2015 18:00,976,431,545,22,17
7/14/2015 19:00,818,396,422,21,19
7/14/2015 20:00,664,301,363,20,20
7/14/2015 21:00,429,183,246,19,13
7/14/2015 22:00,386,134,252,18,7
7/14/2015 23:00,317,112,205,16,7
7/15/2015 0:00,177,44,133,15,7
7/15/2015 1:00,108,32,76,15,9
7/15/2015 2:00,55,24,31,16,7
7/15/2015 3:00,26,16,10,14,6
7/15/2015 4:00,27,19,8,14,7
7/15/2015 5:00,57,43,14,13,2
7/15/2015 6:00,161,128,33,14,2
7/15/2015 7:00,492,340,152,16,2
7/15/2015 8:00,876,547,329,17,6
7/15/2015 9:00,844,540,304,19,4
7/15/2015 10:00,871,476,395,20,9
7/15/2015 11:00,812,451,361,19,11
7/15/2015 12:00,925,498,427,20,11
7/15/2015 13:00,787,404,383,21,11
7/15/2015 14:00,884,426,458,22,9
7/15/2015 15:00,837,411,426,22,11
7/15/2015 16:00,1084,529,555,23,9
7/15/2015 17:00,1056,534,522,23,9
7/15/2015 18:00,938,403,535,22,13
7/15/2015 19:00,943,486,457,21,13
7/15/2015 20:00,691,312,379,21,13
7/15/2015 21:00,513,205,308,20,9
7/15/2015 22:00,483,217,266,19,7
7/15/2015 23:00,357,178,179,19,7
7/16/2015 0:00,288,123,165,18,6
7/16/2015 1:00,172,58,114,18,9
7/16/2015 2:00,121,23,98,17,7
7/16/2015 3:00,123,21,102,16,9
7/16/2015 4:00,96,20,76,17,6
7/16/2015 5:00,75,50,25,17,7
7/16/2015 6:00,137,95,42,16,13
7/16/2015 7:00,469,290,179,16,9
7/16/2015 8:00,796,476,320,16,7
7/16/2015 9:00,770,458,312,16,6
7/16/2015 10:00,792,453,339,17,4
7/16/2015 11:00,733,427,306,19,4
7/16/2015 12:00,829,438,391,20,7
7/16/2015 13:00,921,476,445,21,7
7/16/2015 14:00,993,490,503,24,7
7/16/2015 15:00,986,512,474,24,6
7/16/2015 16:00,1072,532,540,25,9
7/16/2015 17:00,1061,573,488,25,6
7/16/2015 18:00,1159,542,617,24,7
7/16/2015 19:00,944,479,465,24,7
7/16/2015 20:00,755,393,362,23,4
7/16/2015 21:00,583,271,312,21,4
7/16/2015 22:00,541,245,296,19,4
7/16/2015 23:00,355,109,246,19,7
7/17/2015 0:00,382,72,310,19,6
7/17/2015 1:00,163,53,110,19,7
7/17/2015 2:00,98,17,81,19,4
7/17/2015 3:00,30,5,25,18,4
7/17/2015 4:00,41,14,27,18,7
7/17/2015 5:00,65,41,24,18,2
7/17/2015 6:00,129,102,27,18,6
7/17/2015 7:00,355,225,130,19,15
7/17/2015 8:00,658,424,234,22,17
7/17/2015 9:00,659,402,257,24,15
7/17/2015 10:00,681,381,300,28,26
7/17/2015 11:00,723,430,293,29,32
7/17/2015 12:00,805,461,344,30,32
7/17/2015 13:00,755,355,400,30,33
7/17/2015 14:00,888,461,427,31,26
7/17/2015 15:00,825,481,344,31,28
7/17/2015 16:00,869,449,420,31,30
7/17/2015 17:00,839,446,393,31,30
7/17/2015 18:00,860,422,438,30,19
7/17/2015 19:00,972,589,383,28,17
7/17/2015 20:00,953,524,429,26,15
7/17/2015 21:00,757,382,375,24,9
7/17/2015 22:00,726,313,413,21,4
7/17/2015 23:00,780,309,471,20,2
7/18/2015 0:00,654,245,409,20,0
7/18/2015 1:00,518,263,255,20,6
7/18/2015 2:00,282,109,173,21,9
7/18/2015 3:00,195,91,104,19,15
7/18/2015 4:00,122,41,81,18,11
7/18/2015 5:00,125,51,74,17,7
7/18/2015 6:00,77,38,39,17,13
7/18/2015 7:00,114,72,42,18,15
7/18/2015 8:00,260,189,71,19,20
7/18/2015 9:00,455,341,114,19,13
7/18/2015 10:00,676,506,170,20,13
7/18/2015 11:00,741,510,231,20,15
7/18/2015 12:00,925,612,313,22,19
7/18/2015 13:00,808,501,307,23,22
7/18/2015 14:00,772,367,405,23,22
7/18/2015 15:00,694,350,344,23,24
7/18/2015 16:00,639,304,335,25,24
7/18/2015 17:00,674,324,350,24,22
7/18/2015 18:00,653,337,316,24,17
7/18/2015 19:00,763,353,410,22,17
7/18/2015 20:00,697,375,322,21,9
7/18/2015 21:00,462,250,212,18,11
7/18/2015 22:00,332,118,214,17,11
7/18/2015 23:00,316,126,190,15,6
7/19/2015 0:00,289,119,170,15,2
7/19/2015 1:00,394,122,272,14,2
7/19/2015 2:00,146,50,96,13,0
7/19/2015 3:00,118,44,74,13,4
7/19/2015 4:00,64,6,58,14,2
7/19/2015 5:00,39,10,29,14,0
7/19/2015 6:00,51,12,39,14,4
7/19/2015 7:00,37,13,24,14,0
7/19/2015 8:00,66,36,30,15,6
7/19/2015 9:00,216,163,53,16,7
7/19/2015 10:00,303,200,103,16,4
7/19/2015 11:00,260,139,121,16,6
7/19/2015 12:00,269,152,117,17,6
7/19/2015 13:00,360,182,178,18,9
7/19/2015 14:00,364,181,183,17,7
7/19/2015 15:00,342,185,157,17,9
7/19/2015 16:00,334,166,168,17,11
7/19/2015 17:00,406,184,222,18,19
7/19/2015 18:00,410,225,185,18,20
7/19/2015 19:00,370,166,204,19,20
7/19/2015 20:00,288,137,151,19,19
7/19/2015 21:00,216,78,138,18,17
7/19/2015 22:00,141,33,108,16,7
7/19/2015 23:00,99,21,78,16,9
7/20/2015 0:00,94,27,67,16,17
7/20/2015 1:00,34,18,16,14,6
7/20/2015 2:00,18,11,7,12,4
7/20/2015 3:00,9,7,2,11,4
7/20/2015 4:00,16,10,6,10,4
7/20/2015 5:00,68,45,23,11,2
7/20/2015 6:00,155,106,49,11,2
7/20/2015 7:00,451,295,156,15,6
7/20/2015 8:00,781,507,274,17,9
7/20/2015 9:00,592,351,241,19,7
7/20/2015 10:00,575,319,256,20,11
7/20/2015 11:00,690,395,295,21,9
7/20/2015 12:00,652,361,291,22,13
7/20/2015 13:00,770,429,341,24,13
7/20/2015 14:00,692,343,349,24,15
7/20/2015 15:00,750,348,402,24,17
7/20/2015 16:00,944,412,532,23,17
7/20/2015 17:00,928,409,519,21,13
7/20/2015 18:00,805,369,436,20,6
7/20/2015 19:00,712,357,355,20,7
7/20/2015 20:00,508,234,274,20,4
7/20/2015 21:00,269,107,162,20,6
7/20/2015 22:00,232,62,170,20,6
7/20/2015 23:00,189,47,142,20,4
7/21/2015 0:00,110,34,76,20,4
7/21/2015 1:00,68,30,38,20,13
7/21/2015 2:00,28,5,23,20,11
7/21/2015 3:00,15,5,10,20,11
7/21/2015 4:00,28,16,12,20,9
7/21/2015 5:00,60,43,17,20,11
7/21/2015 6:00,161,112,49,20,13
7/21/2015 7:00,360,224,136,21,19
7/21/2015 8:00,660,438,222,21,20
7/21/2015 9:00,578,352,226,21,26
7/21/2015 10:00,601,327,274,22,30
7/21/2015 11:00,533,299,234,24,26
7/21/2015 12:00,740,405,335,25,33
7/21/2015 13:00,705,387,318,25,30
7/21/2015 14:00,744,365,379,26,22
7/21/2015 15:00,667,337,330,26,24
7/21/2015 16:00,853,428,425,27,26
7/21/2015 17:00,948,452,496,26,22
7/21/2015 18:00,955,469,486,26,15
7/21/2015 19:00,831,434,397,25,26
7/21/2015 20:00,600,291,309,24,9
7/21/2015 21:00,450,199,251,22,6
7/21/2015 22:00,414,142,272,21,4
7/21/2015 23:00,272,77,195,19,4
7/22/2015 0:00,200,49,151,18,0
7/22/2015 1:00,100,28,72,16,0
7/22/2015 2:00,42,10,32,17,7
7/22/2015 3:00,35,21,14,17,2
7/22/2015 4:00,31,15,16,17,4
7/22/2015 5:00,66,50,16,18,4
7/22/2015 6:00,173,123,50,18,2
7/22/2015 7:00,433,294,139,19,7
7/22/2015 8:00,746,493,253,19,15
7/22/2015 9:00,641,394,247,20,17
7/22/2015 10:00,663,390,273,21,20
7/22/2015 11:00,642,362,280,23,19
7/22/2015 12:00,824,473,351,24,20
7/22/2015 13:00,852,460,392,24,24
7/22/2015 14:00,780,378,402,25,22
7/22/2015 15:00,775,364,411,25,20
7/22/2015 16:00,917,436,481,25,20
7/22/2015 17:00,993,463,530,25,22
7/22/2015 18:00,997,484,513,23,20
7/22/2015 19:00,912,464,448,22,15
7/22/2015 20:00,674,332,342,21,13
7/22/2015 21:00,459,201,258,19,6
7/22/2015 22:00,508,210,298,17,4
7/22/2015 23:00,359,114,245,15,4
7/23/2015 0:00,353,123,230,14,0
7/23/2015 1:00,181,79,102,15,4
7/23/2015 2:00,112,28,84,16,2
7/23/2015 3:00,103,25,78,17,7
7/23/2015 4:00,84,22,62,16,7
7/23/2015 5:00,89,48,41,16,11
7/23/2015 6:00,169,126,43,16,13
7/23/2015 7:00,402,251,151,17,17
7/23/2015 8:00,686,452,234,17,19
7/23/2015 9:00,609,342,267,18,20
7/23/2015 10:00,531,313,218,19,17
7/23/2015 11:00,614,365,249,21,22
7/23/2015 12:00,659,393,266,20,17
7/23/2015 13:00,769,454,315,22,19
7/23/2015 14:00,712,384,328,21,19
7/23/2015 15:00,660,322,338,22,19
7/23/2015 16:00,893,398,495,22,17
7/23/2015 17:00,1012,494,518,22,13
7/23/2015 18:00,946,409,537,21,13
7/23/2015 19:00,850,425,425,21,9
7/23/2015 20:00,626,318,308,19,7
7/23/2015 21:00,504,201,303,16,4
7/23/2015 22:00,383,140,243,14,0
7/23/2015 23:00,299,78,221,13,2
7/24/2015 0:00,179,,179,12,2
7/24/2015 1:00,85,,85,12,4
7/24/2015 2:00,41,,41,15,7
7/24/2015 3:00,23,,23,15,6
7/24/2015 4:00,37,,37,15,6
7/24/2015 5:00,43,,43,14,2
7/24/2015 6:00,40,,40,16,4
7/24/2015 7:00,191,,191,16,6
7/24/2015 8:00,197,,197,18,7
7/24/2015 9:00,214,,214,20,7
7/24/2015 10:00,201,,201,22,7
7/24/2015 11:00,278,,278,24,7
7/24/2015 12:00,266,,266,24,13
7/24/2015 13:00,369,,369,25,11
7/24/2015 14:00,389,,389,25,9
7/24/2015 15:00,393,,393,26,11
7/24/2015 16:00,385,,385,26,7
7/24/2015 17:00,377,,377,26,11
7/24/2015 18:00,341,,341,26,6
7/24/2015 19:00,324,,324,25,6
7/24/2015 20:00,236,,236,24,6
7/24/2015 21:00,172,,172,23,6
7/24/2015 22:00,197,,197,22,4
7/24/2015 23:00,188,,188,22,7
7/25/2015 0:00,108,14,94,20,13
7/25/2015 1:00,212,59,153,18,4
7/25/2015 2:00,268,171,97,18,7
7/25/2015 3:00,361,291,70,18,7
7/25/2015 4:00,428,376,52,17,7
7/25/2015 5:00,54,25,29,17,9
7/25/2015 6:00,45,27,18,18,15
7/25/2015 7:00,55,37,18,19,20
7/25/2015 8:00,159,116,43,20,19
7/25/2015 9:00,341,262,79,21,26
7/25/2015 10:00,256,161,95,20,24
7/25/2015 11:00,283,152,131,19,26
7/25/2015 12:00,352,209,143,19,30
7/25/2015 13:00,281,145,136,16,33
7/25/2015 14:00,331,158,173,17,35
7/25/2015 15:00,222,109,113,16,44
7/25/2015 16:00,207,68,139,14,50
7/25/2015 17:00,141,37,104,13,57
7/25/2015 18:00,127,33,94,13,57
7/25/2015 19:00,180,60,120,13,48
7/25/2015 20:00,163,81,82,13,39
7/25/2015 21:00,129,70,59,12,26
7/25/2015 22:00,92,43,49,12,28
7/25/2015 23:00,64,37,27,12,32
7/26/2015 0:00,69,31,38,12,22
7/26/2015 1:00,72,19,53,12,22
7/26/2015 2:00,53,17,36,12,20
7/26/2015 3:00,31,11,20,12,19
7/26/2015 4:00,33,10,23,11,13
7/26/2015 5:00,30,10,20,10,13
7/26/2015 6:00,24,14,10,11,11
7/26/2015 7:00,38,26,12,12,13
7/26/2015 8:00,69,47,22,14,15
7/26/2015 9:00,234,163,71,15,17
7/26/2015 10:00,304,194,110,16,15
7/26/2015 11:00,423,292,131,18,15
7/26/2015 12:00,447,204,243,19,13
7/26/2015 13:00,455,235,220,20,20
7/26/2015 14:00,554,277,277,20,15
7/26/2015 15:00,528,288,240,22,19
7/26/2015 16:00,485,240,245,22,17
7/26/2015 17:00,510,203,307,21,13
7/26/2015 18:00,432,198,234,20,11
7/26/2015 19:00,349,124,225,17,15
7/26/2015 20:00,184,79,105,14,4
7/26/2015 21:00,147,52,95,14,9
7/26/2015 22:00,139,40,99,14,13
7/26/2015 23:00,93,39,54,13,11
7/27/2015 0:00,77,27,50,14,17
7/27/2015 1:00,28,8,20,13,11
7/27/2015 2:00,6,3,3,13,13
7/27/2015 3:00,6,4,2,13,15
7/27/2015 4:00,16,9,7,13,11
7/27/2015 5:00,51,29,22,13,13
7/27/2015 6:00,119,79,40,14,11
7/27/2015 7:00,348,218,130,15,15
7/27/2015 8:00,557,343,214,16,19
7/27/2015 9:00,453,285,168,17,20
7/27/2015 10:00,443,253,190,17,20
7/27/2015 11:00,418,219,199,18,28
7/27/2015 12:00,414,225,189,18,33
7/27/2015 13:00,354,166,188,17,32
7/27/2015 14:00,387,209,178,17,24
7/27/2015 15:00,379,157,222,16,26
7/27/2015 16:00,529,244,285,17,22
7/27/2015 17:00,605,277,328,18,19
7/27/2015 18:00,573,252,321,18,26
7/27/2015 19:00,487,245,242,18,24
7/27/2015 20:00,359,161,198,18,24
7/27/2015 21:00,227,103,124,18,15
7/27/2015 22:00,204,74,130,17,17
7/27/2015 23:00,171,55,116,17,24
7/28/2015 0:00,90,32,58,16,24
7/28/2015 1:00,66,17,49,15,20
7/28/2015 2:00,36,8,28,15,19
7/28/2015 3:00,22,7,15,15,20
7/28/2015 4:00,16,11,5,15,24
7/28/2015 5:00,48,32,16,14,24
7/28/2015 6:00,131,80,51,14,24
7/28/2015 7:00,342,199,143,15,30
7/28/2015 8:00,591,386,205,15,28
7/28/2015 9:00,487,341,146,16,28
7/28/2015 10:00,391,241,150,16,32
7/28/2015 11:00,407,201,206,15,30
7/28/2015 12:00,409,205,204,17,24
7/28/2015 13:00,497,274,223,19,30
7/28/2015 14:00,526,276,250,19,28
7/28/2015 15:00,512,245,267,17,13
7/28/2015 16:00,692,314,378,17,28
7/28/2015 17:00,797,360,437,18,19
7/28/2015 18:00,652,307,345,17,24
7/28/2015 19:00,546,252,294,17,26
7/28/2015 20:00,425,221,204,17,20
7/28/2015 21:00,324,158,166,16,11
7/28/2015 22:00,285,97,188,16,15
7/28/2015 23:00,169,51,118,16,20
7/29/2015 0:00,129,36,93,15,20
7/29/2015 1:00,88,36,52,15,22
7/29/2015 2:00,31,7,24,14,20
7/29/2015 3:00,24,15,9,14,19
7/29/2015 4:00,19,10,9,13,20
7/29/2015 5:00,50,34,16,13,17
7/29/2015 6:00,137,92,45,13,22
7/29/2015 7:00,393,244,149,13,20
7/29/2015 8:00,624,409,215,13,20
7/29/2015 9:00,529,349,180,15,22
7/29/2015 10:00,533,326,207,14,17
7/29/2015 11:00,499,302,197,17,24
7/29/2015 12:00,453,192,261,13,20
7/29/2015 13:00,483,269,214,15,24
7/29/2015 14:00,527,230,297,17,28
7/29/2015 15:00,485,222,263,17,43
7/29/2015 16:00,670,318,352,14,35
7/29/2015 17:00,672,346,326,15,17
7/29/2015 18:00,635,265,370,15,28
7/29/2015 19:00,576,283,293,14,20
7/29/2015 20:00,456,225,231,15,32
7/29/2015 21:00,298,154,144,14,20
7/29/2015 22:00,311,138,173,14,24
7/29/2015 23:00,217,88,129,13,24
7/30/2015 0:00,155,61,94,13,22
7/30/2015 1:00,141,50,91,12,20
7/30/2015 2:00,81,42,39,12,20
7/30/2015 3:00,66,16,50,12,22
7/30/2015 4:00,78,19,59,12,17
7/30/2015 5:00,66,36,30,12,17
7/30/2015 6:00,145,103,42,12,17
7/30/2015 7:00,391,241,150,13,22
7/30/2015 8:00,547,344,203,14,22
7/30/2015 9:00,604,378,226,15,22
7/30/2015 10:00,431,258,173,17,28
7/30/2015 11:00,463,263,200,13,22
7/30/2015 12:00,439,224,215,18,24
7/30/2015 13:00,504,269,235,17,15
7/30/2015 14:00,579,279,300,19,26
7/30/2015 15:00,544,270,274,18,30
7/30/2015 16:00,669,334,335,18,22
7/30/2015 17:00,805,381,424,19,26
7/30/2015 18:00,738,349,389,17,19
7/30/2015 19:00,577,290,287,17,20
7/30/2015 20:00,461,215,246,15,15
7/30/2015 21:00,327,147,180,13,9
7/30/2015 22:00,199,70,129,12,9
7/30/2015 23:00,212,81,131,10,7
7/31/2015 0:00,133,30,103,9,7
7/31/2015 1:00,93,31,62,9,7
7/31/2015 2:00,38,6,32,9,7
7/31/2015 3:00,22,5,17,8,7
7/31/2015 4:00,22,12,10,8,6
7/31/2015 5:00,45,28,17,7,0
7/31/2015 6:00,153,108,45,8,0
7/31/2015 7:00,373,245,128,10,6
7/31/2015 8:00,545,326,219,13,7
7/31/2015 9:00,542,363,179,14,13
7/31/2015 10:00,503,306,197,15,9
7/31/2015 11:00,557,350,207,15,11
7/31/2015 12:00,586,327,259,17,7
7/31/2015 13:00,582,304,278,17,7
7/31/2015 14:00,588,280,308,19,4
7/31/2015 15:00,660,334,326,19,9
7/31/2015 16:00,647,330,317,18,6
7/31/2015 17:00,696,342,354,18,9
7/31/2015 18:00,667,266,401,18,7
7/31/2015 19:00,587,295,292,17,7
7/31/2015 20:00,482,233,249,15,6
7/31/2015 21:00,368,195,173,13,4
7/31/2015 22:00,341,129,212,12,4
7/31/2015 23:00,255,126,129,10,2
8/1/2015 0:00,213,81,132,10,4
8/1/2015 1:00,170,52,118,10,7
8/1/2015 2:00,109,39,70,11,6
8/1/2015 3:00,73,16,57,10,6
8/1/2015 4:00,71,13,58,10,6
8/1/2015 5:00,55,19,36,10,6
8/1/2015 6:00,70,42,28,9,6
8/1/2015 7:00,83,56,27,13,6
8/1/2015 8:00,190,114,76,15,7
8/1/2015 9:00,347,248,99,17,9
8/1/2015 10:00,535,371,164,19,9
8/1/2015 11:00,535,361,174,20,6
8/1/2015 12:00,602,377,225,22,6
8/1/2015 13:00,621,310,311,22,7
8/1/2015 14:00,598,310,288,24,6
8/1/2015 15:00,673,333,340,24,7
8/1/2015 16:00,563,306,257,23,7
8/1/2015 17:00,581,256,325,23,13
8/1/2015 18:00,575,261,314,23,13
8/1/2015 19:00,659,334,325,22,13
8/1/2015 20:00,529,309,220,19,9
8/1/2015 21:00,309,152,157,17,9
8/1/2015 22:00,280,102,178,15,6
8/1/2015 23:00,262,85,177,14,4
8/2/2015 0:00,326,91,235,12,2
8/2/2015 1:00,183,63,120,11,6
8/2/2015 2:00,104,31,73,11,2
8/2/2015 3:00,97,18,79,10,4
8/2/2015 4:00,64,12,52,9,4
8/2/2015 5:00,36,10,26,9,0
8/2/2015 6:00,33,14,19,9,2
8/2/2015 7:00,46,32,14,13,2
8/2/2015 8:00,79,33,46,16,2
8/2/2015 9:00,182,116,66,19,4
8/2/2015 10:00,318,181,137,21,4
8/2/2015 11:00,358,214,144,21,7
8/2/2015 12:00,465,279,186,23,6
8/2/2015 13:00,476,278,198,23,6
8/2/2015 14:00,550,340,210,23,7
8/2/2015 15:00,611,312,299,24,9
8/2/2015 16:00,535,311,224,25,4
8/2/2015 17:00,555,253,302,25,11
8/2/2015 18:00,522,246,276,25,6
8/2/2015 19:00,566,306,260,23,9
8/2/2015 20:00,468,252,216,21,6
8/2/2015 21:00,285,106,179,19,6
8/2/2015 22:00,217,62,155,19,7
8/2/2015 23:00,330,83,247,16,4
8/3/2015 0:00,85,30,55,17,6
8/3/2015 1:00,25,11,14,16,4
8/3/2015 2:00,13,4,9,16,4
8/3/2015 3:00,9,3,6,15,4
8/3/2015 4:00,17,11,6,15,4
8/3/2015 5:00,50,34,16,16,7
8/3/2015 6:00,167,108,59,17,7
8/3/2015 7:00,460,282,178,18,9
8/3/2015 8:00,686,447,239,20,9
8/3/2015 9:00,498,292,206,23,13
8/3/2015 10:00,578,296,282,26,13
8/3/2015 11:00,647,377,270,28,13
8/3/2015 12:00,663,362,301,30,11
8/3/2015 13:00,616,315,301,31,22
8/3/2015 14:00,605,320,285,32,19
8/3/2015 15:00,715,371,344,31,19
8/3/2015 16:00,757,348,409,32,19
8/3/2015 17:00,933,451,482,32,17
8/3/2015 18:00,744,420,324,31,17
8/3/2015 19:00,819,483,336,29,7
8/3/2015 20:00,585,340,245,28,6
8/3/2015 21:00,398,155,243,23,4
8/3/2015 22:00,327,89,238,21,4
8/3/2015 23:00,267,63,204,20,4
8/4/2015 0:00,344,63,281,22,6
8/4/2015 1:00,81,19,62,19,2
8/4/2015 2:00,54,9,45,17,4
8/4/2015 3:00,10,5,5,19,4
8/4/2015 4:00,16,8,8,20,7
8/4/2015 5:00,63,38,25,20,11
8/4/2015 6:00,180,110,70,20,7
8/4/2015 7:00,458,282,176,21,7
8/4/2015 8:00,547,355,192,21,7
8/4/2015 9:00,525,348,177,24,7
8/4/2015 10:00,495,303,192,26,4
8/4/2015 11:00,510,289,221,26,15
8/4/2015 12:00,407,192,215,23,24
8/4/2015 13:00,324,139,185,19,7
8/4/2015 14:00,360,165,195,19,7
8/4/2015 15:00,400,207,193,19,7
8/4/2015 16:00,542,244,298,20,11
8/4/2015 17:00,611,271,340,17,26
8/4/2015 18:00,557,244,313,17,11
8/4/2015 19:00,486,240,246,17,9
8/4/2015 20:00,367,200,167,17,9
8/4/2015 21:00,252,100,152,16,9
8/4/2015 22:00,209,80,129,16,11
8/4/2015 23:00,113,32,81,15,9
8/5/2015 0:00,113,29,84,14,6
8/5/2015 1:00,66,6,60,13,6
8/5/2015 2:00,22,5,17,12,6
8/5/2015 3:00,16,5,11,13,7
8/5/2015 4:00,14,8,6,12,6
8/5/2015 5:00,62,41,21,12,7
8/5/2015 6:00,176,121,55,12,7
8/5/2015 7:00,487,311,176,14,7
8/5/2015 8:00,665,435,230,16,7
8/5/2015 9:00,696,433,263,18,9
8/5/2015 10:00,662,377,285,20,9
8/5/2015 11:00,606,337,269,21,13
8/5/2015 12:00,756,409,347,23,13
8/5/2015 13:00,654,330,324,23,15
8/5/2015 14:00,743,362,381,24,11
8/5/2015 15:00,725,359,366,24,13
8/5/2015 16:00,883,402,481,25,11
8/5/2015 17:00,1053,555,498,25,6
8/5/2015 18:00,944,422,522,25,7
8/5/2015 19:00,783,389,394,23,6
8/5/2015 20:00,551,265,286,22,6
8/5/2015 21:00,397,142,255,21,6
8/5/2015 22:00,360,133,227,19,6
8/5/2015 23:00,238,75,163,19,6
8/6/2015 0:00,173,81,92,18,6
8/6/2015 1:00,113,31,82,18,6
8/6/2015 2:00,72,19,53,17,6
8/6/2015 3:00,79,4,75,18,7
8/6/2015 4:00,43,10,33,17,7
8/6/2015 5:00,60,36,24,17,7
8/6/2015 6:00,185,130,55,17,6
8/6/2015 7:00,450,267,183,18,7
8/6/2015 8:00,762,497,265,21,7
8/6/2015 9:00,571,347,224,23,9
8/6/2015 10:00,529,297,232,26,6
8/6/2015 11:00,569,330,239,28,7
8/6/2015 12:00,617,313,304,30,15
8/6/2015 13:00,698,359,339,32,15
8/6/2015 14:00,718,354,364,32,13
8/6/2015 15:00,703,363,340,32,15
8/6/2015 16:00,851,427,424,32,20
8/6/2015 17:00,895,433,462,32,20
8/6/2015 18:00,822,422,400,32,22
8/6/2015 19:00,663,339,324,30,11
8/6/2015 20:00,534,262,272,26,15
8/6/2015 21:00,426,160,266,23,15
8/6/2015 22:00,368,130,238,21,7
8/6/2015 23:00,283,85,198,21,6
8/7/2015 0:00,173,60,113,19,6
8/7/2015 1:00,102,19,83,19,7
8/7/2015 2:00,54,11,43,18,7
8/7/2015 3:00,50,11,39,18,7
8/7/2015 4:00,45,10,35,18,6
8/7/2015 5:00,49,33,16,17,7
8/7/2015 6:00,132,88,44,17,9
8/7/2015 7:00,245,149,96,17,6
8/7/2015 8:00,348,229,119,17,7
8/7/2015 9:00,252,161,91,17,9
8/7/2015 10:00,321,179,142,18,4
8/7/2015 11:00,385,199,186,19,6
8/7/2015 12:00,489,256,233,22,7
8/7/2015 13:00,519,287,232,24,6
8/7/2015 14:00,564,298,266,25,4
8/7/2015 15:00,534,303,231,26,6
8/7/2015 16:00,553,301,252,26,13
8/7/2015 17:00,584,274,310,27,15
8/7/2015 18:00,603,312,291,27,13
8/7/2015 19:00,599,335,264,26,11
8/7/2015 20:00,493,260,233,24,7
8/7/2015 21:00,358,185,173,22,6
8/7/2015 22:00,324,124,200,21,2
8/7/2015 23:00,264,104,160,21,7
8/8/2015 0:00,217,82,135,22,11
8/8/2015 1:00,167,52,115,21,9
8/8/2015 2:00,145,35,110,20,11
8/8/2015 3:00,83,19,64,20,7
8/8/2015 4:00,49,6,43,19,20
8/8/2015 5:00,38,11,27,17,7
8/8/2015 6:00,42,28,14,17,7
8/8/2015 7:00,84,60,24,17,9
8/8/2015 8:00,174,101,73,18,11
8/8/2015 9:00,324,230,94,19,9
8/8/2015 10:00,457,309,148,20,13
8/8/2015 11:00,545,353,192,19,19
8/8/2015 12:00,510,329,181,19,15
8/8/2015 13:00,534,256,278,19,17
8/8/2015 14:00,568,263,305,20,15
8/8/2015 15:00,507,247,260,21,9
8/8/2015 16:00,532,233,299,22,9
8/8/2015 17:00,480,217,263,23,11
8/8/2015 18:00,466,228,238,23,13
8/8/2015 19:00,495,257,238,21,6
8/8/2015 20:00,363,192,171,20,15
8/8/2015 21:00,316,165,151,18,7
8/8/2015 22:00,290,117,173,16,6
8/8/2015 23:00,224,80,144,15,6
8/9/2015 0:00,218,89,129,14,6
8/9/2015 1:00,158,59,99,13,4
8/9/2015 2:00,131,38,93,12,7
8/9/2015 3:00,103,26,77,12,2
8/9/2015 4:00,46,7,39,11,4
8/9/2015 5:00,42,6,36,11,4
8/9/2015 6:00,40,13,27,11,2
8/9/2015 7:00,41,22,19,14,4
8/9/2015 8:00,73,44,29,16,4
8/9/2015 9:00,191,106,85,18,6
8/9/2015 10:00,288,174,114,20,6
8/9/2015 11:00,313,189,124,21,6
8/9/2015 12:00,354,170,184,22,7
8/9/2015 13:00,409,198,211,24,11
8/9/2015 14:00,449,258,191,23,7
8/9/2015 15:00,444,210,234,24,9
8/9/2015 16:00,491,235,256,24,9
8/9/2015 17:00,459,220,239,25,6
8/9/2015 18:00,437,225,212,25,7
8/9/2015 19:00,397,190,207,23,9
8/9/2015 20:00,296,116,180,22,6
8/9/2015 21:00,230,101,129,20,2
8/9/2015 22:00,192,63,129,19,2
8/9/2015 23:00,127,37,90,19,2
8/10/2015 0:00,88,25,63,19,6
8/10/2015 1:00,44,8,36,19,6
8/10/2015 2:00,8,5,3,18,4
8/10/2015 3:00,10,3,7,17,4
8/10/2015 4:00,17,10,7,17,2
8/10/2015 5:00,54,35,19,16,2
8/10/2015 6:00,157,102,55,17,6
8/10/2015 7:00,454,279,175,18,4
8/10/2015 8:00,676,404,272,19,4
8/10/2015 9:00,430,280,150,20,6
8/10/2015 10:00,375,204,171,20,6
8/10/2015 11:00,397,199,198,19,9
8/10/2015 12:00,514,287,227,21,11
8/10/2015 13:00,502,274,228,23,11
8/10/2015 14:00,623,311,312,24,7
8/10/2015 15:00,682,351,331,23,15
8/10/2015 16:00,729,358,371,22,13
8/10/2015 17:00,783,332,451,20,9
8/10/2015 18:00,665,283,382,19,11
8/10/2015 19:00,474,211,263,18,9
8/10/2015 20:00,382,165,217,18,9
8/10/2015 21:00,238,106,132,17,7
8/10/2015 22:00,163,42,121,17,6
8/10/2015 23:00,114,23,91,17,4
8/11/2015 0:00,66,17,49,16,9
8/11/2015 1:00,37,11,26,16,2
8/11/2015 2:00,18,8,10,16,9
8/11/2015 3:00,6,3,3,15,11
8/11/2015 4:00,13,7,6,14,4
8/11/2015 5:00,47,33,14,13,4
8/11/2015 6:00,181,126,55,13,0
8/11/2015 7:00,511,297,214,15,2
8/11/2015 8:00,675,429,246,16,4
8/11/2015 9:00,572,362,210,18,4
8/11/2015 10:00,537,322,215,20,4
8/11/2015 11:00,597,332,265,21,6
8/11/2015 12:00,615,311,304,23,6
8/11/2015 13:00,670,330,340,23,6
8/11/2015 14:00,709,384,325,23,9
8/11/2015 15:00,792,390,402,25,7
8/11/2015 16:00,881,433,448,25,9
8/11/2015 17:00,992,460,532,24,11
8/11/2015 18:00,911,409,502,25,9
8/11/2015 19:00,740,364,376,23,4
8/11/2015 20:00,547,267,280,21,4
8/11/2015 21:00,399,145,254,20,7
8/11/2015 22:00,309,106,203,20,9
8/11/2015 23:00,189,56,133,19,11
8/12/2015 0:00,107,36,71,19,6
8/12/2015 1:00,57,16,41,18,9
8/12/2015 2:00,16,5,11,18,9
8/12/2015 3:00,14,2,12,18,6
8/12/2015 4:00,17,11,6,17,9
8/12/2015 5:00,71,44,27,17,9
8/12/2015 6:00,211,142,69,17,13
8/12/2015 7:00,701,454,247,18,13
8/12/2015 8:00,724,454,270,18,13
8/12/2015 9:00,628,401,227,19,13
8/12/2015 10:00,548,335,213,20,9
8/12/2015 11:00,666,373,293,21,15
8/12/2015 12:00,706,367,339,22,13
8/12/2015 13:00,768,358,410,22,11
8/12/2015 14:00,702,326,376,23,13
8/12/2015 15:00,703,333,370,23,15
8/12/2015 16:00,906,438,468,23,19
8/12/2015 17:00,953,457,496,23,11
8/12/2015 18:00,900,435,465,23,15
8/12/2015 19:00,745,330,415,22,13
8/12/2015 20:00,533,227,306,21,11
8/12/2015 21:00,413,190,223,19,7
8/12/2015 22:00,351,151,200,18,6
8/12/2015 23:00,240,94,146,18,11
8/13/2015 0:00,211,108,103,18,7
8/13/2015 1:00,106,12,94,17,9
8/13/2015 2:00,81,20,61,17,9
8/13/2015 3:00,36,13,23,16,7
8/13/2015 4:00,34,10,24,17,9
8/13/2015 5:00,68,33,35,17,9
8/13/2015 6:00,199,144,55,17,9
8/13/2015 7:00,735,485,250,18,9
8/13/2015 8:00,682,420,262,19,11
8/13/2015 9:00,539,326,213,21,17
8/13/2015 10:00,539,298,241,23,13
8/13/2015 11:00,548,310,238,24,13
8/13/2015 12:00,581,307,274,25,17
8/13/2015 13:00,690,348,342,26,11
8/13/2015 14:00,762,385,377,27,13
8/13/2015 15:00,783,372,411,27,13
8/13/2015 16:00,896,466,430,28,13
8/13/2015 17:00,920,458,462,28,13
8/13/2015 18:00,929,463,466,28,15
8/13/2015 19:00,723,345,378,27,11
8/13/2015 20:00,572,302,270,25,9
8/13/2015 21:00,409,168,241,24,9
8/13/2015 22:00,376,113,263,24,9
8/13/2015 23:00,225,72,153,23,6
8/14/2015 0:00,168,50,118,22,7
8/14/2015 1:00,68,16,52,23,9
8/14/2015 2:00,20,0,20,21,7
8/14/2015 3:00,21,6,15,20,4
8/14/2015 4:00,19,11,8,20,4
8/14/2015 5:00,66,39,27,19,9
8/14/2015 6:00,169,113,56,19,2
8/14/2015 7:00,708,473,235,20,2
8/14/2015 8:00,601,371,230,21,6
8/14/2015 9:00,525,347,178,22,11
8/14/2015 10:00,427,244,183,23,19
8/14/2015 11:00,492,270,222,24,19
8/14/2015 12:00,591,291,300,25,17
8/14/2015 13:00,756,348,408,26,22
8/14/2015 14:00,675,331,344,26,20
8/14/2015 15:00,715,346,369,25,11
8/14/2015 16:00,722,333,389,25,9
8/14/2015 17:00,673,327,346,26,6
8/14/2015 18:00,714,357,357,25,4
8/14/2015 19:00,623,342,281,24,6
8/14/2015 20:00,532,286,246,23,4
8/14/2015 21:00,235,106,129,22,15
8/14/2015 22:00,252,82,170,20,6
8/14/2015 23:00,277,111,166,20,4
8/15/2015 0:00,237,91,146,20,2
8/15/2015 1:00,210,58,152,20,2
8/15/2015 2:00,116,33,83,19,2
8/15/2015 3:00,65,10,55,19,4
8/15/2015 4:00,41,6,35,19,4
8/15/2015 5:00,68,24,44,19,6
8/15/2015 6:00,69,44,25,19,6
8/15/2015 7:00,132,111,21,19,6
8/15/2015 8:00,217,156,61,20,9
8/15/2015 9:00,427,299,128,21,9
8/15/2015 10:00,642,448,194,23,15
8/15/2015 11:00,690,434,256,24,11
8/15/2015 12:00,865,558,307,24,13
8/15/2015 13:00,853,469,384,24,11
8/15/2015 14:00,659,310,349,24,13
8/15/2015 15:00,600,274,326,25,7
8/15/2015 16:00,547,207,340,25,13
8/15/2015 17:00,552,234,318,25,9
8/15/2015 18:00,519,222,297,25,15
8/15/2015 19:00,456,230,226,22,19
8/15/2015 20:00,319,152,167,21,13
8/15/2015 21:00,198,84,114,19,6
8/15/2015 22:00,233,89,144,18,9
8/15/2015 23:00,221,80,141,18,17
8/16/2015 0:00,185,82,103,18,13
8/16/2015 1:00,137,56,81,18,13
8/16/2015 2:00,97,20,77,17,9
8/16/2015 3:00,85,24,61,17,9
8/16/2015 4:00,50,11,39,17,9
8/16/2015 5:00,23,1,22,17,13
8/16/2015 6:00,21,6,15,16,15
8/16/2015 7:00,34,15,19,16,13
8/16/2015 8:00,51,28,23,16,9
8/16/2015 9:00,118,82,36,17,11
8/16/2015 10:00,185,95,90,17,11
8/16/2015 11:00,126,90,36,17,9
8/16/2015 12:00,125,58,67,18,11
8/16/2015 13:00,121,57,64,18,15
8/16/2015 14:00,184,90,94,18,15
8/16/2015 15:00,137,69,68,17,17
8/16/2015 16:00,139,77,62,17,15
8/16/2015 17:00,130,61,69,17,15
8/16/2015 18:00,105,40,65,16,15
8/16/2015 19:00,121,46,75,16,13
8/16/2015 20:00,88,36,52,16,11
8/16/2015 21:00,56,24,32,16,13
8/16/2015 22:00,78,25,53,16,13
8/16/2015 23:00,37,12,25,16,11
8/17/2015 0:00,26,8,18,16,13
8/17/2015 1:00,11,1,10,15,13
8/17/2015 2:00,4,0,4,15,13
8/17/2015 3:00,6,4,2,15,17
8/17/2015 4:00,11,10,1,15,15
8/17/2015 5:00,40,27,13,14,17
8/17/2015 6:00,96,68,28,14,13
8/17/2015 7:00,513,357,156,14,13
8/17/2015 8:00,379,229,150,14,13
8/17/2015 9:00,284,190,94,14,11
8/17/2015 10:00,175,89,86,15,13
8/17/2015 11:00,190,83,107,15,15
8/17/2015 12:00,286,164,122,15,13
8/17/2015 13:00,331,158,173,16,15
8/17/2015 14:00,317,147,170,16,13
8/17/2015 15:00,377,176,201,15,11
8/17/2015 16:00,382,167,215,15,13
8/17/2015 17:00,462,200,262,15,7
8/17/2015 18:00,379,140,239,15,11
8/17/2015 19:00,267,132,135,15,7
8/17/2015 20:00,199,82,117,15,7
8/17/2015 21:00,120,46,74,15,9
8/17/2015 22:00,107,45,62,15,7
8/17/2015 23:00,49,14,35,15,9
8/18/2015 0:00,27,12,15,15,9
8/18/2015 1:00,20,8,12,15,9
8/18/2015 2:00,5,2,3,15,9
8/18/2015 3:00,4,3,1,15,13
8/18/2015 4:00,12,7,5,15,13
8/18/2015 5:00,35,28,7,14,13
8/18/2015 6:00,126,85,41,14,15
8/18/2015 7:00,615,443,172,14,15
8/18/2015 8:00,582,349,233,14,15
8/18/2015 9:00,471,308,163,14,17
8/18/2015 10:00,408,251,157,14,17
8/18/2015 11:00,460,254,206,14,15
8/18/2015 12:00,542,285,257,14,17
8/18/2015 13:00,522,267,255,15,15
8/18/2015 14:00,593,304,289,16,17
8/18/2015 15:00,583,261,322,15,13
8/18/2015 16:00,716,327,389,15,13
8/18/2015 17:00,804,361,443,16,11
8/18/2015 18:00,713,324,389,16,9
8/18/2015 19:00,644,306,338,16,6
8/18/2015 20:00,516,249,267,14,4
8/18/2015 21:00,289,115,174,13,0
8/18/2015 22:00,299,117,182,13,6
8/18/2015 23:00,174,57,117,13,4
8/19/2015 0:00,100,34,66,13,6
8/19/2015 1:00,43,11,32,12,0
8/19/2015 2:00,18,6,12,13,6
8/19/2015 3:00,13,4,9,13,4
8/19/2015 4:00,14,6,8,11,4
8/19/2015 5:00,56,42,14,11,4
8/19/2015 6:00,173,129,44,10,4
8/19/2015 7:00,814,577,237,12,6
8/19/2015 8:00,749,465,284,14,7
8/19/2015 9:00,647,403,244,16,9
8/19/2015 10:00,553,350,203,17,9
8/19/2015 11:00,549,320,229,18,7
8/19/2015 12:00,594,330,264,19,11
8/19/2015 13:00,699,324,375,19,7
8/19/2015 14:00,689,324,365,20,9
8/19/2015 15:00,745,346,399,20,4
8/19/2015 16:00,906,457,449,20,2
8/19/2015 17:00,1019,479,540,20,4
8/19/2015 18:00,851,382,469,20,6
8/19/2015 19:00,857,393,464,18,4
8/19/2015 20:00,564,273,291,16,2
8/19/2015 21:00,380,166,214,15,2
8/19/2015 22:00,359,163,196,14,2
8/19/2015 23:00,248,105,143,13,2
8/20/2015 0:00,146,39,107,12,2
8/20/2015 1:00,107,41,66,12,4
8/20/2015 2:00,70,16,54,12,2
8/20/2015 3:00,75,12,63,12,2
8/20/2015 4:00,49,13,36,12,2
8/20/2015 5:00,61,30,31,13,4
8/20/2015 6:00,174,119,55,13,0
8/20/2015 7:00,758,505,253,14,4
8/20/2015 8:00,719,456,263,16,4
8/20/2015 9:00,562,349,213,17,4
8/20/2015 10:00,480,285,195,20,4
8/20/2015 11:00,525,267,258,21,6
8/20/2015 12:00,638,355,283,22,9
8/20/2015 13:00,660,313,347,22,7
8/20/2015 14:00,742,362,380,22,6
8/20/2015 15:00,799,405,394,23,7
8/20/2015 16:00,857,422,435,24,6
8/20/2015 17:00,1032,484,548,23,7
8/20/2015 18:00,949,452,497,23,6
8/20/2015 19:00,737,372,365,21,4
8/20/2015 20:00,537,252,285,18,0
8/20/2015 21:00,392,150,242,16,0
8/20/2015 22:00,353,129,224,15,4
8/20/2015 23:00,208,53,155,14,4
8/21/2015 0:00,120,32,88,15,4
8/21/2015 1:00,51,18,33,14,2
8/21/2015 2:00,26,11,15,14,4
8/21/2015 3:00,21,6,15,14,2
8/21/2015 4:00,29,15,14,14,4
8/21/2015 5:00,58,40,18,14,6
8/21/2015 6:00,184,131,53,14,6
8/21/2015 7:00,732,492,240,15,4
8/21/2015 8:00,608,387,221,17,6
8/21/2015 9:00,577,366,211,19,6
8/21/2015 10:00,511,293,218,21,6
8/21/2015 11:00,546,306,240,22,7
8/21/2015 12:00,645,364,281,24,11
8/21/2015 13:00,773,354,419,24,7
8/21/2015 14:00,865,417,448,25,7
8/21/2015 15:00,817,418,399,25,4
8/21/2015 16:00,775,406,369,25,2
8/21/2015 17:00,793,365,428,25,6
8/21/2015 18:00,803,389,414,25,4
8/21/2015 19:00,686,342,344,23,4
8/21/2015 20:00,526,269,257,21,6
8/21/2015 21:00,392,197,195,18,6
8/21/2015 22:00,389,128,261,17,6
8/21/2015 23:00,279,95,184,17,4
8/22/2015 0:00,218,85,133,17,4
8/22/2015 1:00,205,75,130,16,6
8/22/2015 2:00,150,63,87,16,7
8/22/2015 3:00,93,25,68,16,6
8/22/2015 4:00,75,25,50,15,6
8/22/2015 5:00,44,20,24,14,4
8/22/2015 6:00,48,27,21,12,2
8/22/2015 7:00,94,66,28,17,4
8/22/2015 8:00,192,132,60,19,6
8/22/2015 9:00,385,273,112,21,7
8/22/2015 10:00,501,321,180,23,11
8/22/2015 11:00,615,361,254,24,11
8/22/2015 12:00,691,399,292,25,11
8/22/2015 13:00,626,356,270,25,13
8/22/2015 14:00,588,293,295,25,11
8/22/2015 15:00,612,292,320,25,9
8/22/2015 16:00,565,259,306,25,11
8/22/2015 17:00,563,229,334,25,7
8/22/2015 18:00,575,230,345,25,6
8/22/2015 19:00,566,269,297,23,6
8/22/2015 20:00,405,191,214,20,4
8/22/2015 21:00,320,166,154,19,7
8/22/2015 22:00,313,130,183,20,9
8/22/2015 23:00,260,86,174,19,6
8/23/2015 0:00,241,129,112,18,6
8/23/2015 1:00,195,81,114,18,6
8/23/2015 2:00,138,47,91,18,7
8/23/2015 3:00,108,26,82,18,7
8/23/2015 4:00,58,10,48,17,7
8/23/2015 5:00,46,15,31,17,7
8/23/2015 6:00,34,12,22,17,7
8/23/2015 7:00,44,24,20,17,9
8/23/2015 8:00,84,50,34,19,11
8/23/2015 9:00,196,107,89,20,9
8/23/2015 10:00,318,157,161,22,13
8/23/2015 11:00,298,142,156,23,20
8/23/2015 12:00,394,203,191,24,19
8/23/2015 13:00,418,208,210,24,17
8/23/2015 14:00,483,266,217,25,19
8/23/2015 15:00,525,282,243,25,19
8/23/2015 16:00,517,277,240,25,19
8/23/2015 17:00,531,283,248,24,19
8/23/2015 18:00,508,248,260,23,13
8/23/2015 19:00,384,158,226,22,9
8/23/2015 20:00,308,105,203,21,9
8/23/2015 21:00,206,71,135,21,11
8/23/2015 22:00,173,67,106,21,11
8/23/2015 23:00,90,36,54,20,13
8/24/2015 0:00,48,14,34,19,6
8/24/2015 1:00,26,9,17,17,9
8/24/2015 2:00,14,9,5,16,4
8/24/2015 3:00,5,2,3,15,4
8/24/2015 4:00,11,7,4,15,4
8/24/2015 5:00,37,26,11,15,6
8/24/2015 6:00,161,115,46,15,4
8/24/2015 7:00,640,428,212,16,4
8/24/2015 8:00,626,391,235,16,7
8/24/2015 9:00,530,310,220,17,9
8/24/2015 10:00,453,274,179,19,15
8/24/2015 11:00,466,249,217,21,13
8/24/2015 12:00,549,306,243,22,19
8/24/2015 13:00,620,298,322,23,17
8/24/2015 14:00,578,283,295,23,11
8/24/2015 15:00,642,276,366,24,28
8/24/2015 16:00,763,361,402,23,28
8/24/2015 17:00,901,405,496,23,20
8/24/2015 18:00,815,317,498,24,24
8/24/2015 19:00,642,305,337,22,24
8/24/2015 20:00,429,212,217,21,19
8/24/2015 21:00,286,135,151,21,26
8/24/2015 22:00,238,73,165,20,30
8/24/2015 23:00,121,37,84,19,24
8/25/2015 0:00,79,24,55,19,22
8/25/2015 1:00,28,12,16,18,13
8/25/2015 2:00,12,3,9,17,20
8/25/2015 3:00,10,6,4,16,17
8/25/2015 4:00,14,9,5,17,26
8/25/2015 5:00,44,31,13,14,19
8/25/2015 6:00,136,95,41,14,17
8/25/2015 7:00,447,303,144,14,19
8/25/2015 8:00,500,327,173,16,22
8/25/2015 9:00,509,319,190,17,20
8/25/2015 10:00,415,241,174,17,30
8/25/2015 11:00,404,187,217,18,30
8/25/2015 12:00,423,190,233,19,24
8/25/2015 13:00,431,206,225,17,30
8/25/2015 14:00,520,261,259,17,15
8/25/2015 15:00,597,284,313,19,22
8/25/2015 16:00,701,352,349,19,28
8/25/2015 17:00,837,389,448,19,20
8/25/2015 18:00,782,346,436,19,13
8/25/2015 19:00,589,277,312,18,9
8/25/2015 20:00,412,170,242,15,4
8/25/2015 21:00,275,94,181,15,9
8/25/2015 22:00,239,95,144,14,11
8/25/2015 23:00,128,27,101,14,11
8/26/2015 0:00,78,23,55,15,13
8/26/2015 1:00,33,7,26,14,9
8/26/2015 2:00,21,11,10,15,7
8/26/2015 3:00,9,3,6,17,13
8/26/2015 4:00,17,12,5,17,13
8/26/2015 5:00,48,32,16,17,11
8/26/2015 6:00,174,112,62,17,9
8/26/2015 7:00,746,505,241,17,9
8/26/2015 8:00,781,490,291,18,13
8/26/2015 9:00,580,376,204,19,19
8/26/2015 10:00,561,337,224,21,28
8/26/2015 11:00,575,307,268,22,24
8/26/2015 12:00,699,368,331,23,24
8/26/2015 13:00,742,362,380,24,24
8/26/2015 14:00,691,297,394,25,24
8/26/2015 15:00,783,384,399,26,24
8/26/2015 16:00,984,509,475,26,13
8/26/2015 17:00,1021,517,504,26,19
8/26/2015 18:00,1063,504,559,25,9
8/26/2015 19:00,805,388,417,24,13
8/26/2015 20:00,578,273,305,23,15
8/26/2015 21:00,467,156,311,23,15
8/26/2015 22:00,411,167,244,23,19
8/26/2015 23:00,272,104,168,22,13
8/27/2015 0:00,146,60,86,21,7
8/27/2015 1:00,104,32,72,19,2
8/27/2015 2:00,80,9,71,20,7
8/27/2015 3:00,74,11,63,20,7
8/27/2015 4:00,57,14,43,21,11
8/27/2015 5:00,64,36,28,19,13
8/27/2015 6:00,155,97,58,19,15
8/27/2015 7:00,616,393,223,19,15
8/27/2015 8:00,610,398,212,19,17
8/27/2015 9:00,448,290,158,19,17
8/27/2015 10:00,397,256,141,19,17
8/27/2015 11:00,481,273,208,20,20
8/27/2015 12:00,523,284,239,19,19
8/27/2015 13:00,509,251,258,18,17
8/27/2015 14:00,453,207,246,17,17
8/27/2015 15:00,479,204,275,16,17
8/27/2015 16:00,540,263,277,15,17
8/27/2015 17:00,669,301,368,15,13
8/27/2015 18:00,606,280,326,15,11
8/27/2015 19:00,483,227,256,14,9
8/27/2015 20:00,344,148,196,14,9
8/27/2015 21:00,218,91,127,14,9
8/27/2015 22:00,183,74,109,14,9
8/27/2015 23:00,103,31,72,14,9
8/28/2015 0:00,74,25,49,13,9
8/28/2015 1:00,43,8,35,13,9
8/28/2015 2:00,19,5,14,13,6
8/28/2015 3:00,18,5,13,13,9
8/28/2015 4:00,27,12,15,13,9
8/28/2015 5:00,52,36,16,13,15
8/28/2015 6:00,135,90,45,13,9
8/28/2015 7:00,605,419,186,14,9
8/28/2015 8:00,572,371,201,14,11
8/28/2015 9:00,441,303,138,15,7
8/28/2015 10:00,492,289,203,16,15
8/28/2015 11:00,498,280,218,17,17
8/28/2015 12:00,615,329,286,19,13
8/28/2015 13:00,680,319,361,20,15
8/28/2015 14:00,746,373,373,19,11
8/28/2015 15:00,767,408,359,21,15
8/28/2015 16:00,750,390,360,21,13
8/28/2015 17:00,809,401,408,21,15
8/28/2015 18:00,836,417,419,21,15
8/28/2015 19:00,669,325,344,19,9
8/28/2015 20:00,552,284,268,16,4
8/28/2015 21:00,430,169,261,14,2
8/28/2015 22:00,293,117,176,13,6
8/28/2015 23:00,255,80,175,12,2
8/29/2015 0:00,230,77,153,12,2
8/29/2015 1:00,169,65,104,11,2
8/29/2015 2:00,124,35,89,11,0
8/29/2015 3:00,83,20,63,10,2
8/29/2015 4:00,52,19,33,10,6
8/29/2015 5:00,54,19,35,11,6
8/29/2015 6:00,83,44,39,10,4
8/29/2015 7:00,106,67,39,12,4
8/29/2015 8:00,174,125,49,14,6
8/29/2015 9:00,374,296,78,16,7
8/29/2015 10:00,487,332,155,19,6
8/29/2015 11:00,684,441,243,20,6
8/29/2015 12:00,668,429,239,21,9
8/29/2015 13:00,648,360,288,22,7
8/29/2015 14:00,734,381,353,23,4
8/29/2015 15:00,689,352,337,23,7
8/29/2015 16:00,682,337,345,24,4
8/29/2015 17:00,747,369,378,24,6
8/29/2015 18:00,675,337,338,23,4
8/29/2015 19:00,609,300,309,21,4
8/29/2015 20:00,489,245,244,19,6
8/29/2015 21:00,366,220,146,18,6
8/29/2015 22:00,361,146,215,17,6
8/29/2015 23:00,332,104,228,16,2
8/30/2015 0:00,228,80,148,16,4
8/30/2015 1:00,197,95,102,15,2
8/30/2015 2:00,135,35,100,16,4
8/30/2015 3:00,126,24,102,16,4
8/30/2015 4:00,69,10,59,17,7
8/30/2015 5:00,45,19,26,18,17
8/30/2015 6:00,47,24,23,17,6
8/30/2015 7:00,52,37,15,17,2
8/30/2015 8:00,89,50,39,18,4
8/30/2015 9:00,208,129,79,20,4
8/30/2015 10:00,247,157,90,20,9
8/30/2015 11:00,319,187,132,22,7
8/30/2015 12:00,389,232,157,24,9
8/30/2015 13:00,491,306,185,26,6
8/30/2015 14:00,596,355,241,27,4
8/30/2015 15:00,539,327,212,28,6
8/30/2015 16:00,498,275,223,27,13
8/30/2015 17:00,613,270,343,27,9
8/30/2015 18:00,420,214,206,26,11
8/30/2015 19:00,400,181,219,25,7
8/30/2015 20:00,293,120,173,23,9
8/30/2015 21:00,241,82,159,22,4
8/30/2015 22:00,221,75,146,21,2
8/30/2015 23:00,108,24,84,21,2
8/31/2015 0:00,70,23,47,21,4
8/31/2015 1:00,29,10,19,20,15
8/31/2015 2:00,12,7,5,19,7
8/31/2015 3:00,13,4,9,19,6
8/31/2015 4:00,17,9,8,20,13
8/31/2015 5:00,60,40,20,19,6
8/31/2015 6:00,152,104,48,19,4
8/31/2015 7:00,690,451,239,20,7
8/31/2015 8:00,694,432,262,21,13
8/31/2015 9:00,557,366,191,22,15
8/31/2015 10:00,518,291,227,25,7
8/31/2015 11:00,551,279,272,26,11
8/31/2015 12:00,685,352,333,28,9
8/31/2015 13:00,624,292,332,29,7
8/31/2015 14:00,738,389,349,30,11
8/31/2015 15:00,744,368,376,31,15
8/31/2015 16:00,926,461,465,31,15
8/31/2015 17:00,932,452,480,30,15
8/31/2015 18:00,916,426,490,29,9
8/31/2015 19:00,676,364,312,27,24
8/31/2015 20:00,545,233,312,25,19
8/31/2015 21:00,359,144,215,23,24
8/31/2015 22:00,251,82,169,22,15
8/31/2015 23:00,140,40,100,21,19
9/1/2015 0:00,100,28,72,21,20
9/1/2015 1:00,48,12,36,20,13
9/1/2015 2:00,15,5,10,20,19
9/1/2015 3:00,7,6,1,20,24
9/1/2015 4:00,13,10,3,19,20
9/1/2015 5:00,56,34,22,19,15
9/1/2015 6:00,176,121,55,18,15
9/1/2015 7:00,702,469,233,17,17
9/1/2015 8:00,721,454,267,17,11
9/1/2015 9:00,499,291,208,17,9
9/1/2015 10:00,402,214,188,16,11
9/1/2015 11:00,261,125,136,16,11
9/1/2015 12:00,402,198,204,16,9
9/1/2015 13:00,389,205,184,16,13
9/1/2015 14:00,414,221,193,16,13
9/1/2015 15:00,509,234,275,16,13
9/1/2015 16:00,644,358,286,17,11
9/1/2015 17:00,851,410,441,17,15
9/1/2015 18:00,735,342,393,17,9
9/1/2015 19:00,622,317,305,16,15
9/1/2015 20:00,498,245,253,14,7
9/1/2015 21:00,305,118,187,13,9
9/1/2015 22:00,330,123,207,13,9
9/1/2015 23:00,125,34,91,12,9
9/2/2015 0:00,108,36,72,12,13
9/2/2015 1:00,43,9,34,12,11
9/2/2015 2:00,22,3,19,11,9
9/2/2015 3:00,10,5,5,12,11
9/2/2015 4:00,18,10,8,11,7
9/2/2015 5:00,43,30,13,11,9
9/2/2015 6:00,184,130,54,10,9
9/2/2015 7:00,736,512,224,11,9
9/2/2015 8:00,781,515,266,13,13
9/2/2015 9:00,689,441,248,15,13
9/2/2015 10:00,598,382,216,16,17
9/2/2015 11:00,608,332,276,17,19
9/2/2015 12:00,653,339,314,18,19
9/2/2015 13:00,731,350,381,18,15
9/2/2015 14:00,679,313,366,17,13
9/2/2015 15:00,709,334,375,17,17
9/2/2015 16:00,810,373,437,18,13
9/2/2015 17:00,943,453,490,18,15
9/2/2015 18:00,883,432,451,17,13
9/2/2015 19:00,753,364,389,15,4
9/2/2015 20:00,523,240,283,13,2
9/2/2015 21:00,359,153,206,12,6
9/2/2015 22:00,337,129,208,13,6
9/2/2015 23:00,251,99,152,12,2
9/3/2015 0:00,150,69,81,11,2
9/3/2015 1:00,89,29,60,11,2
9/3/2015 2:00,71,10,61,12,0
9/3/2015 3:00,42,8,34,12,2
9/3/2015 4:00,30,10,20,12,2
9/3/2015 5:00,69,36,33,12,4
9/3/2015 6:00,167,128,39,11,7
9/3/2015 7:00,695,459,236,11,6
9/3/2015 8:00,751,475,276,13,6
9/3/2015 9:00,595,371,224,14,9
9/3/2015 10:00,475,283,192,15,11
9/3/2015 11:00,467,254,213,16,11
9/3/2015 12:00,556,279,277,16,13
9/3/2015 13:00,603,293,310,17,15
9/3/2015 14:00,719,365,354,17,11
9/3/2015 15:00,687,321,366,17,19
9/3/2015 16:00,867,404,463,17,15
9/3/2015 17:00,941,427,514,16,19
9/3/2015 18:00,821,363,458,15,11
9/3/2015 19:00,702,329,373,15,9
9/3/2015 20:00,444,208,236,14,9
9/3/2015 21:00,365,146,219,13,9
9/3/2015 22:00,298,85,213,13,9
9/3/2015 23:00,142,50,92,13,9
9/4/2015 0:00,101,28,73,13,11
9/4/2015 1:00,62,26,36,12,9
9/4/2015 2:00,28,10,18,12,9
9/4/2015 3:00,26,5,21,11,11
9/4/2015 4:00,21,10,11,11,11
9/4/2015 5:00,51,31,20,11,11
9/4/2015 6:00,184,130,54,11,11
9/4/2015 7:00,674,476,198,11,15
9/4/2015 8:00,658,429,229,12,17
9/4/2015 9:00,538,363,175,13,15
9/4/2015 10:00,432,264,168,15,22
9/4/2015 11:00,461,277,184,16,24
9/4/2015 12:00,551,277,274,16,26
9/4/2015 13:00,667,329,338,16,28
9/4/2015 14:00,653,309,344,17,26
9/4/2015 15:00,676,345,331,17,26
9/4/2015 16:00,637,290,347,17,30
9/4/2015 17:00,679,328,351,16,26
9/4/2015 18:00,576,246,330,15,26
9/4/2015 19:00,577,281,296,15,24
9/4/2015 20:00,397,208,189,14,26
9/4/2015 21:00,270,114,156,13,24
9/4/2015 22:00,215,79,136,13,26
9/4/2015 23:00,225,93,132,13,20
9/5/2015 0:00,163,54,109,13,22
9/5/2015 1:00,160,71,89,13,17
9/5/2015 2:00,95,29,66,13,13
9/5/2015 3:00,48,9,39,12,15
9/5/2015 4:00,33,7,26,12,13
9/5/2015 5:00,53,12,41,13,19
9/5/2015 6:00,45,21,24,13,13
9/5/2015 7:00,85,60,25,13,15
9/5/2015 8:00,161,106,55,13,24
9/5/2015 9:00,286,202,84,14,28
9/5/2015 10:00,338,209,129,13,24
9/5/2015 11:00,272,165,107,15,22
9/5/2015 12:00,264,153,111,14,24
9/5/2015 13:00,340,210,130,16,28
9/5/2015 14:00,338,193,145,15,22
9/5/2015 15:00,364,179,185,15,22
9/5/2015 16:00,386,215,171,15,22
9/5/2015 17:00,374,158,216,15,19
9/5/2015 18:00,415,195,220,14,19
9/5/2015 19:00,397,215,182,13,13
9/5/2015 20:00,368,219,149,12,15
9/5/2015 21:00,270,174,96,11,20
9/5/2015 22:00,264,134,130,11,15
9/5/2015 23:00,245,85,160,10,19
9/6/2015 0:00,190,61,129,10,19
9/6/2015 1:00,150,52,98,10,20
9/6/2015 2:00,129,27,102,10,20
9/6/2015 3:00,80,13,67,10,19
9/6/2015 4:00,58,9,49,10,20
9/6/2015 5:00,47,11,36,10,19
9/6/2015 6:00,66,41,25,10,22
9/6/2015 7:00,78,49,29,11,22
9/6/2015 8:00,388,337,51,12,24
9/6/2015 9:00,507,244,263,13,24
9/6/2015 10:00,544,276,268,14,22
9/6/2015 11:00,459,316,143,15,22
9/6/2015 12:00,571,445,126,16,22
9/6/2015 13:00,484,249,235,16,24
9/6/2015 14:00,549,216,333,16,24
9/6/2015 15:00,403,194,209,15,22
9/6/2015 16:00,374,196,178,13,28
9/6/2015 17:00,396,186,210,15,24
9/6/2015 18:00,350,171,179,14,19
9/6/2015 19:00,352,152,200,14,13
9/6/2015 20:00,211,97,114,13,15
9/6/2015 21:00,168,61,107,13,17
9/6/2015 22:00,155,59,96,12,17
9/6/2015 23:00,97,42,55,12,19
9/7/2015 0:00,37,10,27,12,19
9/7/2015 1:00,28,15,13,12,22
9/7/2015 2:00,7,3,4,12,20
9/7/2015 3:00,3,3,0,12,20
9/7/2015 4:00,15,10,5,12,17
9/7/2015 5:00,44,35,9,12,13
9/7/2015 6:00,159,119,40,13,13
9/7/2015 7:00,658,455,203,13,13
9/7/2015 8:00,691,422,269,13,9
9/7/2015 9:00,511,317,194,14,11
9/7/2015 10:00,457,281,176,15,13
9/7/2015 11:00,391,210,181,16,15
9/7/2015 12:00,554,317,237,16,13
9/7/2015 13:00,507,235,272,15,6
9/7/2015 14:00,510,257,253,16,13
9/7/2015 15:00,587,285,302,17,11
9/7/2015 16:00,728,361,367,16,7
9/7/2015 17:00,866,400,466,16,7
9/7/2015 18:00,823,338,485,15,7
9/7/2015 19:00,583,286,297,15,6
9/7/2015 20:00,373,165,208,14,7
9/7/2015 21:00,273,109,164,12,7
9/7/2015 22:00,200,66,134,11,6
9/7/2015 23:00,141,35,106,12,6
9/8/2015 0:00,84,35,49,12,6
9/8/2015 1:00,43,15,28,10,4
9/8/2015 2:00,8,4,4,10,4
9/8/2015 3:00,15,4,11,11,6
9/8/2015 4:00,15,8,7,12,6
9/8/2015 5:00,54,40,14,12,6
9/8/2015 6:00,177,132,45,13,6
9/8/2015 7:00,652,461,191,13,6
9/8/2015 8:00,598,343,255,13,7
9/8/2015 9:00,455,284,171,14,7
9/8/2015 10:00,336,198,138,14,9
9/8/2015 11:00,404,236,168,15,11
9/8/2015 12:00,470,264,206,15,4
9/8/2015 13:00,515,239,276,16,7
9/8/2015 14:00,519,273,246,16,9
9/8/2015 15:00,584,275,309,16,11
9/8/2015 16:00,711,348,363,16,7
9/8/2015 17:00,839,371,468,17,7
9/8/2015 18:00,760,337,423,16,6
9/8/2015 19:00,590,290,300,15,6
9/8/2015 20:00,393,181,212,14,2
9/8/2015 21:00,282,110,172,13,2
9/8/2015 22:00,273,105,168,11,2
9/8/2015 23:00,192,58,134,10,2
9/9/2015 0:00,75,26,49,10,0
9/9/2015 1:00,31,9,22,9,2
9/9/2015 2:00,15,3,12,9,2
9/9/2015 3:00,19,6,13,8,2
9/9/2015 4:00,18,12,6,7,2
9/9/2015 5:00,42,26,16,6,2
9/9/2015 6:00,181,126,55,9,2
9/9/2015 7:00,725,492,233,11,7
9/9/2015 8:00,690,435,255,12,7
9/9/2015 9:00,604,385,219,13,6
9/9/2015 10:00,510,316,194,15,7
9/9/2015 11:00,465,277,188,15,15
9/9/2015 12:00,705,387,318,16,11
9/9/2015 13:00,737,370,367,17,11
9/9/2015 14:00,734,345,389,17,9
9/9/2015 15:00,724,361,363,18,17
9/9/2015 16:00,897,439,458,18,11
9/9/2015 17:00,1002,469,533,18,13
9/9/2015 18:00,955,463,492,17,7
9/9/2015 19:00,766,384,382,16,6
9/9/2015 20:00,518,249,269,14,6
9/9/2015 21:00,408,169,239,13,7
9/9/2015 22:00,325,122,203,12,7
9/9/2015 23:00,251,123,128,11,2
9/10/2015 0:00,152,57,95,9,4
9/10/2015 1:00,107,35,72,9,6
9/10/2015 2:00,78,10,68,9,6
9/10/2015 3:00,79,10,69,9,7
9/10/2015 4:00,43,15,28,8,7
9/10/2015 5:00,66,42,24,9,7
9/10/2015 6:00,174,121,53,9,7
9/10/2015 7:00,726,498,228,9,7
9/10/2015 8:00,763,488,275,12,9
9/10/2015 9:00,594,367,227,15,9
9/10/2015 10:00,490,314,176,16,13
9/10/2015 11:00,482,287,195,17,15
9/10/2015 12:00,653,373,280,17,17
9/10/2015 13:00,713,343,370,18,17
9/10/2015 14:00,736,354,382,18,15
9/10/2015 15:00,732,350,382,19,11
9/10/2015 16:00,901,430,471,18,17
9/10/2015 17:00,1002,444,558,19,11
9/10/2015 18:00,874,374,500,18,9
9/10/2015 19:00,696,319,377,16,7
9/10/2015 20:00,477,203,274,14,6
9/10/2015 21:00,356,147,209,13,7
9/10/2015 22:00,333,116,217,13,6
9/10/2015 23:00,196,70,126,12,6
9/11/2015 0:00,98,37,61,11,6
9/11/2015 1:00,63,23,40,11,7
9/11/2015 2:00,28,9,19,10,9
9/11/2015 3:00,18,7,11,10,7
9/11/2015 4:00,20,9,11,10,7
9/11/2015 5:00,52,37,15,9,6
9/11/2015 6:00,172,116,56,9,6
9/11/2015 7:00,656,462,194,8,4
9/11/2015 8:00,637,397,240,11,7
9/11/2015 9:00,517,339,178,13,7
9/11/2015 10:00,511,284,227,15,7
9/11/2015 11:00,460,260,200,16,9
9/11/2015 12:00,574,320,254,16,15
9/11/2015 13:00,676,327,349,18,9
9/11/2015 14:00,762,355,407,19,11
9/11/2015 15:00,716,364,352,19,11
9/11/2015 16:00,756,367,389,19,13
9/11/2015 17:00,750,387,363,19,7
9/11/2015 18:00,733,348,385,18,6
9/11/2015 19:00,660,293,367,16,6
9/11/2015 20:00,510,238,272,15,7
9/11/2015 21:00,379,178,201,14,7
9/11/2015 22:00,278,120,158,14,7
9/11/2015 23:00,253,120,133,13,6
9/12/2015 0:00,225,96,129,12,6
9/12/2015 1:00,198,80,118,12,6
9/12/2015 2:00,152,21,131,11,6
9/12/2015 3:00,87,21,66,11,4
9/12/2015 4:00,68,13,55,11,4
9/12/2015 5:00,54,24,30,11,6
9/12/2015 6:00,40,26,14,11,4
9/12/2015 7:00,106,71,35,12,7
9/12/2015 8:00,189,137,52,13,11
9/12/2015 9:00,328,247,81,14,7
9/12/2015 10:00,443,321,122,16,9
9/12/2015 11:00,570,396,174,19,11
9/12/2015 12:00,596,376,220,19,9
9/12/2015 13:00,514,273,241,20,11
9/12/2015 14:00,502,229,273,19,7
9/12/2015 15:00,546,264,282,20,11
9/12/2015 16:00,501,212,289,20,7
9/12/2015 17:00,535,245,290,19,4
9/12/2015 18:00,377,127,250,17,4
9/12/2015 19:00,334,151,183,16,4
9/12/2015 20:00,259,144,115,16,6
9/12/2015 21:00,154,77,77,16,7
9/12/2015 22:00,146,60,86,16,6
9/12/2015 23:00,149,69,80,16,4
9/13/2015 0:00,143,61,82,16,6
9/13/2015 1:00,100,51,49,16,6
9/13/2015 2:00,86,24,62,16,7
9/13/2015 3:00,89,22,67,16,6
9/13/2015 4:00,58,6,52,16,6
9/13/2015 5:00,44,17,27,15,6
9/13/2015 6:00,37,19,18,16,6
9/13/2015 7:00,59,37,22,16,6
9/13/2015 8:00,59,33,26,16,9
9/13/2015 9:00,139,105,34,17,9
9/13/2015 10:00,246,162,84,18,11
9/13/2015 11:00,297,178,119,18,9
9/13/2015 12:00,297,163,134,19,9
9/13/2015 13:00,360,205,155,20,6
9/13/2015 14:00,411,203,208,20,7
9/13/2015 15:00,383,188,195,20,13
9/13/2015 16:00,294,128,166,19,11
9/13/2015 17:00,366,163,203,18,9
9/13/2015 18:00,284,137,147,17,11
9/13/2015 19:00,304,120,184,17,9
9/13/2015 20:00,207,87,120,17,11
9/13/2015 21:00,136,50,86,17,9
9/13/2015 22:00,132,42,90,17,11
9/13/2015 23:00,81,25,56,16,9
9/14/2015 0:00,33,8,25,16,9
9/14/2015 1:00,8,4,4,16,6
9/14/2015 2:00,15,4,11,15,7
9/14/2015 3:00,2,1,1,16,6
9/14/2015 4:00,12,8,4,16,7
9/14/2015 5:00,55,35,20,16,7
9/14/2015 6:00,150,100,50,16,7
9/14/2015 7:00,544,370,174,16,7
9/14/2015 8:00,612,367,245,16,7
9/14/2015 9:00,513,309,204,16,7
9/14/2015 10:00,410,256,154,17,11
9/14/2015 11:00,383,222,161,17,11
9/14/2015 12:00,517,273,244,18,15
9/14/2015 13:00,548,271,277,19,19
9/14/2015 14:00,556,280,276,20,15
9/14/2015 15:00,625,294,331,21,22
9/14/2015 16:00,755,367,388,21,22
9/14/2015 17:00,978,434,544,20,20
9/14/2015 18:00,653,285,368,16,11
9/14/2015 19:00,634,294,340,15,9
9/14/2015 20:00,365,166,199,16,15
9/14/2015 21:00,276,124,152,15,20
9/14/2015 22:00,219,64,155,14,22
9/14/2015 23:00,129,30,99,13,20
9/15/2015 0:00,80,26,54,13,19
9/15/2015 1:00,56,13,43,13,24
9/15/2015 2:00,13,6,7,12,17
9/15/2015 3:00,9,4,5,11,15
9/15/2015 4:00,21,14,7,11,15
9/15/2015 5:00,54,38,16,11,13
9/15/2015 6:00,167,125,42,10,13
9/15/2015 7:00,693,485,208,11,15
9/15/2015 8:00,741,455,286,12,15
9/15/2015 9:00,475,285,190,12,19
9/15/2015 10:00,436,240,196,13,13
9/15/2015 11:00,425,228,197,14,28
9/15/2015 12:00,459,253,206,13,24
9/15/2015 13:00,523,266,257,14,19
9/15/2015 14:00,608,299,309,16,22
9/15/2015 15:00,661,331,330,16,28
9/15/2015 16:00,784,379,405,17,24
9/15/2015 17:00,944,430,514,17,20
9/15/2015 18:00,775,336,439,16,13
9/15/2015 19:00,707,373,334,16,13
9/15/2015 20:00,454,222,232,16,13
9/15/2015 21:00,290,146,144,14,13
9/15/2015 22:00,314,118,196,13,11
9/15/2015 23:00,168,45,123,12,9
9/16/2015 0:00,131,31,100,11,6
9/16/2015 1:00,64,12,52,11,7
9/16/2015 2:00,24,10,14,11,9
9/16/2015 3:00,14,9,5,12,6
9/16/2015 4:00,18,12,6,11,9
9/16/2015 5:00,37,24,13,11,7
9/16/2015 6:00,147,106,41,12,7
9/16/2015 7:00,564,393,171,12,9
9/16/2015 8:00,646,415,231,13,11
9/16/2015 9:00,560,345,215,14,13
9/16/2015 10:00,403,231,172,15,17
9/16/2015 11:00,472,272,200,17,19
9/16/2015 12:00,587,331,256,18,22
9/16/2015 13:00,571,278,293,17,19
9/16/2015 14:00,535,261,274,17,17
9/16/2015 15:00,522,238,284,17,17
9/16/2015 16:00,518,227,291,16,15
9/16/2015 17:00,735,350,385,17,17
9/16/2015 18:00,716,360,356,17,9
9/16/2015 19:00,502,236,266,17,15
9/16/2015 20:00,306,136,170,17,13
9/16/2015 21:00,292,142,150,17,19
9/16/2015 22:00,233,89,144,17,19
9/16/2015 23:00,161,72,89,18,19
9/17/2015 0:00,160,81,79,18,26
9/17/2015 1:00,88,34,54,18,26
9/17/2015 2:00,50,11,39,17,22
9/17/2015 3:00,41,6,35,16,20
9/17/2015 4:00,41,10,31,17,28
9/17/2015 5:00,67,37,30,16,24
9/17/2015 6:00,145,102,43,16,20
9/17/2015 7:00,601,420,181,16,22
9/17/2015 8:00,626,372,254,17,22
9/17/2015 9:00,523,353,170,17,17
9/17/2015 10:00,385,234,151,17,19
9/17/2015 11:00,470,258,212,18,24
9/17/2015 12:00,541,302,239,18,30
9/17/2015 13:00,601,267,334,18,30
9/17/2015 14:00,615,329,286,18,26
9/17/2015 15:00,681,364,317,18,33
9/17/2015 16:00,729,377,352,17,28
9/17/2015 17:00,794,361,433,15,26
9/17/2015 18:00,547,235,312,14,22
9/17/2015 19:00,535,231,304,14,15
9/17/2015 20:00,292,122,170,14,19
9/17/2015 21:00,239,100,139,14,17
9/17/2015 22:00,218,80,138,13,15
9/17/2015 23:00,161,48,113,13,11
9/18/2015 0:00,98,33,65,12,11
9/18/2015 1:00,61,19,42,12,13
9/18/2015 2:00,20,2,18,12,13
9/18/2015 3:00,11,6,5,11,11
9/18/2015 4:00,24,14,10,11,11
9/18/2015 5:00,42,27,15,11,11
9/18/2015 6:00,146,104,42,11,11
9/18/2015 7:00,597,415,182,11,9
9/18/2015 8:00,604,383,221,12,13
9/18/2015 9:00,519,325,194,14,15
9/18/2015 10:00,440,269,171,15,17
9/18/2015 11:00,481,298,183,16,17
9/18/2015 12:00,608,351,257,18,17
9/18/2015 13:00,728,361,367,18,19
9/18/2015 14:00,730,348,382,18,13
9/18/2015 15:00,708,362,346,19,13
9/18/2015 16:00,690,342,348,19,17
9/18/2015 17:00,741,373,368,17,7
9/18/2015 18:00,639,281,358,17,7
9/18/2015 19:00,621,289,332,16,6
9/18/2015 20:00,485,264,221,15,9
9/18/2015 21:00,326,156,170,15,7
9/18/2015 22:00,319,152,167,13,7
9/18/2015 23:00,226,93,133,13,7
9/19/2015 0:00,238,95,143,12,6
9/19/2015 1:00,206,69,137,12,6
9/19/2015 2:00,121,30,91,12,6
9/19/2015 3:00,129,41,88,12,6
9/19/2015 4:00,86,37,49,12,6
9/19/2015 5:00,56,29,27,12,4
9/19/2015 6:00,57,40,17,13,7
9/19/2015 7:00,113,85,28,13,7
9/19/2015 8:00,252,185,67,13,9
9/19/2015 9:00,565,471,94,14,9
9/19/2015 10:00,813,659,154,14,13
9/19/2015 11:00,879,718,161,15,15
9/19/2015 12:00,879,636,243,16,13
9/19/2015 13:00,863,612,251,15,13
9/19/2015 14:00,725,424,301,14,6
9/19/2015 15:00,652,372,280,16,7
9/19/2015 16:00,624,353,271,14,19
9/19/2015 17:00,465,228,237,14,7
9/19/2015 18:00,435,197,238,14,6
9/19/2015 19:00,413,193,220,13,4
9/19/2015 20:00,360,200,160,12,0
9/19/2015 21:00,251,142,109,12,4
9/19/2015 22:00,232,110,122,12,6
9/19/2015 23:00,185,84,101,12,6
9/20/2015 0:00,205,75,130,12,6
9/20/2015 1:00,170,67,103,11,7
9/20/2015 2:00,86,29,57,11,9
9/20/2015 3:00,92,23,69,11,9
9/20/2015 4:00,49,14,35,10,7
9/20/2015 5:00,34,12,22,10,7
9/20/2015 6:00,43,17,26,10,9
9/20/2015 7:00,33,20,13,10,7
9/20/2015 8:00,85,55,30,11,9
9/20/2015 9:00,181,128,53,13,13
9/20/2015 10:00,303,219,84,14,17
9/20/2015 11:00,277,166,111,15,19
9/20/2015 12:00,300,165,135,15,19
9/20/2015 13:00,325,163,162,14,17
9/20/2015 14:00,353,202,151,17,22
9/20/2015 15:00,324,190,134,16,24
9/20/2015 16:00,362,192,170,16,20
9/20/2015 17:00,379,168,211,17,30
9/20/2015 18:00,350,172,178,16,19
9/20/2015 19:00,355,154,201,15,11
9/20/2015 20:00,213,86,127,14,11
9/20/2015 21:00,178,70,108,14,9
9/20/2015 22:00,153,52,101,14,9
9/20/2015 23:00,64,23,41,14,7
9/21/2015 0:00,32,14,18,13,11
9/21/2015 1:00,24,9,15,13,9
9/21/2015 2:00,3,1,2,12,6
9/21/2015 3:00,5,3,2,13,6
9/21/2015 4:00,11,5,6,12,7
9/21/2015 5:00,55,39,16,12,7
9/21/2015 6:00,167,125,42,12,7
9/21/2015 7:00,682,483,199,12,7
9/21/2015 8:00,755,403,352,12,9
9/21/2015 9:00,619,358,261,13,6
9/21/2015 10:00,470,282,188,15,11
9/21/2015 11:00,546,320,226,17,17
9/21/2015 12:00,674,378,296,17,19
9/21/2015 13:00,642,316,326,18,20
9/21/2015 14:00,725,366,359,18,17
9/21/2015 15:00,765,378,387,18,19
9/21/2015 16:00,858,411,447,18,15
9/21/2015 17:00,953,451,502,17,9
9/21/2015 18:00,830,373,457,16,6
9/21/2015 19:00,691,348,343,13,4
9/21/2015 20:00,413,187,226,13,6
9/21/2015 21:00,299,122,177,13,6
9/21/2015 22:00,276,94,182,13,6
9/21/2015 23:00,168,43,125,13,6
9/22/2015 0:00,72,21,51,13,7
9/22/2015 1:00,50,19,31,13,9
9/22/2015 2:00,17,4,13,13,7
9/22/2015 3:00,5,3,2,12,11
9/22/2015 4:00,9,6,3,12,7
9/22/2015 5:00,46,33,13,12,11
9/22/2015 6:00,171,124,47,12,13
9/22/2015 7:00,595,410,185,12,15
9/22/2015 8:00,753,413,340,13,13
9/22/2015 9:00,584,352,232,13,13
9/22/2015 10:00,480,288,192,14,11
9/22/2015 11:00,465,243,222,15,13
9/22/2015 12:00,500,268,232,15,13
9/22/2015 13:00,525,279,246,14,9
9/22/2015 14:00,523,270,253,14,9
9/22/2015 15:00,613,299,314,15,13
9/22/2015 16:00,748,356,392,14,13
9/22/2015 17:00,807,384,423,15,9
9/22/2015 18:00,804,414,390,14,6
9/22/2015 19:00,697,368,329,13,4
9/22/2015 20:00,365,177,188,13,6
9/22/2015 21:00,337,137,200,12,4
9/22/2015 22:00,236,76,160,12,11
9/22/2015 23:00,169,53,116,12,11
9/23/2015 0:00,75,21,54,12,11
9/23/2015 1:00,69,18,51,12,11
9/23/2015 2:00,28,5,23,12,13
9/23/2015 3:00,11,2,9,11,15
9/23/2015 4:00,13,9,4,11,11
9/23/2015 5:00,44,30,14,11,11
9/23/2015 6:00,150,113,37,11,9
9/23/2015 7:00,564,404,160,11,11
9/23/2015 8:00,582,339,243,11,19
9/23/2015 9:00,618,364,254,12,13
9/23/2015 10:00,437,263,174,12,6
9/23/2015 11:00,486,289,197,14,15
9/23/2015 12:00,597,318,279,15,11
9/23/2015 13:00,578,300,278,15,11
9/23/2015 14:00,598,297,301,16,11
9/23/2015 15:00,650,346,304,16,7
9/23/2015 16:00,779,400,379,16,6
9/23/2015 17:00,893,487,406,17,4
9/23/2015 18:00,811,397,414,16,6
9/23/2015 19:00,762,392,370,13,4
9/23/2015 20:00,459,235,224,11,6
9/23/2015 21:00,403,156,247,12,7
9/23/2015 22:00,352,146,206,13,7
9/23/2015 23:00,260,109,151,13,15
9/24/2015 0:00,150,62,88,13,11
9/24/2015 1:00,122,59,63,12,7
9/24/2015 2:00,86,12,74,12,11
9/24/2015 3:00,73,10,63,11,11
9/24/2015 4:00,49,6,43,11,11
9/24/2015 5:00,79,40,39,11,13
9/24/2015 6:00,152,107,45,11,13
9/24/2015 7:00,688,459,229,11,11
9/24/2015 8:00,746,436,310,12,17
9/24/2015 9:00,608,347,261,13,19
9/24/2015 10:00,537,327,210,14,19
9/24/2015 11:00,607,372,235,15,19
9/24/2015 12:00,620,335,285,15,20
9/24/2015 13:00,703,312,391,15,17
9/24/2015 14:00,679,378,301,16,17
9/24/2015 15:00,761,395,366,17,19
9/24/2015 16:00,794,404,390,17,19
9/24/2015 17:00,968,476,492,16,13
9/24/2015 18:00,815,386,429,17,15
9/24/2015 19:00,649,320,329,16,15
9/24/2015 20:00,416,196,220,16,13
9/24/2015 21:00,347,123,224,15,20
9/24/2015 22:00,280,111,169,13,13
9/24/2015 23:00,207,74,133,13,7
9/25/2015 0:00,125,34,91,13,9
9/25/2015 1:00,91,24,67,11,7
9/25/2015 2:00,27,6,21,10,7
9/25/2015 3:00,24,5,19,10,6
9/25/2015 4:00,34,16,18,11,7
9/25/2015 5:00,52,39,13,11,7
9/25/2015 6:00,167,120,47,12,7
9/25/2015 7:00,584,395,189,12,11
9/25/2015 8:00,625,370,255,12,11
9/25/2015 9:00,523,328,195,12,13
9/25/2015 10:00,449,281,168,12,11
9/25/2015 11:00,479,250,229,13,13
9/25/2015 12:00,640,337,303,15,11
9/25/2015 13:00,662,316,346,17,15
9/25/2015 14:00,769,377,392,16,9
9/25/2015 15:00,759,425,334,16,20
9/25/2015 16:00,686,355,331,15,6
9/25/2015 17:00,736,367,369,15,6
9/25/2015 18:00,667,313,354,15,4
9/25/2015 19:00,625,315,310,11,4
9/25/2015 20:00,454,255,199,13,6
9/25/2015 21:00,300,162,138,13,4
9/25/2015 22:00,265,112,153,13,6
9/25/2015 23:00,235,74,161,12,4
9/26/2015 0:00,252,102,150,11,6
9/26/2015 1:00,195,64,131,10,0
9/26/2015 2:00,141,59,82,9,2
9/26/2015 3:00,128,33,95,9,6
9/26/2015 4:00,73,19,54,8,4
9/26/2015 5:00,66,32,34,6,4
9/26/2015 6:00,57,36,21,6,0
9/26/2015 7:00,92,62,30,5,2
9/26/2015 8:00,188,138,50,8,2
9/26/2015 9:00,361,250,111,11,2
9/26/2015 10:00,416,284,132,14,7
9/26/2015 11:00,528,369,159,15,7
9/26/2015 12:00,674,426,248,15,9
9/26/2015 13:00,619,386,233,17,7
9/26/2015 14:00,579,308,271,16,7
9/26/2015 15:00,565,266,299,16,13
9/26/2015 16:00,557,235,322,15,13
9/26/2015 17:00,543,265,278,15,7
9/26/2015 18:00,541,214,327,13,6
9/26/2015 19:00,469,199,270,11,2
9/26/2015 20:00,353,181,172,10,2
9/26/2015 21:00,272,142,130,9,0
9/26/2015 22:00,237,102,135,8,2
9/26/2015 23:00,214,102,112,7,2
9/27/2015 0:00,198,66,132,7,4
9/27/2015 1:00,167,67,100,6,2
9/27/2015 2:00,130,51,79,5,4
9/27/2015 3:00,111,30,81,5,4
9/27/2015 4:00,65,17,48,5,2
9/27/2015 5:00,36,13,23,4,0
9/27/2015 6:00,49,24,25,4,2
9/27/2015 7:00,29,21,8,4,2
9/27/2015 8:00,76,51,25,7,0
9/27/2015 9:00,179,124,55,11,4
9/27/2015 10:00,254,177,77,14,7
9/27/2015 11:00,443,258,185,15,13
9/27/2015 12:00,555,279,276,16,9
9/27/2015 13:00,453,260,193,15,11
9/27/2015 14:00,619,348,271,15,11
9/27/2015 15:00,552,309,243,16,17
9/27/2015 16:00,479,248,231,15,13
9/27/2015 17:00,463,242,221,15,11
9/27/2015 18:00,392,181,211,14,4
9/27/2015 19:00,361,168,193,11,4
9/27/2015 20:00,227,89,138,10,4
9/27/2015 21:00,146,48,98,9,6
9/27/2015 22:00,136,54,82,9,6
9/27/2015 23:00,78,19,59,10,2
9/28/2015 0:00,29,12,17,10,2
9/28/2015 1:00,14,8,6,11,7
9/28/2015 2:00,10,7,3,11,9
9/28/2015 3:00,6,5,1,9,2
9/28/2015 4:00,19,10,9,8,0
9/28/2015 5:00,35,24,11,7,2
9/28/2015 6:00,161,114,47,6,2
9/28/2015 7:00,654,444,210,6,2
9/28/2015 8:00,777,423,354,8,2
9/28/2015 9:00,610,346,264,11,2
9/28/2015 10:00,511,298,213,14,4
9/28/2015 11:00,502,275,227,15,7
9/28/2015 12:00,624,326,298,15,7
9/28/2015 13:00,682,341,341,17,9
9/28/2015 14:00,695,357,338,17,15
9/28/2015 15:00,737,363,374,16,15
9/28/2015 16:00,935,512,423,17,7
9/28/2015 17:00,982,488,494,15,13
9/28/2015 18:00,975,449,526,13,6
9/28/2015 19:00,705,336,369,11,4
9/28/2015 20:00,428,227,201,10,6
9/28/2015 21:00,322,152,170,9,4
9/28/2015 22:00,275,90,185,8,2
9/28/2015 23:00,184,40,144,7,2
9/29/2015 0:00,99,22,77,7,6
9/29/2015 1:00,68,6,62,8,4
9/29/2015 2:00,16,1,15,6,4
9/29/2015 3:00,8,5,3,7,4
9/29/2015 4:00,12,7,5,5,2
9/29/2015 5:00,43,29,14,6,4
9/29/2015 6:00,179,127,52,6,6
9/29/2015 7:00,715,459,256,6,4
9/29/2015 8:00,792,466,326,9,7
9/29/2015 9:00,637,388,249,12,7
9/29/2015 10:00,503,290,213,14,11
9/29/2015 11:00,584,318,266,15,15
9/29/2015 12:00,711,392,319,16,19
9/29/2015 13:00,722,361,361,16,15
9/29/2015 14:00,785,419,366,16,13
9/29/2015 15:00,819,430,389,16,15
9/29/2015 16:00,959,477,482,16,15
9/29/2015 17:00,1123,570,553,15,13
9/29/2015 18:00,961,465,496,14,11
9/29/2015 19:00,713,335,378,12,6
9/29/2015 20:00,498,227,271,11,7
9/29/2015 21:00,367,134,233,10,7
9/29/2015 22:00,381,151,230,10,7
9/29/2015 23:00,188,72,116,10,7
9/30/2015 0:00,123,21,102,10,7
9/30/2015 1:00,73,13,60,9,6
9/30/2015 2:00,34,15,19,9,7
9/30/2015 3:00,13,4,9,8,9
9/30/2015 4:00,10,7,3,8,7
9/30/2015 5:00,46,34,12,7,7
9/30/2015 6:00,158,120,38,7,7
9/30/2015 7:00,720,488,232,6,9
9/30/2015 8:00,786,465,321,9,9
9/30/2015 9:00,721,429,292,11,9
9/30/2015 10:00,593,358,235,14,9
9/30/2015 11:00,658,382,276,15,13
9/30/2015 12:00,739,420,319,16,13
9/30/2015 13:00,819,422,397,17,15
9/30/2015 14:00,834,406,428,17,15
9/30/2015 15:00,861,440,421,17,19
9/30/2015 16:00,927,503,424,16,17
9/30/2015 17:00,1092,526,566,15,13
9/30/2015 18:00,955,430,525,14,9
9/30/2015 19:00,792,432,360,12,6
9/30/2015 20:00,556,308,248,11,7
9/30/2015 21:00,387,187,200,10,7
9/30/2015 22:00,350,155,195,9,7
9/30/2015 23:00,250,110,140,9,7
10/1/2015 0:00,190,77,113,8,6
10/1/2015 1:00,147,63,84,8,6
10/1/2015 2:00,91,4,87,7,6
10/1/2015 3:00,103,8,95,7,7
10/1/2015 4:00,84,24,60,7,7
10/1/2015 5:00,71,39,32,5,6
10/1/2015 6:00,156,108,48,5,6
10/1/2015 7:00,694,462,232,5,4
10/1/2015 8:00,742,416,326,7,6
10/1/2015 9:00,777,444,333,11,11
10/1/2015 10:00,484,290,194,13,13
10/1/2015 11:00,533,288,245,14,19
10/1/2015 12:00,685,347,338,15,15
10/1/2015 13:00,734,372,362,16,17
10/1/2015 14:00,784,381,403,16,11
10/1/2015 15:00,879,482,397,16,11
10/1/2015 16:00,1051,567,484,16,17
10/1/2015 17:00,1057,512,545,15,7
10/1/2015 18:00,937,451,486,13,4
10/1/2015 19:00,724,353,371,10,6
10/1/2015 20:00,490,244,246,7,6
10/1/2015 21:00,267,112,155,8,6
10/1/2015 22:00,292,110,182,6,4
10/1/2015 23:00,247,87,160,5,4
10/2/2015 0:00,115,41,74,4,4
10/2/2015 1:00,55,18,37,3,2
10/2/2015 2:00,29,4,25,3,4
10/2/2015 3:00,24,4,20,3,4
10/2/2015 4:00,25,6,19,3,4
10/2/2015 5:00,51,31,20,2,6
10/2/2015 6:00,162,109,53,2,4
10/2/2015 7:00,632,434,198,2,2
10/2/2015 8:00,676,374,302,4,2
10/2/2015 9:00,639,383,256,10,0
10/2/2015 10:00,540,343,197,13,6
10/2/2015 11:00,582,366,216,15,9
10/2/2015 12:00,708,362,346,16,9
10/2/2015 13:00,833,399,434,17,9
10/2/2015 14:00,827,420,407,18,13
10/2/2015 15:00,887,495,392,18,9
10/2/2015 16:00,846,450,396,18,9
10/2/2015 17:00,927,498,429,17,13
10/2/2015 18:00,801,401,400,14,9
10/2/2015 19:00,684,396,288,12,9
10/2/2015 20:00,461,246,215,11,4
10/2/2015 21:00,327,182,145,9,6
10/2/2015 22:00,310,151,159,10,9
10/2/2015 23:00,249,118,131,10,7
10/3/2015 0:00,209,77,132,9,6
10/3/2015 1:00,172,52,120,10,9
10/3/2015 2:00,149,34,115,7,6
10/3/2015 3:00,92,11,81,6,6
10/3/2015 4:00,88,19,69,4,4
10/3/2015 5:00,63,24,39,4,2
10/3/2015 6:00,55,36,19,4,2
10/3/2015 7:00,137,95,42,4,4
10/3/2015 8:00,283,184,99,7,4
10/3/2015 9:00,264,159,105,9,2
10/3/2015 10:00,431,268,163,13,6
10/3/2015 11:00,741,514,227,14,4
10/3/2015 12:00,865,556,309,15,2
10/3/2015 13:00,835,494,341,16,2
10/3/2015 14:00,791,505,286,17,4
10/3/2015 15:00,750,427,323,18,4
10/3/2015 16:00,678,324,354,19,2
10/3/2015 17:00,707,338,369,18,2
10/3/2015 18:00,550,251,299,15,2
10/3/2015 19:00,462,237,225,12,0
10/3/2015 20:00,384,252,132,11,2
10/3/2015 21:00,257,131,126,11,4
10/3/2015 22:00,219,109,110,11,0
10/3/2015 23:00,180,79,101,9,2
10/4/2015 0:00,177,71,106,8,2
10/4/2015 1:00,149,49,100,7,0
10/4/2015 2:00,121,31,90,7,0
10/4/2015 3:00,84,24,60,7,0
10/4/2015 4:00,49,13,36,7,2
10/4/2015 5:00,37,5,32,7,2
10/4/2015 6:00,27,9,18,8,2
10/4/2015 7:00,27,15,12,7,0
10/4/2015 8:00,74,47,27,9,2
10/4/2015 9:00,168,115,53,11,2
10/4/2015 10:00,246,171,75,13,4
10/4/2015 11:00,307,164,143,15,4
10/4/2015 12:00,357,187,170,16,6
10/4/2015 13:00,439,262,177,18,7
10/4/2015 14:00,494,270,224,18,9
10/4/2015 15:00,541,314,227,19,11
10/4/2015 16:00,607,320,287,19,11
10/4/2015 17:00,549,288,261,18,7
10/4/2015 18:00,437,177,260,14,4
10/4/2015 19:00,482,176,306,12,2
10/4/2015 20:00,293,92,201,12,2
10/4/2015 21:00,187,64,123,13,6
10/4/2015 22:00,153,53,100,13,7
10/4/2015 23:00,100,35,65,11,4
10/5/2015 0:00,46,16,30,10,4
10/5/2015 1:00,25,10,15,9,2
10/5/2015 2:00,16,8,8,9,4
10/5/2015 3:00,7,6,1,9,6
10/5/2015 4:00,13,6,7,9,6
10/5/2015 5:00,46,32,14,9,4
10/5/2015 6:00,144,107,37,9,6
10/5/2015 7:00,468,264,204,9,7
10/5/2015 8:00,678,381,297,10,9
10/5/2015 9:00,681,403,278,12,9
10/5/2015 10:00,521,322,199,14,9
10/5/2015 11:00,543,328,215,15,13
10/5/2015 12:00,676,396,280,17,13
10/5/2015 13:00,736,381,355,17,9
10/5/2015 14:00,882,456,426,17,15
10/5/2015 15:00,1053,489,564,18,9
10/5/2015 16:00,1149,521,628,18,7
10/5/2015 17:00,1148,586,562,18,7
10/5/2015 18:00,883,451,432,16,6
10/5/2015 19:00,715,404,311,16,6
10/5/2015 20:00,419,211,208,15,7
10/5/2015 21:00,276,116,160,15,7
10/5/2015 22:00,245,87,158,15,7
10/5/2015 23:00,185,43,142,15,9
10/6/2015 0:00,121,30,91,15,7
10/6/2015 1:00,111,20,91,14,7
10/6/2015 2:00,30,8,22,13,7
10/6/2015 3:00,5,2,3,13,9
10/6/2015 4:00,18,8,10,13,9
10/6/2015 5:00,41,25,16,13,11
10/6/2015 6:00,112,75,37,13,13
10/6/2015 7:00,399,207,192,13,11
10/6/2015 8:00,606,323,283,13,11
10/6/2015 9:00,691,327,364,14,13
10/6/2015 10:00,448,247,201,15,15
10/6/2015 11:00,443,259,184,15,15
10/6/2015 12:00,515,291,224,16,17
10/6/2015 13:00,603,345,258,16,13
10/6/2015 14:00,659,369,290,17,9
10/6/2015 15:00,711,423,288,17,4
10/6/2015 16:00,780,420,360,19,7
10/6/2015 17:00,911,496,415,18,4
10/6/2015 18:00,873,470,403,17,6
10/6/2015 19:00,805,448,357,17,6
10/6/2015 20:00,446,250,196,17,6
10/6/2015 21:00,308,153,155,16,6
10/6/2015 22:00,355,153,202,16,7
10/6/2015 23:00,324,137,187,16,6
10/7/2015 0:00,151,48,103,15,6
10/7/2015 1:00,172,19,153,15,6
10/7/2015 2:00,92,12,80,14,6
10/7/2015 3:00,61,12,49,14,6
10/7/2015 4:00,33,8,25,14,6
10/7/2015 5:00,51,36,15,15,6
10/7/2015 6:00,126,89,37,14,7
10/7/2015 7:00,533,298,235,14,6
10/7/2015 8:00,742,409,333,14,6
10/7/2015 9:00,804,477,327,16,9
10/7/2015 10:00,582,337,245,17,9
10/7/2015 11:00,754,404,350,17,13
10/7/2015 12:00,729,398,331,17,13
10/7/2015 13:00,684,374,310,16,9
10/7/2015 14:00,745,402,343,18,11
10/7/2015 15:00,858,503,355,18,13
10/7/2015 16:00,861,447,414,17,17
10/7/2015 17:00,1007,534,473,17,15
10/7/2015 18:00,854,402,452,16,7
10/7/2015 19:00,770,438,332,15,7
10/7/2015 20:00,468,229,239,15,7
10/7/2015 21:00,399,241,158,14,13
10/7/2015 22:00,362,124,238,14,13
10/7/2015 23:00,273,147,126,14,13
10/8/2015 0:00,212,98,114,14,11
10/8/2015 1:00,158,36,122,14,13
10/8/2015 2:00,102,12,90,14,11
10/8/2015 3:00,98,8,90,13,11
10/8/2015 4:00,86,12,74,13,11
10/8/2015 5:00,85,41,44,13,13
10/8/2015 6:00,154,97,57,13,13
10/8/2015 7:00,421,233,188,13,9
10/8/2015 8:00,640,358,282,13,9
10/8/2015 9:00,651,294,357,13,7
10/8/2015 10:00,524,268,256,13,11
10/8/2015 11:00,476,272,204,14,9
10/8/2015 12:00,459,237,222,14,9
10/8/2015 13:00,439,225,214,14,7
10/8/2015 14:00,607,361,246,14,9
10/8/2015 15:00,655,366,289,14,9
10/8/2015 16:00,771,471,300,14,9
10/8/2015 17:00,791,452,339,14,11
10/8/2015 18:00,696,357,339,14,6
10/8/2015 19:00,568,307,261,13,6
10/8/2015 20:00,335,189,146,13,11
10/8/2015 21:00,232,95,137,13,9
10/8/2015 22:00,237,92,145,13,7
10/8/2015 23:00,205,71,134,12,6
10/9/2015 0:00,166,41,125,12,4
10/9/2015 1:00,105,10,95,12,7
10/9/2015 2:00,46,8,38,12,9
10/9/2015 3:00,28,9,19,12,6
10/9/2015 4:00,29,15,14,12,4
10/9/2015 5:00,43,30,13,12,6
10/9/2015 6:00,116,83,33,12,6
10/9/2015 7:00,370,222,148,12,9
10/9/2015 8:00,562,330,232,12,7
10/9/2015 9:00,475,266,209,12,6
10/9/2015 10:00,335,205,130,13,9
10/9/2015 11:00,412,244,168,14,11
10/9/2015 12:00,569,323,246,14,11
10/9/2015 13:00,583,302,281,14,13
10/9/2015 14:00,599,344,255,14,13
10/9/2015 15:00,585,308,277,15,13
10/9/2015 16:00,553,293,260,15,11
10/9/2015 17:00,634,336,298,14,11
10/9/2015 18:00,570,246,324,14,9
10/9/2015 19:00,492,259,233,14,11
10/9/2015 20:00,328,171,157,13,4
10/9/2015 21:00,320,162,158,13,6
10/9/2015 22:00,262,108,154,13,7
10/9/2015 23:00,222,98,124,12,7
10/10/2015 0:00,200,89,111,12,9
10/10/2015 1:00,168,68,100,11,11
10/10/2015 2:00,113,27,86,11,7
10/10/2015 3:00,118,45,73,11,4
10/10/2015 4:00,44,11,33,10,7
10/10/2015 5:00,61,27,34,10,7
10/10/2015 6:00,57,25,32,10,7
10/10/2015 7:00,72,41,31,9,11
10/10/2015 8:00,156,97,59,9,9
10/10/2015 9:00,289,221,68,8,15
10/10/2015 10:00,396,285,111,10,13
10/10/2015 11:00,446,292,154,11,13
10/10/2015 12:00,538,353,185,12,13
10/10/2015 13:00,521,297,224,13,11
10/10/2015 14:00,589,329,260,13,19
10/10/2015 15:00,570,285,285,13,17
10/10/2015 16:00,602,284,318,12,19
10/10/2015 17:00,491,199,292,11,9
10/10/2015 18:00,516,198,318,9,9
10/10/2015 19:00,493,233,260,8,9
10/10/2015 20:00,373,211,162,8,9
10/10/2015 21:00,271,164,107,7,9
10/10/2015 22:00,228,135,93,7,9
10/10/2015 23:00,208,102,106,6,9
10/11/2015 0:00,216,95,121,5,6
10/11/2015 1:00,152,46,106,4,7
10/11/2015 2:00,148,40,108,4,7
10/11/2015 3:00,109,22,87,4,11
10/11/2015 4:00,82,14,68,3,11
10/11/2015 5:00,51,11,40,3,9
10/11/2015 6:00,40,17,23,3,11
10/11/2015 7:00,26,12,14,2,11
10/11/2015 8:00,63,45,18,3,13
10/11/2015 9:00,159,122,37,4,13
10/11/2015 10:00,215,137,78,6,13
10/11/2015 11:00,247,152,95,8,11
10/11/2015 12:00,271,169,102,9,17
10/11/2015 13:00,407,221,186,10,13
10/11/2015 14:00,539,247,292,10,17
10/11/2015 15:00,478,264,214,10,13
10/11/2015 16:00,423,209,214,10,13
10/11/2015 17:00,437,196,241,9,15
10/11/2015 18:00,458,233,225,7,7
10/11/2015 19:00,341,172,169,7,9
10/11/2015 20:00,289,116,173,6,9
10/11/2015 21:00,139,50,89,6,11
10/11/2015 22:00,196,46,150,5,13
10/11/2015 23:00,109,43,66,5,9
10/12/2015 0:00,50,17,33,5,9
10/12/2015 1:00,29,8,21,4,7
10/12/2015 2:00,13,6,7,4,9
10/12/2015 3:00,5,3,2,3,7
10/12/2015 4:00,13,6,7,3,9
10/12/2015 5:00,41,29,12,2,9
10/12/2015 6:00,127,83,44,2,9
10/12/2015 7:00,474,306,168,2,9
10/12/2015 8:00,783,481,302,3,9
10/12/2015 9:00,916,528,388,4,11
10/12/2015 10:00,652,399,253,6,15
10/12/2015 11:00,586,332,254,7,13
10/12/2015 12:00,733,426,307,8,9
10/12/2015 13:00,813,403,410,8,13
10/12/2015 14:00,853,491,362,9,9
10/12/2015 15:00,935,471,464,9,11
10/12/2015 16:00,995,480,515,8,11
10/12/2015 17:00,1120,561,559,7,9
10/12/2015 18:00,945,484,461,7,7
10/12/2015 19:00,849,516,333,6,6
10/12/2015 20:00,549,305,244,5,9
10/12/2015 21:00,338,164,174,4,9
10/12/2015 22:00,289,118,171,4,7
10/12/2015 23:00,280,88,192,4,7
10/13/2015 0:00,238,73,165,3,7
10/13/2015 1:00,216,67,149,2,6
10/13/2015 2:00,115,22,93,2,7
10/13/2015 3:00,66,10,56,2,11
10/13/2015 4:00,43,6,37,2,11
10/13/2015 5:00,53,39,14,2,11
10/13/2015 6:00,145,101,44,1,11
10/13/2015 7:00,518,286,232,1,13
10/13/2015 8:00,754,406,348,2,11
10/13/2015 9:00,714,426,288,3,17
10/13/2015 10:00,656,414,242,4,17
10/13/2015 11:00,746,451,295,4,13
10/13/2015 12:00,819,471,348,4,15
10/13/2015 13:00,729,422,307,5,19
10/13/2015 14:00,860,470,390,5,19
10/13/2015 15:00,803,423,380,5,13
10/13/2015 16:00,946,472,474,4,19
10/13/2015 17:00,1126,542,584,5,15
10/13/2015 18:00,912,505,407,5,15
10/13/2015 19:00,828,496,332,4,13
10/13/2015 20:00,626,322,304,5,7
10/13/2015 21:00,409,156,253,4,7
10/13/2015 22:00,483,116,367,4,6
10/13/2015 23:00,405,100,305,4,2
10/14/2015 0:00,316,130,186,4,4
10/14/2015 1:00,214,89,125,4,4
10/14/2015 2:00,227,151,76,4,9
10/14/2015 3:00,203,151,52,4,6
10/14/2015 4:00,126,78,48,4,2
10/14/2015 5:00,71,41,30,4,2
10/14/2015 6:00,130,96,34,4,4
10/14/2015 7:00,337,182,155,3,2
10/14/2015 8:00,484,277,207,3,6
10/14/2015 9:00,409,248,161,2,7
10/14/2015 10:00,296,169,127,3,7
10/14/2015 11:00,398,241,157,4,6
10/14/2015 12:00,457,265,192,4,9
10/14/2015 13:00,546,283,263,4,9
10/14/2015 14:00,533,239,294,4,9
10/14/2015 15:00,505,252,253,4,9
10/14/2015 16:00,621,349,272,4,9
10/14/2015 17:00,742,395,347,4,9
10/14/2015 18:00,715,381,334,4,6
10/14/2015 19:00,605,340,265,4,9
10/14/2015 20:00,503,295,208,4,7
10/14/2015 21:00,315,174,141,4,7
10/14/2015 22:00,274,148,126,4,7
10/14/2015 23:00,248,133,115,4,7
10/15/2015 0:00,263,155,108,4,4
10/15/2015 1:00,184,66,118,4,4
10/15/2015 2:00,130,18,112,4,4
10/15/2015 3:00,134,15,119,4,4
10/15/2015 4:00,103,21,82,4,6
10/15/2015 5:00,91,41,50,5,7
10/15/2015 6:00,115,78,37,5,9
10/15/2015 7:00,415,254,161,5,7
10/15/2015 8:00,612,373,239,5,9
10/15/2015 9:00,570,360,210,6,9
10/15/2015 10:00,369,197,172,6,9
10/15/2015 11:00,457,260,197,6,11
10/15/2015 12:00,510,266,244,7,15
10/15/2015 13:00,488,263,225,7,11
10/15/2015 14:00,466,241,225,7,13
10/15/2015 15:00,527,264,263,7,11
10/15/2015 16:00,656,345,311,7,7
10/15/2015 17:00,729,391,338,7,9
10/15/2015 18:00,734,372,362,7,6
10/15/2015 19:00,594,371,223,7,9
10/15/2015 20:00,474,277,197,7,7
10/15/2015 21:00,271,144,127,7,2
10/15/2015 22:00,298,155,143,7,4
10/15/2015 23:00,198,65,133,7,7
10/16/2015 0:00,172,63,109,6,7
10/16/2015 1:00,129,30,99,6,4
10/16/2015 2:00,109,19,90,6,4
10/16/2015 3:00,108,18,90,6,6
10/16/2015 4:00,113,22,91,6,4
10/16/2015 5:00,80,39,41,6,4
10/16/2015 6:00,105,73,32,6,6
10/16/2015 7:00,355,222,133,6,2
10/16/2015 8:00,576,334,242,6,4
10/16/2015 9:00,518,316,202,7,2
10/16/2015 10:00,432,259,173,7,0
10/16/2015 11:00,541,352,189,7,6
10/16/2015 12:00,558,324,234,7,7
10/16/2015 13:00,516,251,265,7,7
10/16/2015 14:00,453,238,215,7,7
10/16/2015 15:00,445,255,190,7,6
10/16/2015 16:00,498,286,212,7,7
10/16/2015 17:00,459,243,216,7,6
10/16/2015 18:00,394,212,182,7,6
10/16/2015 19:00,352,188,164,7,7
10/16/2015 20:00,256,158,98,7,6
10/16/2015 21:00,230,107,123,7,7
10/16/2015 22:00,166,82,84,7,7
10/16/2015 23:00,135,67,68,7,6
10/17/2015 0:00,124,60,64,6,6
10/17/2015 1:00,100,36,64,6,6
10/17/2015 2:00,102,34,68,6,4
10/17/2015 3:00,80,13,67,6,4
10/17/2015 4:00,46,12,34,5,7
10/17/2015 5:00,61,23,38,6,6
10/17/2015 6:00,51,35,16,6,4
10/17/2015 7:00,52,38,14,6,6
10/17/2015 8:00,137,89,48,6,7
10/17/2015 9:00,252,192,60,7,9
10/17/2015 10:00,330,245,85,7,7
10/17/2015 11:00,349,248,101,7,9
10/17/2015 12:00,435,285,150,8,7
10/17/2015 13:00,409,236,173,8,9
10/17/2015 14:00,383,191,192,8,6
10/17/2015 15:00,320,139,181,8,6
10/17/2015 16:00,364,197,167,8,2
10/17/2015 17:00,398,210,188,8,2
10/17/2015 18:00,390,178,212,8,2
10/17/2015 19:00,357,194,163,7,4
10/17/2015 20:00,373,193,180,7,4
10/17/2015 21:00,255,139,116,7,4
10/17/2015 22:00,204,94,110,7,4
10/17/2015 23:00,224,119,105,7,2
10/18/2015 0:00,215,114,101,7,2
10/18/2015 1:00,178,61,117,6,4
10/18/2015 2:00,165,70,95,4,2
10/18/2015 3:00,128,41,87,4,4
10/18/2015 4:00,79,36,43,4,4
10/18/2015 5:00,45,15,30,4,2
10/18/2015 6:00,41,22,19,4,0
10/18/2015 7:00,27,18,9,4,4
10/18/2015 8:00,55,41,14,5,2
10/18/2015 9:00,142,98,44,5,4
10/18/2015 10:00,171,120,51,6,4
10/18/2015 11:00,206,133,73,7,7
10/18/2015 12:00,252,142,110,7,9
10/18/2015 13:00,262,160,102,7,7
10/18/2015 14:00,283,178,105,8,9
10/18/2015 15:00,309,182,127,8,9
10/18/2015 16:00,287,147,140,8,9
10/18/2015 17:00,342,162,180,7,7
10/18/2015 18:00,336,163,173,7,6
10/18/2015 19:00,285,131,154,7,7
10/18/2015 20:00,228,91,137,7,4
10/18/2015 21:00,143,38,105,7,4
10/18/2015 22:00,183,62,121,7,6
10/18/2015 23:00,75,30,45,7,4
10/19/2015 0:00,30,12,18,7,4
10/19/2015 1:00,23,13,10,7,2
10/19/2015 2:00,11,9,2,7,0
10/19/2015 3:00,6,6,0,7,2
10/19/2015 4:00,16,13,3,7,2
10/19/2015 5:00,58,41,17,7,4
10/19/2015 6:00,148,110,38,7,4
10/19/2015 7:00,987,705,282,7,2
10/19/2015 8:00,1019,590,429,7,2
10/19/2015 9:00,1163,690,473,8,4
10/19/2015 10:00,888,531,357,8,6
10/19/2015 11:00,1032,560,472,9,6
10/19/2015 12:00,1067,585,482,9,4
10/19/2015 13:00,1358,690,668,10,6
10/19/2015 14:00,1198,600,598,11,4
10/19/2015 15:00,1531,830,701,11,6
10/19/2015 16:00,1233,692,541,12,6
10/19/2015 17:00,1729,852,877,11,6
10/19/2015 18:00,1207,549,658,10,4
10/19/2015 19:00,1010,564,446,9,0
10/19/2015 20:00,572,272,300,7,2
10/19/2015 21:00,435,180,255,6,2
10/19/2015 22:00,360,114,246,6,2
10/19/2015 23:00,214,72,142,6,2
10/20/2015 0:00,121,48,73,6,2
10/20/2015 1:00,84,24,60,6,4
10/20/2015 2:00,23,10,13,6,4
10/20/2015 3:00,7,3,4,6,2
10/20/2015 4:00,14,13,1,7,4
10/20/2015 5:00,63,43,20,7,4
10/20/2015 6:00,154,112,42,7,4
10/20/2015 7:00,1174,670,504,7,4
10/20/2015 8:00,1256,723,533,7,4
10/20/2015 9:00,1283,676,607,7,7
10/20/2015 10:00,1036,579,457,7,7
10/20/2015 11:00,1316,765,551,8,4
10/20/2015 12:00,1135,696,439,8,2
10/20/2015 13:00,1470,760,710,9,6
10/20/2015 14:00,1156,624,532,10,6
10/20/2015 15:00,1509,849,660,10,11
10/20/2015 16:00,1397,744,653,10,7
10/20/2015 17:00,1547,748,799,9,4
10/20/2015 18:00,1200,608,592,9,2
10/20/2015 19:00,1054,515,539,8,2
10/20/2015 20:00,805,451,354,8,4
10/20/2015 21:00,545,292,253,8,2
10/20/2015 22:00,489,185,304,8,2
10/20/2015 23:00,300,102,198,9,6
10/21/2015 0:00,244,137,107,8,2
10/21/2015 1:00,109,41,68,9,2
10/21/2015 2:00,74,14,60,9,2
10/21/2015 3:00,106,11,95,9,2
10/21/2015 4:00,104,20,84,9,6
10/21/2015 5:00,73,45,28,9,4
10/21/2015 6:00,178,131,47,9,6
10/21/2015 7:00,1026,659,367,9,6
10/21/2015 8:00,1170,693,477,8,6
10/21/2015 9:00,1334,809,525,9,9
10/21/2015 10:00,947,610,337,10,11
10/21/2015 11:00,1336,665,671,10,13
10/21/2015 12:00,1130,658,472,11,17
10/21/2015 13:00,1735,1112,623,11,15
10/21/2015 14:00,1133,618,515,12,15
10/21/2015 15:00,1449,607,842,12,20
10/21/2015 16:00,1309,660,649,12,13
10/21/2015 17:00,1599,769,830,12,11
10/21/2015 18:00,1260,614,646,11,9
10/21/2015 19:00,1180,645,535,11,11
10/21/2015 20:00,735,417,318,11,9
10/21/2015 21:00,543,270,273,11,11
10/21/2015 22:00,615,355,260,11,17
10/21/2015 23:00,461,227,234,11,19
10/22/2015 0:00,454,259,195,10,13
10/22/2015 1:00,298,78,220,10,17
10/22/2015 2:00,242,39,203,10,15
10/22/2015 3:00,212,18,194,10,13
10/22/2015 4:00,119,26,93,10,15
10/22/2015 5:00,99,49,50,10,15
10/22/2015 6:00,177,118,59,10,15
10/22/2015 7:00,994,554,440,10,17
10/22/2015 8:00,999,559,440,10,15
10/22/2015 9:00,1077,672,405,10,13
10/22/2015 10:00,893,574,319,11,15
10/22/2015 11:00,1225,636,589,11,15
10/22/2015 12:00,940,502,438,12,15
10/22/2015 13:00,1202,640,562,12,15
10/22/2015 14:00,1032,542,490,12,15
10/22/2015 15:00,1293,650,643,13,17
10/22/2015 16:00,1144,572,572,13,13
10/22/2015 17:00,1165,595,570,13,15
10/22/2015 18:00,886,451,435,12,17
10/22/2015 19:00,786,390,396,12,11
10/22/2015 20:00,506,229,277,12,17
10/22/2015 21:00,368,165,203,11,11
10/22/2015 22:00,332,147,185,11,13
10/22/2015 23:00,223,65,158,11,9
10/23/2015 0:00,134,36,98,10,9
10/23/2015 1:00,113,41,72,10,9
10/23/2015 2:00,64,21,43,8,9
10/23/2015 3:00,39,13,26,6,7
10/23/2015 4:00,25,9,16,6,6
10/23/2015 5:00,42,31,11,6,2
10/23/2015 6:00,147,105,42,7,2
10/23/2015 7:00,1033,638,395,7,4
10/23/2015 8:00,946,534,412,7,2
10/23/2015 9:00,1110,652,458,8,4
10/23/2015 10:00,975,648,327,11,6
10/23/2015 11:00,927,482,445,13,13
10/23/2015 12:00,1020,576,444,14,17
10/23/2015 13:00,1215,589,626,14,20
10/23/2015 14:00,1013,535,478,15,17
10/23/2015 15:00,940,501,439,14,9
10/23/2015 16:00,972,483,489,14,6
10/23/2015 17:00,938,494,444,11,4
10/23/2015 18:00,862,437,425,9,4
10/23/2015 19:00,764,392,372,8,2
10/23/2015 20:00,601,339,262,8,2
10/23/2015 21:00,426,205,221,10,7
10/23/2015 22:00,401,182,219,10,6
10/23/2015 23:00,394,154,240,10,7
10/24/2015 0:00,299,108,191,10,6
10/24/2015 1:00,315,111,204,10,6
10/24/2015 2:00,255,64,191,9,6
10/24/2015 3:00,148,61,87,9,6
10/24/2015 4:00,106,37,69,9,6
10/24/2015 5:00,104,44,60,9,7
10/24/2015 6:00,51,38,13,9,9
10/24/2015 7:00,108,76,32,9,7
10/24/2015 8:00,242,141,101,9,7
10/24/2015 9:00,363,278,85,10,7
10/24/2015 10:00,457,319,138,11,11
10/24/2015 11:00,584,369,215,12,11
10/24/2015 12:00,690,413,277,12,11
10/24/2015 13:00,738,441,297,13,13
10/24/2015 14:00,767,393,374,13,13
10/24/2015 15:00,716,393,323,13,9
10/24/2015 16:00,661,381,280,13,7
10/24/2015 17:00,697,337,360,12,7
10/24/2015 18:00,668,329,339,11,7
10/24/2015 19:00,675,370,305,10,7
10/24/2015 20:00,545,283,262,10,7
10/24/2015 21:00,411,240,171,9,6
10/24/2015 22:00,350,152,198,10,6
10/24/2015 23:00,293,134,159,10,6
10/25/2015 0:00,302,123,179,10,6
10/25/2015 1:00,232,88,144,9,6
10/25/2015 2:00,338,95,243,10,6
10/25/2015 3:00,89,13,76,10,6
10/25/2015 4:00,65,5,60,10,4
10/25/2015 5:00,45,17,28,10,2
10/25/2015 6:00,37,21,16,10,6
10/25/2015 7:00,51,31,20,10,7
10/25/2015 8:00,81,50,31,11,7
10/25/2015 9:00,169,125,44,11,6
10/25/2015 10:00,299,202,97,12,7
10/25/2015 11:00,320,189,131,13,7
10/25/2015 12:00,427,260,167,14,11
10/25/2015 13:00,584,337,247,13,11
10/25/2015 14:00,655,392,263,14,6
10/25/2015 15:00,809,464,345,13,7
10/25/2015 16:00,790,417,373,11,4
10/25/2015 17:00,744,338,406,9,0
10/25/2015 18:00,577,337,240,7,2
10/25/2015 19:00,523,226,297,6,0
10/25/2015 20:00,291,122,169,6,4
10/25/2015 21:00,267,75,192,5,2
10/25/2015 22:00,241,75,166,6,6
10/25/2015 23:00,96,35,61,,
10/26/2015 0:00,39,13,26,7,2
10/26/2015 1:00,8,0,8,7,6
10/26/2015 2:00,7,4,3,8,6
10/26/2015 3:00,5,3,2,6,2
10/26/2015 4:00,18,12,6,6,4
10/26/2015 5:00,49,40,9,8,6
10/26/2015 6:00,179,130,49,8,7
10/26/2015 7:00,1123,711,412,8,9
10/26/2015 8:00,1200,741,459,9,7
10/26/2015 9:00,1324,774,550,10,6
10/26/2015 10:00,1035,646,389,11,11
10/26/2015 11:00,1354,627,727,13,11
10/26/2015 12:00,1361,704,657,13,11
10/26/2015 13:00,1815,950,865,13,9
10/26/2015 14:00,1327,718,609,13,7
10/26/2015 15:00,1761,939,822,13,11
10/26/2015 16:00,1606,895,711,13,9
10/26/2015 17:00,1985,981,1004,12,7
10/26/2015 18:00,1551,865,686,11,7
10/26/2015 19:00,1403,746,657,11,7
10/26/2015 20:00,763,393,370,10,7
10/26/2015 21:00,642,299,343,10,9
10/26/2015 22:00,437,169,268,9,9
10/26/2015 23:00,277,79,198,9,7
10/27/2015 0:00,201,40,161,9,7
10/27/2015 1:00,140,13,127,8,4
10/27/2015 2:00,73,3,70,8,6
10/27/2015 3:00,25,5,20,8,6
10/27/2015 4:00,29,16,13,8,6
10/27/2015 5:00,49,39,10,8,6
10/27/2015 6:00,170,123,47,7,4
10/27/2015 7:00,1239,678,561,7,6
10/27/2015 8:00,1552,937,615,9,7
10/27/2015 9:00,1549,801,748,10,7
10/27/2015 10:00,1226,770,456,12,7
10/27/2015 11:00,1461,760,701,13,7
10/27/2015 12:00,1343,742,601,15,9
10/27/2015 13:00,1711,883,828,15,7
10/27/2015 14:00,1393,725,668,15,7
10/27/2015 15:00,1910,1013,897,15,6
10/27/2015 16:00,1599,873,726,14,6
10/27/2015 17:00,1970,982,988,11,6
10/27/2015 18:00,1463,740,723,10,6
10/27/2015 19:00,1418,733,685,10,4
10/27/2015 20:00,895,442,453,9,4
10/27/2015 21:00,642,299,343,10,7
10/27/2015 22:00,574,223,351,9,4
10/27/2015 23:00,338,115,223,8,4
10/28/2015 0:00,185,78,107,8,4
10/28/2015 1:00,92,17,75,8,4
10/28/2015 2:00,64,18,46,6,2
10/28/2015 3:00,65,8,57,5,4
10/28/2015 4:00,25,14,11,6,2
10/28/2015 5:00,49,39,10,7,4
10/28/2015 6:00,196,148,48,7,9
10/28/2015 7:00,1258,791,467,7,6
10/28/2015 8:00,1375,808,567,8,4
10/28/2015 9:00,1456,804,652,9,7
10/28/2015 10:00,1229,749,480,10,7
10/28/2015 11:00,1382,722,660,12,6
10/28/2015 12:00,1309,802,507,13,7
10/28/2015 13:00,1612,911,701,13,9
10/28/2015 14:00,1338,769,569,13,7
10/28/2015 15:00,1517,761,756,13,4
10/28/2015 16:00,1466,771,695,12,4
10/28/2015 17:00,1803,891,912,12,4
10/28/2015 18:00,1513,878,635,11,6
10/28/2015 19:00,1586,943,643,10,4
10/28/2015 20:00,985,517,468,10,4
10/28/2015 21:00,742,319,423,9,4
10/28/2015 22:00,698,247,451,9,4
10/28/2015 23:00,433,157,276,8,6
10/29/2015 0:00,263,92,171,8,4
10/29/2015 1:00,157,56,101,9,6
10/29/2015 2:00,96,18,78,9,4
10/29/2015 3:00,62,20,42,9,2
10/29/2015 4:00,51,19,32,10,4
10/29/2015 5:00,73,46,27,10,4
10/29/2015 6:00,154,115,39,10,6
10/29/2015 7:00,1082,611,471,10,4
10/29/2015 8:00,1361,760,601,11,4
10/29/2015 9:00,1321,699,622,12,7
10/29/2015 10:00,1164,736,428,13,9
10/29/2015 11:00,1397,680,717,13,13
10/29/2015 12:00,1222,695,527,14,9
10/29/2015 13:00,1414,748,666,14,11
10/29/2015 14:00,1171,631,540,14,9
10/29/2015 15:00,1571,825,746,15,2
10/29/2015 16:00,1520,815,705,12,4
10/29/2015 17:00,1709,947,762,12,2
10/29/2015 18:00,1298,705,593,12,4
10/29/2015 19:00,1259,546,713,12,6
10/29/2015 20:00,732,365,367,9,2
10/29/2015 21:00,661,357,304,8,2
10/29/2015 22:00,526,215,311,8,2
10/29/2015 23:00,423,201,222,8,6
10/30/2015 0:00,290,178,112,7,2
10/30/2015 1:00,145,43,102,8,4
10/30/2015 2:00,119,11,108,8,6
10/30/2015 3:00,95,12,83,7,4
10/30/2015 4:00,60,12,48,6,2
10/30/2015 5:00,58,38,20,5,2
10/30/2015 6:00,161,117,44,4,2
10/30/2015 7:00,1076,605,471,5,6
10/30/2015 8:00,1100,578,522,8,11
10/30/2015 9:00,1131,668,463,9,7
10/30/2015 10:00,1008,662,346,10,6
10/30/2015 11:00,1193,611,582,11,6
10/30/2015 12:00,1075,628,447,13,6
10/30/2015 13:00,1285,693,592,14,7
10/30/2015 14:00,1152,627,525,15,6
10/30/2015 15:00,1236,668,568,14,4
10/30/2015 16:00,1090,607,483,13,6
10/30/2015 17:00,1092,582,510,12,6
10/30/2015 18:00,997,512,485,11,7
10/30/2015 19:00,954,577,377,10,4
10/30/2015 20:00,939,628,311,10,6
10/30/2015 21:00,725,275,450,10,9
10/30/2015 22:00,475,183,292,10,4
10/30/2015 23:00,434,140,294,10,6
10/31/2015 0:00,298,109,189,9,7
10/31/2015 1:00,229,74,155,9,9
10/31/2015 2:00,176,50,126,9,11
10/31/2015 3:00,111,26,85,9,9
10/31/2015 4:00,81,22,59,9,9
10/31/2015 5:00,52,25,27,9,7
10/31/2015 6:00,53,32,21,8,6
10/31/2015 7:00,125,94,31,8,7
10/31/2015 8:00,214,145,69,9,9
10/31/2015 9:00,402,278,124,10,11
10/31/2015 10:00,477,360,117,12,13
10/31/2015 11:00,631,439,192,13,13
10/31/2015 12:00,850,599,251,14,11
10/31/2015 13:00,832,484,348,15,7
10/31/2015 14:00,802,443,359,15,9
10/31/2015 15:00,787,397,390,15,6
10/31/2015 16:00,788,339,449,14,4
10/31/2015 17:00,802,354,448,13,7
10/31/2015 18:00,657,301,356,12,7
10/31/2015 19:00,590,295,295,11,9
10/31/2015 20:00,645,330,315,9,6
10/31/2015 21:00,552,281,271,7,0
10/31/2015 22:00,357,169,188,5,0
10/31/2015 23:00,340,180,160,5,2
11/1/2015 0:00,356,195,161,4,2
11/1/2015 1:00,291,145,146,4,2
11/1/2015 2:00,288,118,170,4,2
11/1/2015 3:00,266,93,173,3,0
11/1/2015 4:00,141,41,100,3,2
11/1/2015 5:00,103,18,85,3,2
11/1/2015 6:00,65,20,45,2,2
11/1/2015 7:00,52,28,24,3,7
11/1/2015 8:00,63,38,25,5,9
11/1/2015 9:00,146,94,52,8,4
11/1/2015 10:00,250,165,85,10,7
11/1/2015 11:00,296,180,116,12,6
11/1/2015 12:00,368,223,145,13,2
11/1/2015 13:00,579,334,245,14,4
11/1/2015 14:00,626,382,244,15,4
11/1/2015 15:00,652,363,289,14,4
11/1/2015 16:00,573,271,302,12,4
11/1/2015 17:00,628,365,263,9,2
11/1/2015 18:00,615,335,280,7,2
11/1/2015 19:00,502,230,272,6,4
11/1/2015 20:00,375,138,237,5,0
11/1/2015 21:00,240,98,142,4,2
11/1/2015 22:00,219,70,149,4,4
11/1/2015 23:00,110,38,72,3,2
11/2/2015 0:00,56,19,37,2,2
11/2/2015 1:00,27,9,18,2,0
11/2/2015 2:00,11,3,8,2,4
11/2/2015 3:00,7,5,2,2,0
11/2/2015 4:00,12,7,5,2,0
11/2/2015 5:00,45,35,10,2,2
11/2/2015 6:00,156,113,43,2,2
11/2/2015 7:00,962,596,366,2,2
11/2/2015 8:00,1251,729,522,2,0
11/2/2015 9:00,1233,618,615,4,6
11/2/2015 10:00,995,627,368,6,2
11/2/2015 11:00,1233,515,718,8,4
11/2/2015 12:00,1025,582,443,11,2
11/2/2015 13:00,1499,769,730,13,4
11/2/2015 14:00,1121,628,493,14,4
11/2/2015 15:00,1666,902,764,14,2
11/2/2015 16:00,1546,912,634,12,2
11/2/2015 17:00,1924,975,949,8,4
11/2/2015 18:00,1496,762,734,6,2
11/2/2015 19:00,1220,625,595,4,0
11/2/2015 20:00,673,319,354,4,2
11/2/2015 21:00,563,224,339,2,4
11/2/2015 22:00,450,149,301,2,2
11/2/2015 23:00,220,92,128,2,2
11/3/2015 0:00,92,27,65,1,2
11/3/2015 1:00,34,14,20,0,2
11/3/2015 2:00,13,6,7,1,4
11/3/2015 3:00,12,3,9,0,2
11/3/2015 4:00,15,10,5,1,2
11/3/2015 5:00,53,44,9,2,4
11/3/2015 6:00,180,131,49,1,2
11/3/2015 7:00,1189,628,561,1,2
11/3/2015 8:00,1574,928,646,2,0
11/3/2015 9:00,1422,699,723,5,4
11/3/2015 10:00,1161,688,473,8,4
11/3/2015 11:00,1277,621,656,11,6
11/3/2015 12:00,1264,734,530,13,6
11/3/2015 13:00,1652,906,746,14,6
11/3/2015 14:00,1346,673,673,15,4
11/3/2015 15:00,1706,892,814,13,4
11/3/2015 16:00,1567,869,698,10,2
11/3/2015 17:00,1785,902,883,7,2
11/3/2015 18:00,1351,725,626,6,2
11/3/2015 19:00,1187,658,529,5,2
11/3/2015 20:00,766,384,382,4,2
11/3/2015 21:00,604,226,378,4,2
11/3/2015 22:00,480,165,315,5,2
11/3/2015 23:00,250,71,179,5,2
11/4/2015 0:00,127,47,80,6,6
11/4/2015 1:00,65,33,32,6,6
11/4/2015 2:00,16,5,11,7,4
11/4/2015 3:00,11,8,3,6,7
11/4/2015 4:00,21,15,6,4,4
11/4/2015 5:00,60,43,17,4,6
11/4/2015 6:00,187,148,39,5,6
11/4/2015 7:00,1191,698,493,5,7
11/4/2015 8:00,1488,857,631,7,6
11/4/2015 9:00,1390,709,681,10,7
11/4/2015 10:00,1187,757,430,12,9
11/4/2015 11:00,1286,700,586,15,11
11/4/2015 12:00,1317,793,524,15,9
11/4/2015 13:00,1479,752,727,16,7
11/4/2015 14:00,1287,695,592,17,13
11/4/2015 15:00,1523,770,753,16,9
11/4/2015 16:00,1357,760,597,14,4
11/4/2015 17:00,1783,943,840,12,6
11/4/2015 18:00,1336,715,621,12,7
11/4/2015 19:00,1349,749,600,13,9
11/4/2015 20:00,988,525,463,13,9
11/4/2015 21:00,660,317,343,13,7
11/4/2015 22:00,559,288,271,13,9
11/4/2015 23:00,420,252,168,13,9
11/5/2015 0:00,436,262,174,13,7
11/5/2015 1:00,181,42,139,12,6
11/5/2015 2:00,192,15,177,12,6
11/5/2015 3:00,185,14,171,12,7
11/5/2015 4:00,132,19,113,12,7
11/5/2015 5:00,123,40,83,11,4
11/5/2015 6:00,205,146,59,11,6
11/5/2015 7:00,998,583,415,9,4
11/5/2015 8:00,1278,739,539,11,6
11/5/2015 9:00,1297,751,546,13,7
11/5/2015 10:00,1109,657,452,14,11
11/5/2015 11:00,1477,781,696,15,11
11/5/2015 12:00,1302,701,601,15,13
11/5/2015 13:00,1388,689,699,16,11
11/5/2015 14:00,1167,609,558,16,9
11/5/2015 15:00,1408,738,670,16,6
11/5/2015 16:00,1385,713,672,15,6
11/5/2015 17:00,1385,747,638,14,7
11/5/2015 18:00,1234,665,569,14,11
11/5/2015 19:00,1071,477,594,14,9
11/5/2015 20:00,675,284,391,14,9
11/5/2015 21:00,507,256,251,14,7
11/5/2015 22:00,482,185,297,13,9
11/5/2015 23:00,292,103,189,13,6
11/6/2015 0:00,156,38,118,13,4
11/6/2015 1:00,101,31,70,13,7
11/6/2015 2:00,56,13,43,13,11
11/6/2015 3:00,14,3,11,13,13
11/6/2015 4:00,22,12,10,14,11
11/6/2015 5:00,45,30,15,14,11
11/6/2015 6:00,142,100,42,14,15
11/6/2015 7:00,869,498,371,14,13
11/6/2015 8:00,1073,576,497,14,15
11/6/2015 9:00,884,497,387,14,13
11/6/2015 10:00,817,521,296,14,13
11/6/2015 11:00,939,457,482,15,13
11/6/2015 12:00,991,561,430,15,13
11/6/2015 13:00,1130,612,518,16,11
11/6/2015 14:00,1000,539,461,16,9
11/6/2015 15:00,990,559,431,16,9
11/6/2015 16:00,821,455,366,16,6
11/6/2015 17:00,873,462,411,15,7
11/6/2015 18:00,758,354,404,15,9
11/6/2015 19:00,698,354,344,15,11
11/6/2015 20:00,503,272,231,15,17
11/6/2015 21:00,387,212,175,15,17
11/6/2015 22:00,297,130,167,15,15
11/6/2015 23:00,264,117,147,15,15
11/7/2015 0:00,241,98,143,16,17
11/7/2015 1:00,213,77,136,16,17
11/7/2015 2:00,172,40,132,16,17
11/7/2015 3:00,104,18,86,16,13
11/7/2015 4:00,61,17,44,16,15
11/7/2015 5:00,61,22,39,16,13
11/7/2015 6:00,52,29,23,16,15
11/7/2015 7:00,150,119,31,16,11
11/7/2015 8:00,285,178,107,15,13
11/7/2015 9:00,380,277,103,16,11
11/7/2015 10:00,500,345,155,17,13
11/7/2015 11:00,540,371,169,17,13
11/7/2015 12:00,616,356,260,18,15
11/7/2015 13:00,597,340,257,18,13
11/7/2015 14:00,643,295,348,18,13
11/7/2015 15:00,512,251,261,18,17
11/7/2015 16:00,584,278,306,18,15
11/7/2015 17:00,537,238,299,18,19
11/7/2015 18:00,539,242,297,18,20
11/7/2015 19:00,458,236,222,18,20
11/7/2015 20:00,422,226,196,19,24
11/7/2015 21:00,247,126,121,17,39
11/7/2015 22:00,274,111,163,16,35
11/7/2015 23:00,277,105,172,16,28
11/8/2015 0:00,268,119,149,15,28
11/8/2015 1:00,214,62,152,14,26
11/8/2015 2:00,160,52,108,14,20
11/8/2015 3:00,121,34,87,14,20
11/8/2015 4:00,97,30,67,13,11
11/8/2015 5:00,64,18,46,13,13
11/8/2015 6:00,33,18,15,13,9
11/8/2015 7:00,49,32,17,11,2
11/8/2015 8:00,76,45,31,11,7
11/8/2015 9:00,198,133,65,12,9
11/8/2015 10:00,344,255,89,13,15
11/8/2015 11:00,263,142,121,13,11
11/8/2015 12:00,402,204,198,14,17
11/8/2015 13:00,418,233,185,15,13
11/8/2015 14:00,509,292,217,15,11
11/8/2015 15:00,552,306,246,14,9
11/8/2015 16:00,474,259,215,13,9
11/8/2015 17:00,506,199,307,13,9
11/8/2015 18:00,465,217,248,13,9
11/8/2015 19:00,516,247,269,13,9
11/8/2015 20:00,283,104,179,13,9
11/8/2015 21:00,202,62,140,13,11
11/8/2015 22:00,301,129,172,13,7
11/8/2015 23:00,184,47,137,15,9
11/9/2015 0:00,73,14,59,17,20
11/9/2015 1:00,18,10,8,17,22
11/9/2015 2:00,6,3,3,16,22
11/9/2015 3:00,7,4,3,16,22
11/9/2015 4:00,10,5,5,16,24
11/9/2015 5:00,58,39,19,15,26
11/9/2015 6:00,165,119,46,14,19
11/9/2015 7:00,880,531,349,15,26
11/9/2015 8:00,1221,694,527,15,22
11/9/2015 9:00,1086,595,491,14,30
11/9/2015 10:00,981,600,381,15,33
11/9/2015 11:00,1130,491,639,15,28
11/9/2015 12:00,995,478,517,14,30
11/9/2015 13:00,1283,654,629,14,37
11/9/2015 14:00,1096,572,524,13,33
11/9/2015 15:00,1447,740,707,13,28
11/9/2015 16:00,1332,735,597,13,28
11/9/2015 17:00,1644,802,842,13,22
11/9/2015 18:00,1337,644,693,13,24
11/9/2015 19:00,1080,521,559,13,32
11/9/2015 20:00,647,305,342,13,28
11/9/2015 21:00,453,182,271,13,28
11/9/2015 22:00,357,143,214,13,32
11/9/2015 23:00,247,81,166,13,32
11/10/2015 0:00,103,17,86,13,28
11/10/2015 1:00,40,19,21,14,30
11/10/2015 2:00,16,7,9,14,30
11/10/2015 3:00,10,6,4,14,35
11/10/2015 4:00,12,8,4,14,32
11/10/2015 5:00,50,31,19,14,26
11/10/2015 6:00,147,107,40,14,30
11/10/2015 7:00,979,554,425,14,32
11/10/2015 8:00,1483,888,595,13,28
11/10/2015 9:00,1237,584,653,13,22
11/10/2015 10:00,987,591,396,13,22
11/10/2015 11:00,1105,496,609,13,24
11/10/2015 12:00,1079,570,509,13,26
11/10/2015 13:00,1251,598,653,13,22
11/10/2015 14:00,1017,526,491,13,24
11/10/2015 15:00,1360,652,708,13,22
11/10/2015 16:00,1260,689,571,13,20
11/10/2015 17:00,1533,818,715,14,24
11/10/2015 18:00,1250,658,592,14,22
11/10/2015 19:00,1128,571,557,14,24
11/10/2015 20:00,673,333,340,14,22
11/10/2015 21:00,527,226,301,14,20
11/10/2015 22:00,363,121,242,14,22
11/10/2015 23:00,281,74,207,14,24
11/11/2015 0:00,148,48,100,14,32
11/11/2015 1:00,77,40,37,14,24
11/11/2015 2:00,57,49,8,13,24
11/11/2015 3:00,34,31,3,13,20
11/11/2015 4:00,28,21,7,13,17
11/11/2015 5:00,57,41,16,13,22
11/11/2015 6:00,186,136,50,12,20
11/11/2015 7:00,968,568,400,12,19
11/11/2015 8:00,1314,749,565,12,17
11/11/2015 9:00,1191,630,561,12,22
11/11/2015 10:00,994,645,349,13,20
11/11/2015 11:00,1127,564,563,13,20
11/11/2015 12:00,1159,644,515,13,20
11/11/2015 13:00,1228,625,603,13,15
11/11/2015 14:00,1076,572,504,13,17
11/11/2015 15:00,1321,651,670,13,17
11/11/2015 16:00,1232,658,574,12,15
11/11/2015 17:00,1469,749,720,12,17
11/11/2015 18:00,1327,734,593,12,17
11/11/2015 19:00,1151,577,574,12,17
11/11/2015 20:00,756,313,443,12,20
11/11/2015 21:00,642,267,375,12,22
11/11/2015 22:00,475,170,305,12,20
11/11/2015 23:00,340,115,225,12,20
11/12/2015 0:00,243,97,146,12,17
11/12/2015 1:00,139,36,103,12,19
11/12/2015 2:00,80,15,65,12,15
11/12/2015 3:00,57,8,49,13,17
11/12/2015 4:00,34,13,21,13,17
11/12/2015 5:00,75,38,37,13,19
11/12/2015 6:00,169,113,56,13,19
11/12/2015 7:00,957,555,402,12,17
11/12/2015 8:00,1205,641,564,13,19
11/12/2015 9:00,1135,610,525,13,15
11/12/2015 10:00,1027,611,416,13,17
11/12/2015 11:00,1325,648,677,14,19
11/12/2015 12:00,1114,596,518,14,17
11/12/2015 13:00,1290,655,635,14,15
11/12/2015 14:00,1158,600,558,14,15
11/12/2015 15:00,1293,683,610,14,11
11/12/2015 16:00,1349,716,633,13,7
11/12/2015 17:00,1511,799,712,12,6
11/12/2015 18:00,1268,663,605,13,9
11/12/2015 19:00,1216,581,635,12,7
11/12/2015 20:00,776,353,423,13,9
11/12/2015 21:00,637,361,276,13,7
11/12/2015 22:00,525,218,307,13,9
11/12/2015 23:00,363,174,189,13,13
11/13/2015 0:00,242,103,139,13,15
11/13/2015 1:00,117,33,84,13,11
11/13/2015 2:00,125,14,111,13,11
11/13/2015 3:00,125,10,115,13,13
11/13/2015 4:00,104,16,88,13,15
11/13/2015 5:00,101,40,61,14,19
11/13/2015 6:00,141,90,51,13,19
11/13/2015 7:00,867,495,372,13,22
11/13/2015 8:00,1051,587,464,14,19
11/13/2015 9:00,863,477,386,13,22
11/13/2015 10:00,834,517,317,14,30
11/13/2015 11:00,1000,492,508,14,33
11/13/2015 12:00,940,520,420,14,28
11/13/2015 13:00,1109,586,523,14,37
11/13/2015 14:00,890,465,425,14,35
11/13/2015 15:00,1022,557,465,13,22
11/13/2015 16:00,871,455,416,12,15
11/13/2015 17:00,848,415,433,12,19
11/13/2015 18:00,590,265,325,9,22
11/13/2015 19:00,564,290,274,9,30
11/13/2015 20:00,489,259,230,8,24
11/13/2015 21:00,352,192,160,8,24
11/13/2015 22:00,272,127,145,8,20
11/13/2015 23:00,239,113,126,6,24
11/14/2015 0:00,270,122,148,7,24
11/14/2015 1:00,196,87,109,7,19
11/14/2015 2:00,135,47,88,7,24
11/14/2015 3:00,121,23,98,7,26
11/14/2015 4:00,61,24,37,7,24
11/14/2015 5:00,56,16,40,7,30
11/14/2015 6:00,46,28,18,7,28
11/14/2015 7:00,135,111,24,7,22
11/14/2015 8:00,216,155,61,7,22
11/14/2015 9:00,335,262,73,8,24
11/14/2015 10:00,434,325,109,9,24
11/14/2015 11:00,466,291,175,9,28
11/14/2015 12:00,540,336,204,10,30
11/14/2015 13:00,614,304,310,9,22
11/14/2015 14:00,561,283,278,9,28
11/14/2015 15:00,628,326,302,9,24
11/14/2015 16:00,528,266,262,9,20
11/14/2015 17:00,502,252,250,9,20
11/14/2015 18:00,401,173,228,8,20
11/14/2015 19:00,339,166,173,7,13
11/14/2015 20:00,282,149,133,8,15
11/14/2015 21:00,299,156,143,8,15
11/14/2015 22:00,228,87,141,9,20
11/14/2015 23:00,173,59,114,8,19
11/15/2015 0:00,238,86,152,9,24
11/15/2015 1:00,154,67,87,10,26
11/15/2015 2:00,167,64,103,11,35
11/15/2015 3:00,114,38,76,12,28
11/15/2015 4:00,76,23,53,11,32
11/15/2015 5:00,49,23,26,12,33
11/15/2015 6:00,43,27,16,12,33
11/15/2015 7:00,31,23,8,13,32
11/15/2015 8:00,46,28,18,13,41
11/15/2015 9:00,106,76,30,14,44
11/15/2015 10:00,193,128,65,14,43
11/15/2015 11:00,153,88,65,14,39
11/15/2015 12:00,152,70,82,13,43
11/15/2015 13:00,191,106,85,13,43
11/15/2015 14:00,190,89,101,13,39
11/15/2015 15:00,202,113,89,13,39
11/15/2015 16:00,219,114,105,13,39
11/15/2015 17:00,244,115,129,13,32
11/15/2015 18:00,245,121,124,13,30
11/15/2015 19:00,211,84,127,13,30
11/15/2015 20:00,149,45,104,13,32
11/15/2015 21:00,101,39,62,13,32
11/15/2015 22:00,115,48,67,13,28
11/15/2015 23:00,91,23,68,13,17
11/16/2015 0:00,40,10,30,13,20
11/16/2015 1:00,17,8,9,13,22
11/16/2015 2:00,7,3,4,13,22
11/16/2015 3:00,5,3,2,13,19
11/16/2015 4:00,10,7,3,12,19
11/16/2015 5:00,41,27,14,12,20
11/16/2015 6:00,150,109,41,13,24
11/16/2015 7:00,800,502,298,12,22
11/16/2015 8:00,1096,642,454,12,22
11/16/2015 9:00,1024,589,435,12,28
11/16/2015 10:00,985,604,381,12,24
11/16/2015 11:00,1032,445,587,12,28
11/16/2015 12:00,988,517,471,12,24
11/16/2015 13:00,1334,664,670,12,24
11/16/2015 14:00,982,515,467,13,20
11/16/2015 15:00,1421,769,652,13,22
11/16/2015 16:00,1225,658,567,12,20
11/16/2015 17:00,1561,716,845,12,20
11/16/2015 18:00,1147,586,561,12,19
11/16/2015 19:00,928,445,483,12,17
11/16/2015 20:00,511,209,302,12,22
11/16/2015 21:00,421,172,249,12,20
11/16/2015 22:00,307,148,159,12,17
11/16/2015 23:00,204,57,147,12,17
11/17/2015 0:00,113,35,78,12,17
11/17/2015 1:00,51,17,34,12,20
11/17/2015 2:00,16,3,13,12,17
11/17/2015 3:00,15,6,9,12,17
11/17/2015 4:00,12,7,5,12,13
11/17/2015 5:00,45,29,16,12,15
11/17/2015 6:00,148,105,43,12,13
11/17/2015 7:00,718,363,355,12,13
11/17/2015 8:00,1224,732,492,12,11
11/17/2015 9:00,912,433,479,13,17
11/17/2015 10:00,785,461,324,14,24
11/17/2015 11:00,904,418,486,14,28
11/17/2015 12:00,932,523,409,14,30
11/17/2015 13:00,1157,587,570,14,24
11/17/2015 14:00,977,533,444,14,28
11/17/2015 15:00,1232,563,669,14,26
11/17/2015 16:00,1224,718,506,14,22
11/17/2015 17:00,1330,650,680,14,28
11/17/2015 18:00,1108,595,513,14,22
11/17/2015 19:00,941,455,486,14,26
11/17/2015 20:00,609,296,313,14,30
11/17/2015 21:00,437,195,242,16,39
11/17/2015 22:00,443,165,278,16,48
11/17/2015 23:00,209,58,151,15,59
11/18/2015 0:00,105,26,79,15,39
11/18/2015 1:00,54,10,44,12,54
11/18/2015 2:00,19,4,15,12,44
11/18/2015 3:00,10,9,1,12,54
11/18/2015 4:00,15,8,7,12,48
11/18/2015 5:00,34,23,11,11,50
11/18/2015 6:00,129,93,36,11,50
11/18/2015 7:00,796,462,334,10,30
11/18/2015 8:00,1161,645,516,10,32
11/18/2015 9:00,1144,604,540,11,39
11/18/2015 10:00,959,600,359,12,33
11/18/2015 11:00,1076,529,547,12,28
11/18/2015 12:00,1056,577,479,13,32
11/18/2015 13:00,1171,628,543,13,22
11/18/2015 14:00,1004,563,441,13,24
11/18/2015 15:00,1153,577,576,13,20
11/18/2015 16:00,1174,622,552,13,26
11/18/2015 17:00,1435,737,698,13,33
11/18/2015 18:00,1186,597,589,13,32
11/18/2015 19:00,1133,565,568,13,33
11/18/2015 20:00,726,379,347,13,35
11/18/2015 21:00,605,288,317,13,35
11/18/2015 22:00,482,226,256,13,41
11/18/2015 23:00,391,197,194,13,35
11/19/2015 0:00,341,168,173,13,37
11/19/2015 1:00,177,63,114,13,33
11/19/2015 2:00,115,34,81,13,39
11/19/2015 3:00,146,42,104,12,32
11/19/2015 4:00,143,43,100,13,39
11/19/2015 5:00,118,34,84,12,37
11/19/2015 6:00,160,114,46,12,41
11/19/2015 7:00,758,451,307,12,39
11/19/2015 8:00,1046,586,460,12,35
11/19/2015 9:00,985,554,431,12,37
11/19/2015 10:00,913,539,374,13,41
11/19/2015 11:00,1088,538,550,12,39
11/19/2015 12:00,1042,606,436,13,37
11/19/2015 13:00,1164,555,609,12,37
11/19/2015 14:00,1004,513,491,12,30
11/19/2015 15:00,1267,715,552,12,30
11/19/2015 16:00,1024,542,482,11,22
11/19/2015 17:00,1098,580,518,9,28
11/19/2015 18:00,883,466,417,8,17
11/19/2015 19:00,685,324,361,8,17
11/19/2015 20:00,550,283,267,8,15
11/19/2015 21:00,360,170,190,8,17
11/19/2015 22:00,336,163,173,8,20
11/19/2015 23:00,225,89,136,8,22
11/20/2015 0:00,116,38,78,9,20
11/20/2015 1:00,74,20,54,9,20
11/20/2015 2:00,41,16,25,8,17
11/20/2015 3:00,35,9,26,9,19
11/20/2015 4:00,20,11,9,9,22
11/20/2015 5:00,51,29,22,8,19
11/20/2015 6:00,148,103,45,8,20
11/20/2015 7:00,730,473,257,8,19
11/20/2015 8:00,992,586,406,8,17
11/20/2015 9:00,906,531,375,8,22
11/20/2015 10:00,860,555,305,8,20
11/20/2015 11:00,1006,524,482,8,22
11/20/2015 12:00,936,555,381,8,24
11/20/2015 13:00,1059,553,506,8,20
11/20/2015 14:00,903,470,433,8,20
11/20/2015 15:00,856,476,380,7,15
11/20/2015 16:00,846,473,373,6,13
11/20/2015 17:00,864,427,437,7,15
11/20/2015 18:00,770,399,371,6,19
11/20/2015 19:00,623,322,301,6,17
11/20/2015 20:00,512,256,256,6,15
11/20/2015 21:00,468,248,220,5,15
11/20/2015 22:00,337,160,177,5,24
11/20/2015 23:00,325,142,183,5,11
11/21/2015 0:00,305,131,174,5,13
11/21/2015 1:00,263,105,158,5,15
11/21/2015 2:00,184,54,130,5,20
11/21/2015 3:00,175,66,109,5,17
11/21/2015 4:00,97,26,71,5,15
11/21/2015 5:00,54,35,19,5,19
11/21/2015 6:00,65,43,22,5,19
11/21/2015 7:00,132,109,23,4,15
11/21/2015 8:00,238,170,68,4,13
11/21/2015 9:00,345,254,91,5,17
11/21/2015 10:00,468,349,119,5,17
11/21/2015 11:00,482,354,128,5,20
11/21/2015 12:00,539,342,197,6,17
11/21/2015 13:00,497,277,220,5,15
11/21/2015 14:00,482,230,252,4,11
11/21/2015 15:00,432,201,231,4,9
11/21/2015 16:00,409,205,204,4,9
11/21/2015 17:00,394,177,217,4,9
11/21/2015 18:00,414,179,235,4,9
11/21/2015 19:00,356,185,171,4,11
11/21/2015 20:00,292,164,128,4,13
11/21/2015 21:00,250,141,109,3,11
11/21/2015 22:00,239,100,139,3,9
11/21/2015 23:00,211,84,127,2,9
11/22/2015 0:00,188,76,112,1,7
11/22/2015 1:00,168,61,107,1,11
11/22/2015 2:00,156,43,113,1,13
11/22/2015 3:00,156,56,100,1,11
11/22/2015 4:00,80,25,55,0,9
11/22/2015 5:00,67,12,55,-1,13
11/22/2015 6:00,56,28,28,0,9
11/22/2015 7:00,32,19,13,0,17
11/22/2015 8:00,50,25,25,0,7
11/22/2015 9:00,173,137,36,1,11
11/22/2015 10:00,217,152,65,3,15
11/22/2015 11:00,187,98,89,3,19
11/22/2015 12:00,242,132,110,3,19
11/22/2015 13:00,320,186,134,4,26
11/22/2015 14:00,331,183,148,2,11
11/22/2015 15:00,309,173,136,2,13
11/22/2015 16:00,349,178,171,1,17
11/22/2015 17:00,340,183,157,2,20
11/22/2015 18:00,368,193,175,2,24
11/22/2015 19:00,303,122,181,2,24
11/22/2015 20:00,232,83,149,2,24
11/22/2015 21:00,183,63,120,2,19
11/22/2015 22:00,158,56,102,3,17
11/22/2015 23:00,115,39,76,3,13
11/23/2015 0:00,43,13,30,3,15
11/23/2015 1:00,17,7,10,3,11
11/23/2015 2:00,3,3,0,3,13
11/23/2015 3:00,3,3,0,3,13
11/23/2015 4:00,12,9,3,3,11
11/23/2015 5:00,50,40,10,2,7
11/23/2015 6:00,146,101,45,1,7
11/23/2015 7:00,785,513,272,0,7
11/23/2015 8:00,1140,663,477,0,7
11/23/2015 9:00,971,545,426,2,7
11/23/2015 10:00,882,525,357,3,4
11/23/2015 11:00,1001,459,542,4,6
11/23/2015 12:00,950,509,441,5,6
11/23/2015 13:00,1250,649,601,5,9
11/23/2015 14:00,1064,588,476,5,13
11/23/2015 15:00,1372,763,609,4,9
11/23/2015 16:00,1315,762,553,4,9
11/23/2015 17:00,1656,918,738,4,7
11/23/2015 18:00,1389,809,580,4,9
11/23/2015 19:00,1199,576,623,4,9
11/23/2015 20:00,688,241,447,3,9
11/23/2015 21:00,473,163,310,3,11
11/23/2015 22:00,382,145,237,4,13
11/23/2015 23:00,215,60,155,4,13
11/24/2015 0:00,116,45,71,3,13
11/24/2015 1:00,50,9,41,3,17
11/24/2015 2:00,12,2,10,3,17
11/24/2015 3:00,10,5,5,3,15
11/24/2015 4:00,23,13,10,3,19
11/24/2015 5:00,46,34,12,3,15
11/24/2015 6:00,182,124,58,3,19
11/24/2015 7:00,845,478,367,3,20
11/24/2015 8:00,1427,865,562,3,19
11/24/2015 9:00,1100,576,524,4,19
11/24/2015 10:00,999,569,430,4,22
11/24/2015 11:00,1080,497,583,4,24
11/24/2015 12:00,1021,596,425,4,26
11/24/2015 13:00,1231,631,600,4,28
11/24/2015 14:00,955,515,440,3,20
11/24/2015 15:00,1281,669,612,3,26
11/24/2015 16:00,1158,663,495,3,20
11/24/2015 17:00,1390,764,626,2,17
11/24/2015 18:00,1095,650,445,1,17
11/24/2015 19:00,921,443,478,1,15
11/24/2015 20:00,590,236,354,1,17
11/24/2015 21:00,439,162,277,2,17
11/24/2015 22:00,309,85,224,2,15
11/24/2015 23:00,229,75,154,3,15
11/25/2015 0:00,89,21,68,3,17
11/25/2015 1:00,67,22,45,3,15
11/25/2015 2:00,20,4,16,3,15
11/25/2015 3:00,11,11,0,4,13
11/25/2015 4:00,11,7,4,4,13
11/25/2015 5:00,43,32,11,4,13
11/25/2015 6:00,178,130,48,4,15
11/25/2015 7:00,721,427,294,5,15
11/25/2015 8:00,1169,677,492,5,13
11/25/2015 9:00,1063,500,563,6,11
11/25/2015 10:00,848,506,342,6,7
11/25/2015 11:00,927,510,417,7,15
11/25/2015 12:00,942,555,387,7,19
11/25/2015 13:00,1148,603,545,7,17
11/25/2015 14:00,962,506,456,7,11
11/25/2015 15:00,1176,593,583,6,11
11/25/2015 16:00,1172,661,511,6,4
11/25/2015 17:00,1438,751,687,6,11
11/25/2015 18:00,1177,650,527,5,13
11/25/2015 19:00,1137,579,558,4,11
11/25/2015 20:00,800,346,454,5,11
11/25/2015 21:00,556,237,319,5,13
11/25/2015 22:00,454,216,238,4,9
11/25/2015 23:00,393,146,247,3,9
11/26/2015 0:00,328,171,157,3,11
11/26/2015 1:00,137,34,103,3,6
11/26/2015 2:00,109,24,85,3,13
11/26/2015 3:00,108,16,92,3,9
11/26/2015 4:00,92,27,65,3,9
11/26/2015 5:00,82,36,46,3,7
11/26/2015 6:00,184,125,59,2,4
11/26/2015 7:00,796,459,337,1,4
11/26/2015 8:00,1135,628,507,1,6
11/26/2015 9:00,1019,580,439,2,6
11/26/2015 10:00,963,593,370,5,7
11/26/2015 11:00,1105,547,558,6,6
11/26/2015 12:00,1042,567,475,7,7
11/26/2015 13:00,1248,662,586,8,7
11/26/2015 14:00,1031,576,455,8,11
11/26/2015 15:00,1322,773,549,6,9
11/26/2015 16:00,1280,743,537,4,4
11/26/2015 17:00,1521,880,641,3,4
11/26/2015 18:00,1283,714,569,2,2
11/26/2015 19:00,1041,435,606,1,4
11/26/2015 20:00,812,310,502,1,2
11/26/2015 21:00,531,235,296,0,4
11/26/2015 22:00,380,152,228,-1,2
11/26/2015 23:00,303,99,204,-1,2
11/27/2015 0:00,175,57,118,-2,2
11/27/2015 1:00,77,26,51,-1,4
11/27/2015 2:00,85,33,52,-1,6
11/27/2015 3:00,74,23,51,-1,6
11/27/2015 4:00,53,20,33,0,6
11/27/2015 5:00,66,37,29,0,6
11/27/2015 6:00,157,99,58,0,7
11/27/2015 7:00,702,426,276,1,9
11/27/2015 8:00,1076,643,433,1,11
11/27/2015 9:00,904,508,396,2,11
11/27/2015 10:00,869,559,310,4,11
11/27/2015 11:00,877,469,408,5,15
11/27/2015 12:00,908,520,388,6,17
11/27/2015 13:00,1016,552,464,7,17
11/27/2015 14:00,899,500,399,7,17
11/27/2015 15:00,998,537,461,6,13
11/27/2015 16:00,941,565,376,5,13
11/27/2015 17:00,875,497,378,5,20
11/27/2015 18:00,822,475,347,5,20
11/27/2015 19:00,755,420,335,5,19
11/27/2015 20:00,530,242,288,5,17
11/27/2015 21:00,441,160,281,5,22
11/27/2015 22:00,325,139,186,4,22
11/27/2015 23:00,278,91,187,4,20
11/28/2015 0:00,245,71,174,4,20
11/28/2015 1:00,205,58,147,4,19
11/28/2015 2:00,139,48,91,4,20
11/28/2015 3:00,91,34,57,4,22
11/28/2015 4:00,63,21,42,4,19
11/28/2015 5:00,70,36,34,4,22
11/28/2015 6:00,44,31,13,5,22
11/28/2015 7:00,109,88,21,6,20
11/28/2015 8:00,218,150,68,5,19
11/28/2015 9:00,339,255,84,5,22
11/28/2015 10:00,478,354,124,7,24
11/28/2015 11:00,523,377,146,7,28
11/28/2015 12:00,610,385,225,7,32
11/28/2015 13:00,651,391,260,7,30
11/28/2015 14:00,542,282,260,7,22
11/28/2015 15:00,525,275,250,6,19
11/28/2015 16:00,496,252,244,6,19
11/28/2015 17:00,516,251,265,6,24
11/28/2015 18:00,494,270,224,6,20
11/28/2015 19:00,443,223,220,6,20
11/28/2015 20:00,332,139,193,6,26
11/28/2015 21:00,310,120,190,6,24
11/28/2015 22:00,255,113,142,6,32
11/28/2015 23:00,245,83,162,6,26
11/29/2015 0:00,188,66,122,6,33
11/29/2015 1:00,183,70,113,7,33
11/29/2015 2:00,137,56,81,7,35
11/29/2015 3:00,124,48,76,7,28
11/29/2015 4:00,89,38,51,7,17
11/29/2015 5:00,60,13,47,8,22
11/29/2015 6:00,46,19,27,8,22
11/29/2015 7:00,22,9,13,8,22
11/29/2015 8:00,58,39,19,8,22
11/29/2015 9:00,149,111,38,9,24
11/29/2015 10:00,206,148,58,9,32
11/29/2015 11:00,219,154,65,10,33
11/29/2015 12:00,227,134,93,10,30
11/29/2015 13:00,247,129,118,10,24
11/29/2015 14:00,242,128,114,9,22
11/29/2015 15:00,231,119,112,10,33
11/29/2015 16:00,249,135,114,10,33
11/29/2015 17:00,307,180,127,11,35
11/29/2015 18:00,358,183,175,11,39
11/29/2015 19:00,306,113,193,11,35
11/29/2015 20:00,215,56,159,11,46
11/29/2015 21:00,102,36,66,9,39
11/29/2015 22:00,132,34,98,9,37
11/29/2015 23:00,78,23,55,9,35
11/30/2015 0:00,47,20,27,9,33
11/30/2015 1:00,7,1,6,9,37
11/30/2015 2:00,9,1,8,8,39
11/30/2015 3:00,1,1,0,8,41
11/30/2015 4:00,10,6,4,7,43
11/30/2015 5:00,20,12,8,7,32
11/30/2015 6:00,94,66,28,7,30
11/30/2015 7:00,427,196,231,7,30
11/30/2015 8:00,1050,662,388,7,26
11/30/2015 9:00,829,437,392,7,22
11/30/2015 10:00,979,667,312,7,22
11/30/2015 11:00,786,283,503,7,15
11/30/2015 12:00,990,600,390,7,26
11/30/2015 13:00,770,292,478,6,7
11/30/2015 14:00,1048,654,394,6,11
11/30/2015 15:00,825,308,517,8,17
11/30/2015 16:00,1344,891,453,10,26
11/30/2015 17:00,856,349,507,10,28
11/30/2015 18:00,973,603,370,10,33
11/30/2015 19:00,646,286,360,11,35
11/30/2015 20:00,518,256,262,11,37
11/30/2015 21:00,275,107,168,11,44
11/30/2015 22:00,308,79,229,11,39
11/30/2015 23:00,135,58,77,12,39
12/1/2015 0:00,77,29,48,10,28
12/1/2015 1:00,32,18,14,8,15
12/1/2015 2:00,8,7,1,8,20
12/1/2015 3:00,6,4,2,8,13
12/1/2015 4:00,12,8,4,7,13
12/1/2015 5:00,29,23,6,7,11
12/1/2015 6:00,128,86,42,6,11
12/1/2015 7:00,733,419,314,5,7
12/1/2015 8:00,1223,767,456,6,7
12/1/2015 9:00,1011,508,503,6,7
12/1/2015 10:00,976,556,420,7,11
12/1/2015 11:00,1079,555,524,8,11
12/1/2015 12:00,1059,639,420,8,13
12/1/2015 13:00,1201,589,612,8,15
12/1/2015 14:00,1031,528,503,9,11
12/1/2015 15:00,1162,578,584,8,7
12/1/2015 16:00,1204,704,500,8,13
12/1/2015 17:00,1400,793,607,8,11
12/1/2015 18:00,1141,653,488,9,15
12/1/2015 19:00,1028,520,508,11,19
12/1/2015 20:00,685,339,346,12,20
12/1/2015 21:00,540,205,335,11,22
12/1/2015 22:00,422,152,270,11,24
12/1/2015 23:00,252,83,169,11,24
12/2/2015 0:00,113,27,86,11,24
12/2/2015 1:00,48,24,24,11,24
12/2/2015 2:00,19,13,6,11,24
12/2/2015 3:00,16,8,8,11,24
12/2/2015 4:00,22,16,6,11,20
12/2/2015 5:00,47,42,5,11,19
12/2/2015 6:00,157,121,36,11,17
12/2/2015 7:00,831,516,315,11,19
12/2/2015 8:00,1250,718,532,10,17
12/2/2015 9:00,1151,669,482,11,17
12/2/2015 10:00,1085,700,385,11,20
12/2/2015 11:00,1113,593,520,11,20
12/2/2015 12:00,1090,642,448,11,17
12/2/2015 13:00,1185,603,582,11,17
12/2/2015 14:00,1165,649,516,11,15
12/2/2015 15:00,1297,664,633,11,15
12/2/2015 16:00,1263,711,552,11,19
12/2/2015 17:00,1651,923,728,11,17
12/2/2015 18:00,1333,763,570,10,15
12/2/2015 19:00,1271,713,558,10,19
12/2/2015 20:00,858,381,477,10,17
12/2/2015 21:00,581,215,366,10,17
12/2/2015 22:00,486,167,319,10,15
12/2/2015 23:00,375,164,211,9,15
12/3/2015 0:00,206,68,138,9,13
12/3/2015 1:00,165,30,135,9,11
12/3/2015 2:00,114,31,83,9,13
12/3/2015 3:00,58,6,52,9,11
12/3/2015 4:00,40,13,27,9,13
12/3/2015 5:00,62,45,17,9,13
12/3/2015 6:00,166,124,42,9,11
12/3/2015 7:00,852,495,357,8,9
12/3/2015 8:00,1211,713,498,9,11
12/3/2015 9:00,1058,586,472,9,9
12/3/2015 10:00,977,650,327,10,13
12/3/2015 11:00,1096,579,517,10,17
12/3/2015 12:00,1044,574,470,11,17
12/3/2015 13:00,1239,656,583,11,11
12/3/2015 14:00,1120,600,520,11,11
12/3/2015 15:00,1322,681,641,10,6
12/3/2015 16:00,1256,704,552,9,9
12/3/2015 17:00,1592,955,637,9,15
12/3/2015 18:00,1390,801,589,9,13
12/3/2015 19:00,1077,506,571,8,13
12/3/2015 20:00,849,306,543,8,11
12/3/2015 21:00,575,251,324,7,13
12/3/2015 22:00,473,200,273,7,15
12/3/2015 23:00,309,106,203,7,13
12/4/2015 0:00,193,76,117,7,11
12/4/2015 1:00,103,21,82,7,11
12/4/2015 2:00,76,20,56,7,11
12/4/2015 3:00,52,10,42,9,19
12/4/2015 4:00,46,11,35,9,19
12/4/2015 5:00,45,28,17,9,26
12/4/2015 6:00,100,66,34,9,24
12/4/2015 7:00,528,305,223,9,24
12/4/2015 8:00,826,464,362,9,28
12/4/2015 9:00,745,421,324,9,20
12/4/2015 10:00,770,518,252,9,19
12/4/2015 11:00,853,493,360,9,20
12/4/2015 12:00,902,544,358,10,30
12/4/2015 13:00,1032,565,467,10,22
12/4/2015 14:00,931,508,423,10,24
12/4/2015 15:00,887,509,378,9,20
12/4/2015 16:00,809,448,361,8,20
12/4/2015 17:00,848,491,357,9,20
12/4/2015 18:00,810,434,376,9,22
12/4/2015 19:00,647,329,318,8,20
12/4/2015 20:00,590,262,328,8,20
12/4/2015 21:00,458,172,286,8,19
12/4/2015 22:00,383,124,259,8,24
12/4/2015 23:00,403,133,270,8,22
12/5/2015 0:00,342,129,213,8,20
12/5/2015 1:00,282,130,152,8,20
12/5/2015 2:00,224,121,103,7,20
12/5/2015 3:00,167,98,69,8,22
12/5/2015 4:00,137,85,52,8,22
12/5/2015 5:00,87,49,38,7,19
12/5/2015 6:00,61,30,31,7,20
12/5/2015 7:00,122,87,35,7,26
12/5/2015 8:00,263,187,76,7,30
12/5/2015 9:00,345,239,106,7,28
12/5/2015 10:00,451,343,108,7,26
12/5/2015 11:00,493,340,153,8,28
12/5/2015 12:00,586,382,204,8,28
12/5/2015 13:00,558,357,201,9,26
12/5/2015 14:00,503,275,228,9,24
12/5/2015 15:00,576,288,288,9,22
12/5/2015 16:00,539,269,270,9,24
12/5/2015 17:00,558,299,259,9,20
12/5/2015 18:00,478,242,236,9,20
12/5/2015 19:00,453,229,224,9,24
12/5/2015 20:00,391,170,221,8,24
12/5/2015 21:00,351,119,232,8,22
12/5/2015 22:00,233,112,121,7,22
12/5/2015 23:00,247,111,136,7,19
12/6/2015 0:00,245,93,152,7,24
12/6/2015 1:00,216,111,105,8,26
12/6/2015 2:00,146,39,107,8,22
12/6/2015 3:00,116,39,77,8,24
12/6/2015 4:00,79,31,48,8,28
12/6/2015 5:00,51,19,32,8,24
12/6/2015 6:00,32,14,18,8,30
12/6/2015 7:00,36,21,15,8,30
12/6/2015 8:00,60,43,17,8,28
12/6/2015 9:00,169,122,47,9,28
12/6/2015 10:00,277,196,81,9,20
12/6/2015 11:00,244,167,77,10,22
12/6/2015 12:00,289,158,131,11,26
12/6/2015 13:00,348,228,120,12,28
12/6/2015 14:00,377,211,166,12,26
12/6/2015 15:00,412,216,196,12,22
12/6/2015 16:00,394,181,213,12,28
12/6/2015 17:00,460,237,223,12,22
12/6/2015 18:00,434,283,151,10,26
12/6/2015 19:00,317,146,171,10,22
12/6/2015 20:00,321,105,216,10,22
12/6/2015 21:00,199,67,132,10,19
12/6/2015 22:00,174,59,115,11,15
12/6/2015 23:00,95,24,71,11,17
12/7/2015 0:00,38,9,29,11,17
12/7/2015 1:00,27,9,18,11,17
12/7/2015 2:00,11,2,9,11,17
12/7/2015 3:00,6,5,1,11,17
12/7/2015 4:00,16,6,10,10,15
12/7/2015 5:00,43,31,12,10,9
12/7/2015 6:00,126,84,42,10,13
12/7/2015 7:00,691,431,260,10,7
12/7/2015 8:00,947,540,407,10,6
12/7/2015 9:00,883,493,390,10,7
12/7/2015 10:00,913,576,337,10,7
12/7/2015 11:00,948,419,529,11,7
12/7/2015 12:00,870,446,424,11,6
12/7/2015 13:00,1125,580,545,12,6
12/7/2015 14:00,966,533,433,12,6
12/7/2015 15:00,1257,625,632,11,6
12/7/2015 16:00,1267,695,572,11,9
12/7/2015 17:00,1450,754,696,10,7
12/7/2015 18:00,1248,718,530,9,2
12/7/2015 19:00,980,455,525,9,7
12/7/2015 20:00,675,236,439,8,6
12/7/2015 21:00,445,168,277,8,6
12/7/2015 22:00,406,162,244,8,7
12/7/2015 23:00,222,73,149,7,4
12/8/2015 0:00,77,35,42,7,6
12/8/2015 1:00,54,17,37,8,9
12/8/2015 2:00,27,8,19,8,6
12/8/2015 3:00,7,5,2,8,7
12/8/2015 4:00,16,8,8,7,6
12/8/2015 5:00,60,42,18,7,7
12/8/2015 6:00,163,113,50,7,11
12/8/2015 7:00,846,482,364,6,6
12/8/2015 8:00,1434,910,524,6,9
12/8/2015 9:00,1178,629,549,7,11
12/8/2015 10:00,1059,593,466,9,13
12/8/2015 11:00,1019,545,474,11,13
12/8/2015 12:00,1216,742,474,13,13
12/8/2015 13:00,1303,710,593,14,11
12/8/2015 14:00,1237,660,577,14,13
12/8/2015 15:00,1350,732,618,13,11
12/8/2015 16:00,1396,730,666,11,7
12/8/2015 17:00,1617,890,727,11,11
12/8/2015 18:00,1364,851,513,11,13
12/8/2015 19:00,1105,553,552,11,13
12/8/2015 20:00,769,275,494,12,17
12/8/2015 21:00,574,219,355,10,9
12/8/2015 22:00,432,138,294,10,15
12/8/2015 23:00,297,110,187,10,11
12/9/2015 0:00,146,52,94,11,19
12/9/2015 1:00,57,19,38,10,20
12/9/2015 2:00,37,8,29,10,19
12/9/2015 3:00,23,5,18,9,19
12/9/2015 4:00,20,11,9,9,17
12/9/2015 5:00,58,39,19,8,17
12/9/2015 6:00,176,132,44,8,15
12/9/2015 7:00,892,551,341,8,15
12/9/2015 8:00,1314,791,523,7,15
12/9/2015 9:00,1162,631,531,7,17
12/9/2015 10:00,1120,709,411,8,19
12/9/2015 11:00,1077,584,493,8,19
12/9/2015 12:00,1124,667,457,9,22
12/9/2015 13:00,1225,658,567,9,24
12/9/2015 14:00,1188,691,497,8,22
12/9/2015 15:00,1224,590,634,8,9
12/9/2015 16:00,1246,688,558,7,9
12/9/2015 17:00,1549,878,671,6,13
12/9/2015 18:00,1397,842,555,6,11
12/9/2015 19:00,1150,574,576,6,13
12/9/2015 20:00,849,364,485,6,11
12/9/2015 21:00,588,228,360,5,11
12/9/2015 22:00,523,208,315,5,15
12/9/2015 23:00,397,161,236,5,15
12/10/2015 0:00,238,105,133,5,11
12/10/2015 1:00,161,50,111,5,13
12/10/2015 2:00,62,23,39,5,15
12/10/2015 3:00,74,8,66,5,17
12/10/2015 4:00,46,15,31,5,19
12/10/2015 5:00,71,44,27,4,15
12/10/2015 6:00,138,101,37,4,19
12/10/2015 7:00,838,502,336,4,17
12/10/2015 8:00,1168,665,503,4,15
12/10/2015 9:00,1021,588,433,5,19
12/10/2015 10:00,995,651,344,6,20
12/10/2015 11:00,1115,575,540,7,24
12/10/2015 12:00,1131,664,467,7,20
12/10/2015 13:00,1208,588,620,8,20
12/10/2015 14:00,1154,587,567,8,17
12/10/2015 15:00,1329,726,603,7,17
12/10/2015 16:00,1322,748,574,7,17
12/10/2015 17:00,1493,847,646,6,17
12/10/2015 18:00,1341,756,585,6,15
12/10/2015 19:00,1122,512,610,5,19
12/10/2015 20:00,689,274,415,5,19
12/10/2015 21:00,562,238,324,5,17
12/10/2015 22:00,478,185,293,5,20
12/10/2015 23:00,336,128,208,5,19
12/11/2015 0:00,224,110,114,6,15
12/11/2015 1:00,113,48,65,6,19
12/11/2015 2:00,68,18,50,4,22
12/11/2015 3:00,50,14,36,5,19
12/11/2015 4:00,41,16,25,4,19
12/11/2015 5:00,45,28,17,5,20
12/11/2015 6:00,82,58,24,5,20
12/11/2015 7:00,565,346,219,5,22
12/11/2015 8:00,760,447,313,5,24
12/11/2015 9:00,749,435,314,6,26
12/11/2015 10:00,737,472,265,7,26
12/11/2015 11:00,744,428,316,7,22
12/11/2015 12:00,804,459,345,7,26
12/11/2015 13:00,807,446,361,7,24
12/11/2015 14:00,745,406,339,7,20
12/11/2015 15:00,719,390,329,8,24
12/11/2015 16:00,733,407,326,8,24
12/11/2015 17:00,747,428,319,8,24
12/11/2015 18:00,726,439,287,8,32
12/11/2015 19:00,655,355,300,7,13
12/11/2015 20:00,422,194,228,7,22
12/11/2015 21:00,442,202,240,6,20
12/11/2015 22:00,307,140,167,6,17
12/11/2015 23:00,268,116,152,6,17
12/12/2015 0:00,324,138,186,5,15
12/12/2015 1:00,266,110,156,5,13
12/12/2015 2:00,151,47,104,5,15
12/12/2015 3:00,121,33,88,5,15
12/12/2015 4:00,88,24,64,5,17
12/12/2015 5:00,45,19,26,4,15
12/12/2015 6:00,66,36,30,4,17
12/12/2015 7:00,118,97,21,5,17
12/12/2015 8:00,336,242,94,5,17
12/12/2015 9:00,399,274,125,5,15
12/12/2015 10:00,566,401,165,5,13
12/12/2015 11:00,544,391,153,6,15
12/12/2015 12:00,598,377,221,7,13
12/12/2015 13:00,636,390,246,7,7
12/12/2015 14:00,571,304,267,7,7
12/12/2015 15:00,615,342,273,7,7
12/12/2015 16:00,518,261,257,7,11
12/12/2015 17:00,574,254,320,7,11
12/12/2015 18:00,498,221,277,6,15
12/12/2015 19:00,414,203,211,7,19
12/12/2015 20:00,462,196,266,9,26
12/12/2015 21:00,295,143,152,10,30
12/12/2015 22:00,249,102,147,10,37
12/12/2015 23:00,255,97,158,11,41
12/13/2015 0:00,230,112,118,11,35
12/13/2015 1:00,255,133,122,10,44
12/13/2015 2:00,158,82,76,10,35
12/13/2015 3:00,143,56,87,10,39
12/13/2015 4:00,108,47,61,9,33
12/13/2015 5:00,50,21,29,8,26
12/13/2015 6:00,30,23,7,7,20
12/13/2015 7:00,39,26,13,7,9
12/13/2015 8:00,61,34,27,6,11
12/13/2015 9:00,180,147,33,6,11
12/13/2015 10:00,285,218,67,7,11
12/13/2015 11:00,277,184,93,7,13
12/13/2015 12:00,371,240,131,8,9
12/13/2015 13:00,405,258,147,8,7
12/13/2015 14:00,464,270,194,8,6
12/13/2015 15:00,530,306,224,6,4
12/13/2015 16:00,562,320,242,4,4
12/13/2015 17:00,471,221,250,3,4
12/13/2015 18:00,554,209,345,2,0
12/13/2015 19:00,404,183,221,2,2
12/13/2015 20:00,299,94,205,2,4
12/13/2015 21:00,212,71,141,3,6
12/13/2015 22:00,213,83,130,3,4
12/13/2015 23:00,122,39,83,3,6
12/14/2015 0:00,66,25,41,3,6
12/14/2015 1:00,28,13,15,3,6
12/14/2015 2:00,3,1,2,3,6
12/14/2015 3:00,5,4,1,4,6
12/14/2015 4:00,13,11,2,4,6
12/14/2015 5:00,48,36,12,4,6
12/14/2015 6:00,144,106,38,4,6
12/14/2015 7:00,710,444,266,5,6
12/14/2015 8:00,1055,615,440,5,7
12/14/2015 9:00,970,535,435,5,6
12/14/2015 10:00,857,536,321,6,6
12/14/2015 11:00,936,455,481,6,7
12/14/2015 12:00,889,492,397,7,7
12/14/2015 13:00,1119,592,527,8,6
12/14/2015 14:00,935,514,421,8,9
12/14/2015 15:00,1277,661,616,8,6
12/14/2015 16:00,1204,660,544,8,6
12/14/2015 17:00,1578,948,630,8,6
12/14/2015 18:00,1264,665,599,8,6
12/14/2015 19:00,1025,480,545,9,11
12/14/2015 20:00,696,231,465,9,9
12/14/2015 21:00,417,171,246,8,7
12/14/2015 22:00,429,191,238,8,9
12/14/2015 23:00,257,95,162,7,9
12/15/2015 0:00,113,32,81,7,9
12/15/2015 1:00,37,14,23,6,4
12/15/2015 2:00,33,13,20,4,4
12/15/2015 3:00,14,8,6,5,6
12/15/2015 4:00,22,15,7,5,6
12/15/2015 5:00,61,49,12,4,2
12/15/2015 6:00,150,102,48,4,2
12/15/2015 7:00,776,444,332,5,4
12/15/2015 8:00,1339,815,524,5,4
12/15/2015 9:00,1079,579,500,5,2
12/15/2015 10:00,1056,622,434,6,4
12/15/2015 11:00,1071,514,557,7,2
12/15/2015 12:00,1088,635,453,8,4
12/15/2015 13:00,1193,630,563,8,4
12/15/2015 14:00,1071,599,472,7,2
12/15/2015 15:00,1275,678,597,7,4
12/15/2015 16:00,1234,720,514,6,4
12/15/2015 17:00,1505,869,636,6,6
12/15/2015 18:00,1340,704,636,6,6
12/15/2015 19:00,1102,516,586,6,7
12/15/2015 20:00,824,318,506,6,6
12/15/2015 21:00,562,271,291,7,7
12/15/2015 22:00,507,201,306,7,7
12/15/2015 23:00,355,142,213,7,7
12/16/2015 0:00,196,65,131,6,6
12/16/2015 1:00,133,39,94,6,9
12/16/2015 2:00,15,4,11,6,9
12/16/2015 3:00,26,17,9,5,9
12/16/2015 4:00,27,17,10,5,9
12/16/2015 5:00,50,36,14,6,11
12/16/2015 6:00,154,116,38,7,11
12/16/2015 7:00,730,461,269,7,9
12/16/2015 8:00,972,524,448,7,9
12/16/2015 9:00,794,457,337,8,13
12/16/2015 10:00,852,534,318,8,11
12/16/2015 11:00,749,407,342,9,11
12/16/2015 12:00,937,532,405,10,11
12/16/2015 13:00,996,536,460,10,11
12/16/2015 14:00,921,493,428,11,13
12/16/2015 15:00,1022,518,504,11,13
12/16/2015 16:00,1027,563,464,11,13
12/16/2015 17:00,1156,617,539,11,13
12/16/2015 18:00,1089,604,485,11,13
12/16/2015 19:00,981,566,415,12,15
12/16/2015 20:00,661,261,400,12,15
12/16/2015 21:00,547,204,343,12,15
12/16/2015 22:00,443,166,277,12,15
12/16/2015 23:00,382,203,179,12,15
12/17/2015 0:00,402,275,127,12,17
12/17/2015 1:00,220,115,105,12,19
12/17/2015 2:00,125,29,96,12,15
12/17/2015 3:00,157,25,132,12,11
12/17/2015 4:00,180,33,147,12,11
12/17/2015 5:00,112,36,76,13,15
12/17/2015 6:00,141,84,57,13,15
12/17/2015 7:00,643,389,254,13,17
12/17/2015 8:00,916,540,376,13,13
12/17/2015 9:00,822,460,362,13,9
12/17/2015 10:00,851,489,362,14,17
12/17/2015 11:00,975,515,460,14,15
12/17/2015 12:00,1034,593,441,15,15
12/17/2015 13:00,1137,540,597,15,15
12/17/2015 14:00,1130,612,518,15,15
12/17/2015 15:00,1236,659,577,14,9
12/17/2015 16:00,1306,747,559,13,9
12/17/2015 17:00,1357,793,564,13,9
12/17/2015 18:00,1361,749,612,13,9
12/17/2015 19:00,966,426,540,12,7
12/17/2015 20:00,708,253,455,12,9
12/17/2015 21:00,497,202,295,13,11
12/17/2015 22:00,471,210,261,13,11
12/17/2015 23:00,410,137,273,13,11
12/18/2015 0:00,244,106,138,14,13
12/18/2015 1:00,177,68,109,14,13
12/18/2015 2:00,79,19,60,13,13
12/18/2015 3:00,82,26,56,14,19
12/18/2015 4:00,64,17,47,12,20
12/18/2015 5:00,77,35,42,12,17
12/18/2015 6:00,156,114,42,12,17
12/18/2015 7:00,654,410,244,12,24
12/18/2015 8:00,918,510,408,12,19
12/18/2015 9:00,804,480,324,12,17
12/18/2015 10:00,885,564,321,12,20
12/18/2015 11:00,875,511,364,12,20
12/18/2015 12:00,989,575,414,12,17
12/18/2015 13:00,1062,571,491,12,19
12/18/2015 14:00,955,509,446,12,15
12/18/2015 15:00,968,523,445,12,15
12/18/2015 16:00,885,452,433,12,15
12/18/2015 17:00,875,445,430,12,13
12/18/2015 18:00,907,477,430,12,11
12/18/2015 19:00,679,351,328,12,11
12/18/2015 20:00,578,278,300,11,11
12/18/2015 21:00,466,216,250,11,9
12/18/2015 22:00,332,136,196,11,9
12/18/2015 23:00,323,116,207,11,11
12/19/2015 0:00,302,106,196,11,11
12/19/2015 1:00,310,105,205,11,11
12/19/2015 2:00,234,66,168,11,11
12/19/2015 3:00,171,55,116,11,13
12/19/2015 4:00,111,39,72,12,15
12/19/2015 5:00,79,31,48,12,15
12/19/2015 6:00,62,45,17,12,13
12/19/2015 7:00,90,63,27,12,13
12/19/2015 8:00,191,130,61,11,13
12/19/2015 9:00,315,259,56,12,13
12/19/2015 10:00,507,380,127,12,13
12/19/2015 11:00,581,407,174,13,15
12/19/2015 12:00,718,459,259,13,13
12/19/2015 13:00,701,459,242,14,17
12/19/2015 14:00,666,323,343,14,17
12/19/2015 15:00,639,335,304,14,11
12/19/2015 16:00,607,294,313,14,13
12/19/2015 17:00,571,265,306,14,13
12/19/2015 18:00,563,257,306,14,13
12/19/2015 19:00,519,232,287,13,17
12/19/2015 20:00,462,207,255,13,17
12/19/2015 21:00,381,130,251,12,17
12/19/2015 22:00,261,96,165,11,13
12/19/2015 23:00,266,105,161,11,11
12/20/2015 0:00,260,114,146,11,13
12/20/2015 1:00,287,109,178,10,11
12/20/2015 2:00,211,88,123,10,11
12/20/2015 3:00,163,62,101,10,11
12/20/2015 4:00,103,30,73,10,11
12/20/2015 5:00,77,31,46,11,13
12/20/2015 6:00,36,16,20,10,9
12/20/2015 7:00,37,19,18,11,15
12/20/2015 8:00,54,32,22,10,9
12/20/2015 9:00,178,115,63,11,7
12/20/2015 10:00,303,224,79,12,11
12/20/2015 11:00,287,167,120,13,15
12/20/2015 12:00,336,184,152,14,13
12/20/2015 13:00,423,257,166,14,20
12/20/2015 14:00,465,278,187,14,17
12/20/2015 15:00,432,279,153,13,9
12/20/2015 16:00,523,286,237,12,11
12/20/2015 17:00,534,323,211,12,11
12/20/2015 18:00,483,243,240,12,9
12/20/2015 19:00,396,190,206,11,11
12/20/2015 20:00,365,118,247,12,11
12/20/2015 21:00,196,59,137,12,13
12/20/2015 22:00,246,92,154,12,9
12/20/2015 23:00,146,60,86,13,15
12/21/2015 0:00,82,32,50,12,17
12/21/2015 1:00,54,21,33,12,17
12/21/2015 2:00,18,11,7,11,15
12/21/2015 3:00,17,9,8,11,20
12/21/2015 4:00,23,11,12,11,15
12/21/2015 5:00,31,18,13,11,17
12/21/2015 6:00,92,63,29,11,19
12/21/2015 7:00,482,318,164,10,19
12/21/2015 8:00,735,455,280,9,17
12/21/2015 9:00,755,463,292,10,24
12/21/2015 10:00,820,506,314,11,28
12/21/2015 11:00,917,504,413,11,30
12/21/2015 12:00,902,485,417,11,28
12/21/2015 13:00,982,534,448,11,32
12/21/2015 14:00,925,487,438,11,32
12/21/2015 15:00,1119,655,464,11,30
12/21/2015 16:00,1024,532,492,11,32
12/21/2015 17:00,1200,693,507,11,28
12/21/2015 18:00,1006,502,504,11,30
12/21/2015 19:00,747,328,419,10,35
12/21/2015 20:00,441,156,285,10,33
12/21/2015 21:00,300,99,201,10,32
12/21/2015 22:00,297,119,178,11,33
12/21/2015 23:00,235,100,135,11,30
12/22/2015 0:00,141,36,105,11,24
12/22/2015 1:00,123,20,103,11,19
12/22/2015 2:00,66,15,51,11,15
12/22/2015 3:00,29,14,15,11,19
12/22/2015 4:00,21,10,11,11,19
12/22/2015 5:00,39,26,13,11,13
12/22/2015 6:00,104,69,35,12,19
12/22/2015 7:00,427,260,167,11,26
12/22/2015 8:00,542,302,240,11,24
12/22/2015 9:00,641,358,283,11,26
12/22/2015 10:00,610,371,239,12,28
12/22/2015 11:00,708,436,272,13,33
12/22/2015 12:00,843,471,372,13,35
12/22/2015 13:00,831,450,381,14,32
12/22/2015 14:00,765,396,369,14,28
12/22/2015 15:00,824,466,358,14,28
12/22/2015 16:00,819,448,371,14,28
12/22/2015 17:00,877,460,417,14,24
12/22/2015 18:00,666,328,338,14,32
12/22/2015 19:00,579,251,328,14,26
12/22/2015 20:00,419,181,238,14,28
12/22/2015 21:00,232,102,130,14,26
12/22/2015 22:00,252,116,136,14,30
12/22/2015 23:00,196,66,130,14,32
12/23/2015 0:00,141,52,89,13,30
12/23/2015 1:00,140,29,111,13,22
12/23/2015 2:00,86,14,72,13,24
12/23/2015 3:00,32,6,26,13,32
12/23/2015 4:00,48,25,23,13,32
12/23/2015 5:00,36,21,15,12,30
12/23/2015 6:00,83,63,20,12,26
12/23/2015 7:00,242,154,88,12,33
12/23/2015 8:00,256,165,91,11,22
12/23/2015 9:00,363,240,123,11,28
12/23/2015 10:00,402,272,130,12,30
12/23/2015 11:00,508,300,208,12,32
12/23/2015 12:00,491,274,217,12,30
12/23/2015 13:00,485,251,234,12,35
12/23/2015 14:00,451,213,238,12,35
12/23/2015 15:00,496,278,218,11,30
12/23/2015 16:00,493,242,251,9,15
12/23/2015 17:00,450,209,241,9,9
12/23/2015 18:00,363,199,164,7,6
12/23/2015 19:00,272,133,139,7,9
12/23/2015 20:00,241,109,132,7,9
12/23/2015 21:00,168,106,62,6,9
12/23/2015 22:00,128,56,72,6,9
12/23/2015 23:00,143,59,84,6,9
12/24/2015 0:00,132,53,79,7,13
12/24/2015 1:00,121,19,102,6,11
12/24/2015 2:00,85,16,69,7,15
12/24/2015 3:00,67,13,54,7,15
12/24/2015 4:00,34,21,13,6,15
12/24/2015 5:00,40,18,22,6,11
12/24/2015 6:00,54,33,21,7,15
12/24/2015 7:00,53,36,17,8,15
12/24/2015 8:00,105,68,37,7,13
12/24/2015 9:00,149,111,38,8,13
12/24/2015 10:00,230,154,76,9,11
12/24/2015 11:00,241,141,100,11,15
12/24/2015 12:00,208,98,110,12,17
12/24/2015 13:00,187,73,114,13,22
12/24/2015 14:00,153,83,70,13,19
12/24/2015 15:00,143,84,59,13,22
12/24/2015 16:00,179,112,67,13,22
12/24/2015 17:00,91,44,47,13,24
12/24/2015 18:00,76,30,46,13,24
12/24/2015 19:00,59,23,36,13,32
12/24/2015 20:00,28,14,14,13,26
12/24/2015 21:00,39,20,19,9,37
12/24/2015 22:00,36,26,10,9,19
12/24/2015 23:00,41,21,20,9,17
12/25/2015 0:00,47,23,24,9,20
12/25/2015 1:00,26,10,16,9,20
12/25/2015 2:00,12,5,7,9,19
12/25/2015 3:00,6,1,5,8,15
12/25/2015 4:00,8,5,3,9,20
12/25/2015 5:00,11,3,8,8,19
12/25/2015 6:00,18,10,8,8,15
12/25/2015 7:00,11,9,2,7,15
12/25/2015 8:00,15,4,11,7,13
12/25/2015 9:00,36,28,8,8,15
12/25/2015 10:00,49,21,28,8,13
12/25/2015 11:00,81,50,31,9,17
12/25/2015 12:00,89,50,39,9,15
12/25/2015 13:00,101,58,43,10,15
12/25/2015 14:00,81,49,32,10,9
12/25/2015 15:00,101,51,50,9,11
12/25/2015 16:00,77,33,44,8,13
12/25/2015 17:00,83,45,38,8,11
12/25/2015 18:00,71,45,26,8,11
12/25/2015 19:00,77,50,27,9,15
12/25/2015 20:00,55,28,27,11,20
12/25/2015 21:00,70,40,30,13,32
12/25/2015 22:00,57,34,23,13,24
12/25/2015 23:00,41,14,27,13,26
12/26/2015 0:00,47,23,24,13,30
12/26/2015 1:00,16,7,9,14,35
12/26/2015 2:00,26,11,15,14,32
12/26/2015 3:00,15,6,9,14,33
12/26/2015 4:00,6,0,6,14,33
12/26/2015 5:00,8,2,6,13,30
12/26/2015 6:00,13,8,5,14,35
12/26/2015 7:00,13,7,6,13,32
12/26/2015 8:00,25,10,15,13,30
12/26/2015 9:00,62,44,18,13,32
12/26/2015 10:00,71,47,24,14,28
12/26/2015 11:00,119,73,46,14,24
12/26/2015 12:00,118,66,52,14,26
12/26/2015 13:00,135,84,51,14,26
12/26/2015 14:00,130,71,59,14,28
12/26/2015 15:00,134,73,61,14,24
12/26/2015 16:00,125,62,63,13,19
12/26/2015 17:00,101,55,46,13,19
12/26/2015 18:00,118,69,49,13,19
12/26/2015 19:00,102,54,48,13,19
12/26/2015 20:00,109,68,41,13,22
12/26/2015 21:00,102,62,40,12,17
12/26/2015 22:00,101,53,48,12,19
12/26/2015 23:00,82,47,35,12,19
12/27/2015 0:00,65,26,39,11,20
12/27/2015 1:00,46,14,32,11,22
12/27/2015 2:00,46,5,41,11,17
12/27/2015 3:00,43,7,36,11,19
12/27/2015 4:00,27,9,18,11,19
12/27/2015 5:00,25,6,19,11,19
12/27/2015 6:00,23,13,10,11,19
12/27/2015 7:00,25,18,7,11,19
12/27/2015 8:00,23,13,10,11,20
12/27/2015 9:00,72,51,21,11,19
12/27/2015 10:00,113,76,37,11,17
12/27/2015 11:00,101,65,36,12,24
12/27/2015 12:00,153,84,69,12,24
12/27/2015 13:00,187,108,79,13,22
12/27/2015 14:00,206,122,84,12,22
12/27/2015 15:00,189,102,87,13,22
12/27/2015 16:00,137,82,55,13,24
12/27/2015 17:00,164,90,74,13,20
12/27/2015 18:00,142,81,61,12,20
12/27/2015 19:00,176,98,78,13,20
12/27/2015 20:00,134,65,69,13,17
12/27/2015 21:00,66,28,38,12,19
12/27/2015 22:00,88,31,57,12,17
12/27/2015 23:00,92,27,65,12,11
12/28/2015 0:00,37,12,25,12,11
12/28/2015 1:00,27,10,17,12,9
12/28/2015 2:00,19,4,15,12,7
12/28/2015 3:00,9,6,3,11,6
12/28/2015 4:00,11,7,4,11,7
12/28/2015 5:00,33,25,8,9,4
12/28/2015 6:00,70,51,19,8,7
12/28/2015 7:00,155,95,60,9,6
12/28/2015 8:00,147,95,52,9,6
12/28/2015 9:00,207,153,54,9,6
12/28/2015 10:00,249,165,84,10,6
12/28/2015 11:00,297,194,103,12,7
12/28/2015 12:00,358,214,144,12,13
12/28/2015 13:00,408,265,143,12,9
12/28/2015 14:00,441,255,186,12,7
12/28/2015 15:00,480,234,246,12,9
12/28/2015 16:00,438,218,220,11,11
12/28/2015 17:00,424,187,237,11,9
12/28/2015 18:00,318,165,153,10,11
12/28/2015 19:00,288,145,143,10,11
12/28/2015 20:00,211,89,122,10,13
12/28/2015 21:00,128,59,69,9,13
12/28/2015 22:00,120,42,78,9,11
12/28/2015 23:00,114,42,72,8,15
12/29/2015 0:00,68,17,51,9,15
12/29/2015 1:00,67,14,53,8,13
12/29/2015 2:00,37,8,29,8,11
12/29/2015 3:00,10,1,9,8,9
12/29/2015 4:00,15,7,8,7,9
12/29/2015 5:00,37,28,9,7,7
12/29/2015 6:00,73,53,20,7,11
12/29/2015 7:00,119,70,49,6,9
12/29/2015 8:00,175,117,58,6,6
12/29/2015 9:00,251,197,54,6,7
12/29/2015 10:00,249,175,74,8,11
12/29/2015 11:00,295,168,127,9,11
12/29/2015 12:00,357,217,140,10,11
12/29/2015 13:00,405,246,159,11,9
12/29/2015 14:00,417,219,198,10,7
12/29/2015 15:00,444,228,216,10,6
12/29/2015 16:00,411,213,198,10,7
12/29/2015 17:00,461,217,244,10,9
12/29/2015 18:00,391,186,205,10,6
12/29/2015 19:00,305,153,152,9,6
12/29/2015 20:00,217,108,109,9,7
12/29/2015 21:00,166,74,92,9,7
12/29/2015 22:00,136,56,80,9,9
12/29/2015 23:00,97,30,67,8,7
12/30/2015 0:00,91,21,70,8,7
12/30/2015 1:00,69,24,45,6,4
12/30/2015 2:00,48,17,31,6,4
12/30/2015 3:00,13,5,8,6,9
12/30/2015 4:00,23,12,11,5,7
12/30/2015 5:00,25,18,7,5,9
12/30/2015 6:00,75,56,19,4,9
12/30/2015 7:00,129,88,41,4,9
12/30/2015 8:00,218,157,61,4,9
12/30/2015 9:00,249,181,68,5,13
12/30/2015 10:00,330,220,110,7,13
12/30/2015 11:00,413,260,153,8,15
12/30/2015 12:00,407,250,157,9,13
12/30/2015 13:00,468,265,203,10,11
12/30/2015 14:00,473,226,247,9,19
12/30/2015 15:00,450,241,209,9,15
12/30/2015 16:00,423,195,228,7,17
12/30/2015 17:00,433,190,243,6,19
12/30/2015 18:00,379,190,189,6,17
12/30/2015 19:00,286,135,151,5,13
12/30/2015 20:00,225,104,121,5,13
12/30/2015 21:00,146,67,79,4,15
12/30/2015 22:00,143,54,89,3,13
12/30/2015 23:00,133,52,81,3,17
12/31/2015 0:00,117,29,88,3,17
12/31/2015 1:00,59,13,46,4,15
12/31/2015 2:00,32,9,23,4,15
12/31/2015 3:00,22,7,15,4,15
12/31/2015 4:00,13,4,9,4,17
12/31/2015 5:00,20,14,6,5,15
12/31/2015 6:00,31,21,10,5,13
12/31/2015 7:00,46,29,17,6,11
12/31/2015 8:00,58,29,29,7,11
12/31/2015 9:00,100,62,38,7,15
12/31/2015 10:00,188,122,66,8,15
12/31/2015 11:00,229,145,84,8,15
12/31/2015 12:00,242,134,108,9,17
12/31/2015 13:00,248,107,141,10,15
12/31/2015 14:00,264,128,136,10,20
12/31/2015 15:00,255,125,130,9,19
12/31/2015 16:00,197,121,76,9,13
12/31/2015 17:00,228,139,89,7,7
12/31/2015 18:00,320,182,138,7,9
12/31/2015 19:00,357,202,155,6,9
12/31/2015 20:00,226,135,91,6,7
12/31/2015 21:00,170,110,60,5,9
12/31/2015 22:00,151,125,26,6,9
12/31/2015 23:00,238,195,43,4,7
Insgesamt,4041517,,,,
