Stunden,Neutor (gesamt),FR stadteinwärts,FR stadtauswärts,Temperatur (°C),Windstärke (km/h),Wetter
1/1/2016 0:00,137,49,88,3,9,Klarer Himmel
1/1/2016 1:00,178,97,81,3,7,Klarer Himmel
1/1/2016 2:00,243,115,128,3,9,Klarer Himmel
1/1/2016 3:00,256,101,155,3,9,teilweise bewölkt
1/1/2016 4:00,205,68,137,2,6,wolkig
1/1/2016 5:00,125,36,89,3,6,Regen
1/1/2016 6:00,49,11,38,3,7,
1/1/2016 7:00,46,21,25,2,4,
1/1/2016 8:00,22,10,12,0,2,Nebel
1/1/2016 9:00,25,20,5,1,4,wolkig
1/1/2016 10:00,40,24,16,4,6,Nebel
1/1/2016 11:00,75,44,31,5,6,wolkig
1/1/2016 12:00,126,86,40,6,4,wolkig
1/1/2016 13:00,145,65,80,7,4,wolkig
1/1/2016 14:00,173,94,79,7,4,wolkig
1/1/2016 15:00,216,119,97,6,4,Nebel
1/1/2016 16:00,179,100,79,6,6,Nebel
1/1/2016 17:00,138,72,66,5,4,Nebel
1/1/2016 18:00,163,89,74,4,4,Nebel
1/1/2016 19:00,96,53,43,5,7,
1/1/2016 20:00,83,30,53,4,9,wolkig
1/1/2016 21:00,55,25,30,4,9,wolkig
1/1/2016 22:00,77,24,53,4,9,Klarer Himmel
1/1/2016 23:00,33,7,26,4,7,Klarer Himmel
1/2/2016 0:00,34,18,16,4,9,teilweise bewölkt
1/2/2016 1:00,18,5,13,5,9,wolkig
1/2/2016 2:00,8,5,3,4,11,Klarer Himmel
1/2/2016 3:00,5,2,3,4,13,Klarer Himmel
1/2/2016 4:00,6,5,1,4,13,Klarer Himmel
1/2/2016 5:00,21,12,9,4,17,Klarer Himmel
1/2/2016 6:00,35,20,15,4,17,Klarer Himmel
1/2/2016 7:00,44,34,10,4,13,Klarer Himmel
1/2/2016 8:00,79,43,36,4,15,Klarer Himmel
1/2/2016 9:00,130,97,33,4,15,wolkig
1/2/2016 10:00,195,131,64,4,15,Regen
1/2/2016 11:00,201,133,68,3,15,wolkig
1/2/2016 12:00,214,107,107,3,15,Regen
1/2/2016 13:00,215,120,95,3,15,Regen
1/2/2016 14:00,252,151,101,3,13,wolkig
1/2/2016 15:00,248,134,114,3,13,Regen
1/2/2016 16:00,235,119,116,3,15,Regen
1/2/2016 17:00,216,91,125,3,13,Regen
1/2/2016 18:00,177,83,94,2,17,Regen
1/2/2016 19:00,175,77,98,2,13,Regen
1/2/2016 20:00,148,79,69,2,13,wolkig
1/2/2016 21:00,95,45,50,2,15,wolkig
1/2/2016 22:00,68,29,39,2,13,wolkig
1/2/2016 23:00,83,51,32,2,13,wolkig
1/3/2016 0:00,73,37,36,2,13,wolkig
1/3/2016 1:00,53,16,37,2,11,teilweise bewölkt
1/3/2016 2:00,33,9,24,2,15,wolkig
1/3/2016 3:00,33,4,29,2,11,Regen
1/3/2016 4:00,16,6,10,3,15,wolkig
1/3/2016 5:00,15,6,9,3,15,wolkig
1/3/2016 6:00,18,6,12,2,17,Regen
1/3/2016 7:00,19,10,9,2,13,Regen
1/3/2016 8:00,34,23,11,2,17,Regen
1/3/2016 9:00,40,31,9,2,15,Regen
1/3/2016 10:00,88,50,38,2,15,Regen
1/3/2016 11:00,69,43,26,3,11,Regen
1/3/2016 12:00,80,40,40,3,13,Regen
1/3/2016 13:00,111,60,51,3,11,Regen
1/3/2016 14:00,133,74,59,3,9,Regen
1/3/2016 15:00,139,78,61,3,13,wolkig
1/3/2016 16:00,147,78,69,3,11,wolkig
1/3/2016 17:00,170,96,74,3,13,teilweise bewölkt
1/3/2016 18:00,201,114,87,3,11,teilweise bewölkt
1/3/2016 19:00,170,74,96,2,11,wolkig
1/3/2016 20:00,118,59,59,2,15,wolkig
1/3/2016 21:00,65,32,33,2,15,wolkig
1/3/2016 22:00,77,31,46,2,17,wolkig
1/3/2016 23:00,72,27,45,2,15,wolkig
1/4/2016 0:00,42,14,28,2,15,Regen
1/4/2016 1:00,19,5,14,2,15,Schnee
1/4/2016 2:00,9,2,7,1,13,Schnee
1/4/2016 3:00,6,3,3,1,13,Schnee
1/4/2016 4:00,14,10,4,1,13,Regen
1/4/2016 5:00,40,31,9,1,13,Schnee
1/4/2016 6:00,100,75,25,1,11,Schnee
1/4/2016 7:00,304,195,109,1,13,Schnee
1/4/2016 8:00,394,237,157,1,9,Schnee
1/4/2016 9:00,322,194,128,0,9,Schnee
1/4/2016 10:00,210,124,86,0,9,Schnee
1/4/2016 11:00,226,129,97,0,7,Schnee
1/4/2016 12:00,271,142,129,0,9,Schnee
1/4/2016 13:00,287,159,128,0,7,Schnee
1/4/2016 14:00,342,184,158,0,7,wolkig
1/4/2016 15:00,361,179,182,1,6,Schnee
1/4/2016 16:00,481,255,226,0,7,wolkig
1/4/2016 17:00,497,274,223,-1,9,wolkig
1/4/2016 18:00,474,238,236,-1,11,wolkig
1/4/2016 19:00,374,180,194,-1,9,Regen
1/4/2016 20:00,256,124,132,-1,6,Regen
1/4/2016 21:00,144,45,99,-1,6,Schneeregen
1/4/2016 22:00,128,59,69,0,4,wolkig
1/4/2016 23:00,113,35,78,0,6,Schnee
1/5/2016 0:00,60,20,40,0,4,Schnee
1/5/2016 1:00,35,15,20,1,6,wolkig
1/5/2016 2:00,34,16,18,1,4,wolkig
1/5/2016 3:00,21,8,13,1,4,wolkig
1/5/2016 4:00,19,16,3,1,4,wolkig
1/5/2016 5:00,45,31,14,,,
1/5/2016 6:00,115,75,40,,,
1/5/2016 7:00,300,187,113,,,
1/5/2016 8:00,537,340,197,3,4,wolkig
1/5/2016 9:00,479,297,182,3,7,wolkig
1/5/2016 10:00,408,242,166,4,6,wolkig
1/5/2016 11:00,404,248,156,4,7,wolkig
1/5/2016 12:00,481,265,216,5,7,wolkig
1/5/2016 13:00,499,268,231,5,7,wolkig
1/5/2016 14:00,574,328,246,4,7,wolkig
1/5/2016 15:00,575,297,278,2,11,wolkig
1/5/2016 16:00,697,334,363,1,13,wolkig
1/5/2016 17:00,754,379,375,0,11,wolkig
1/5/2016 18:00,605,309,296,0,9,wolkig
1/5/2016 19:00,505,234,271,-1,13,Schneeregen
1/5/2016 20:00,334,169,165,-1,13,wolkig
1/5/2016 21:00,191,79,112,-1,11,wolkig
1/5/2016 22:00,200,85,115,-2,13,wolkig
1/5/2016 23:00,145,46,99,-2,11,wolkig
1/6/2016 0:00,88,33,55,-2,15,wolkig
1/6/2016 1:00,42,11,31,-2,13,wolkig
1/6/2016 2:00,16,6,10,-2,9,Schneeregen
1/6/2016 3:00,14,3,11,-2,11,wolkig
1/6/2016 4:00,20,11,9,-2,11,wolkig
1/6/2016 5:00,50,38,12,-2,13,wolkig
1/6/2016 6:00,127,95,32,-2,13,Schneeregen
1/6/2016 7:00,411,253,158,-2,11,Schneeregen
1/6/2016 8:00,560,310,250,-2,11,Schneeregen
1/6/2016 9:00,514,325,189,-2,11,Schneeregen
1/6/2016 10:00,469,291,178,-2,11,Schneeregen
1/6/2016 11:00,385,204,181,-2,11,Schneeregen
1/6/2016 12:00,513,272,241,-2,11,Schneeregen
1/6/2016 13:00,528,261,267,-2,11,wolkig
1/6/2016 14:00,532,281,251,-2,15,wolkig
1/6/2016 15:00,616,352,264,-2,9,wolkig
1/6/2016 16:00,705,374,331,-2,9,wolkig
1/6/2016 17:00,723,381,342,-2,7,wolkig
1/6/2016 18:00,671,351,320,-2,9,wolkig
1/6/2016 19:00,554,299,255,-2,6,wolkig
1/6/2016 20:00,416,221,195,-2,7,wolkig
1/6/2016 21:00,280,127,153,-2,7,wolkig
1/6/2016 22:00,241,85,156,-2,6,wolkig
1/6/2016 23:00,163,46,117,-1,6,wolkig
1/7/2016 0:00,95,30,65,-1,6,wolkig
1/7/2016 1:00,58,19,39,-1,6,wolkig
1/7/2016 2:00,29,12,17,0,2,wolkig
1/7/2016 3:00,17,2,15,0,4,wolkig
1/7/2016 4:00,24,11,13,0,6,wolkig
1/7/2016 5:00,55,33,22,1,6,wolkig
1/7/2016 6:00,114,92,22,1,7,wolkig
1/7/2016 7:00,680,417,263,2,11,Nebel
1/7/2016 8:00,885,488,397,2,7,Nebel
1/7/2016 9:00,842,465,377,3,13,Nebel
1/7/2016 10:00,753,448,305,3,9,
1/7/2016 11:00,895,483,412,5,9,
1/7/2016 12:00,828,455,373,5,9,Klarer Himmel
1/7/2016 13:00,982,487,495,6,9,Klarer Himmel
1/7/2016 14:00,867,453,414,6,17,Klarer Himmel
1/7/2016 15:00,1091,585,506,6,15,wolkig
1/7/2016 16:00,964,484,480,5,17,Regen
1/7/2016 17:00,795,390,405,5,15,Regen
1/7/2016 18:00,677,308,369,5,24,Regen
1/7/2016 19:00,615,289,326,5,20,Regen
1/7/2016 20:00,346,154,192,5,19,Regen
1/7/2016 21:00,257,126,131,7,43,Regen
1/7/2016 22:00,190,82,108,6,35,Regen
1/7/2016 23:00,138,53,85,6,28,teilweise bewölkt
1/8/2016 0:00,76,27,49,6,30,teilweise bewölkt
1/8/2016 1:00,35,14,21,5,32,teilweise bewölkt
1/8/2016 2:00,15,4,11,5,28,wolkig
1/8/2016 3:00,14,3,11,5,33,Klarer Himmel
1/8/2016 4:00,15,9,6,5,32,Klarer Himmel
1/8/2016 5:00,36,27,9,5,32,Klarer Himmel
1/8/2016 6:00,126,93,33,5,32,Klarer Himmel
1/8/2016 7:00,608,385,223,5,28,teilweise bewölkt
1/8/2016 8:00,869,460,409,4,28,teilweise bewölkt
1/8/2016 9:00,730,416,314,4,26,teilweise bewölkt
1/8/2016 10:00,730,471,259,5,28,teilweise bewölkt
1/8/2016 11:00,787,445,342,6,26,teilweise bewölkt
1/8/2016 12:00,801,455,346,7,24,teilweise bewölkt
1/8/2016 13:00,906,510,396,7,24,teilweise bewölkt
1/8/2016 14:00,903,454,449,8,19,teilweise bewölkt
1/8/2016 15:00,826,445,381,7,17,teilweise bewölkt
1/8/2016 16:00,781,397,384,7,13,wolkig
1/8/2016 17:00,776,399,377,7,15,wolkig
1/8/2016 18:00,698,369,329,6,13,teilweise bewölkt
1/8/2016 19:00,582,301,281,5,9,Klarer Himmel
1/8/2016 20:00,519,274,245,4,11,Klarer Himmel
1/8/2016 21:00,304,151,153,4,11,Klarer Himmel
1/8/2016 22:00,296,137,159,2,7,Klarer Himmel
1/8/2016 23:00,263,102,161,2,7,Klarer Himmel
1/9/2016 0:00,244,84,160,1,6,Klarer Himmel
1/9/2016 1:00,222,68,154,1,6,Klarer Himmel
1/9/2016 2:00,122,35,87,0,6,Klarer Himmel
1/9/2016 3:00,103,27,76,1,7,wolkig
1/9/2016 4:00,87,23,64,1,9,wolkig
1/9/2016 5:00,41,15,26,1,7,Schnee
1/9/2016 6:00,42,26,16,1,9,wolkig
1/9/2016 7:00,69,44,25,1,9,teilweise bewölkt
1/9/2016 8:00,171,107,64,1,9,teilweise bewölkt
1/9/2016 9:00,385,258,127,2,9,Klarer Himmel
1/9/2016 10:00,448,316,132,4,9,Klarer Himmel
1/9/2016 11:00,546,388,158,6,13,Klarer Himmel
1/9/2016 12:00,557,338,219,6,7,Klarer Himmel
1/9/2016 13:00,606,368,238,7,11,Klarer Himmel
1/9/2016 14:00,647,324,323,7,9,Klarer Himmel
1/9/2016 15:00,564,256,308,7,7,Klarer Himmel
1/9/2016 16:00,530,252,278,7,9,Klarer Himmel
1/9/2016 17:00,518,214,304,7,9,Klarer Himmel
1/9/2016 18:00,508,241,267,6,13,Klarer Himmel
1/9/2016 19:00,526,273,253,5,20,Klarer Himmel
1/9/2016 20:00,423,209,214,5,15,wolkig
1/9/2016 21:00,332,197,135,4,13,teilweise bewölkt
1/9/2016 22:00,271,120,151,3,13,teilweise bewölkt
1/9/2016 23:00,242,98,144,3,13,teilweise bewölkt
1/10/2016 0:00,263,116,147,2,9,Klarer Himmel
1/10/2016 1:00,207,98,109,3,15,teilweise bewölkt
1/10/2016 2:00,180,51,129,3,15,Klarer Himmel
1/10/2016 3:00,142,46,96,4,13,wolkig
1/10/2016 4:00,91,23,68,4,13,Regen
1/10/2016 5:00,45,6,39,5,13,wolkig
1/10/2016 6:00,35,14,21,5,13,wolkig
1/10/2016 7:00,26,18,8,6,9,Regen
1/10/2016 8:00,44,24,20,6,13,Regen
1/10/2016 9:00,168,136,32,6,15,wolkig
1/10/2016 10:00,259,190,69,7,19,wolkig
1/10/2016 11:00,262,157,105,8,22,teilweise bewölkt
1/10/2016 12:00,282,167,115,8,20,teilweise bewölkt
1/10/2016 13:00,345,195,150,9,22,teilweise bewölkt
1/10/2016 14:00,441,238,203,9,19,teilweise bewölkt
1/10/2016 15:00,462,240,222,8,17,teilweise bewölkt
1/10/2016 16:00,444,217,227,7,11,Klarer Himmel
1/10/2016 17:00,372,164,208,7,15,Klarer Himmel
1/10/2016 18:00,385,181,204,7,11,wolkig
1/10/2016 19:00,307,134,173,6,11,Regen
1/10/2016 20:00,238,78,160,5,6,wolkig
1/10/2016 21:00,136,50,86,5,7,wolkig
1/10/2016 22:00,167,53,114,5,9,wolkig
1/10/2016 23:00,129,41,88,5,13,wolkig
1/11/2016 0:00,43,17,26,5,9,wolkig
1/11/2016 1:00,27,8,19,5,11,wolkig
1/11/2016 2:00,12,3,9,6,9,wolkig
1/11/2016 3:00,5,5,0,6,11,wolkig
1/11/2016 4:00,8,8,0,4,6,wolkig
1/11/2016 5:00,48,36,12,3,9,teilweise bewölkt
1/11/2016 6:00,141,98,43,3,7,teilweise bewölkt
1/11/2016 7:00,666,446,220,3,7,teilweise bewölkt
1/11/2016 8:00,1088,646,442,3,7,Klarer Himmel
1/11/2016 9:00,918,516,402,3,9,Klarer Himmel
1/11/2016 10:00,866,527,339,3,9,Klarer Himmel
1/11/2016 11:00,938,424,514,4,7,wolkig
1/11/2016 12:00,910,463,447,5,9,Regen
1/11/2016 13:00,933,457,476,5,13,Regen
1/11/2016 14:00,714,375,339,5,7,Regen
1/11/2016 15:00,1043,557,486,5,9,Regen
1/11/2016 16:00,1052,550,502,5,7,Regen
1/11/2016 17:00,1247,602,645,5,9,wolkig
1/11/2016 18:00,993,520,473,5,6,wolkig
1/11/2016 19:00,888,406,482,5,7,Regen
1/11/2016 20:00,464,216,248,5,7,wolkig
1/11/2016 21:00,298,114,184,6,13,wolkig
1/11/2016 22:00,285,111,174,6,13,Regen
1/11/2016 23:00,157,51,106,6,11,Regen
1/12/2016 0:00,68,22,46,6,17,Regen
1/12/2016 1:00,43,10,33,6,17,Regen
1/12/2016 2:00,17,7,10,6,13,Regen
1/12/2016 3:00,8,3,5,6,15,wolkig
1/12/2016 4:00,14,9,5,6,15,wolkig
1/12/2016 5:00,35,23,12,5,20,wolkig
1/12/2016 6:00,134,92,42,5,20,wolkig
1/12/2016 7:00,678,412,266,6,22,wolkig
1/12/2016 8:00,1179,689,490,5,19,wolkig
1/12/2016 9:00,1017,504,513,6,20,wolkig
1/12/2016 10:00,962,596,366,6,19,wolkig
1/12/2016 11:00,1021,502,519,6,26,wolkig
1/12/2016 12:00,997,548,449,6,22,Regen
1/12/2016 13:00,1033,522,511,7,22,wolkig
1/12/2016 14:00,992,511,481,6,20,Regen
1/12/2016 15:00,1112,494,618,6,20,wolkig
1/12/2016 16:00,1110,578,532,7,17,wolkig
1/12/2016 17:00,1329,694,635,7,17,wolkig
1/12/2016 18:00,1089,535,554,6,17,wolkig
1/12/2016 19:00,1045,474,571,6,17,wolkig
1/12/2016 20:00,562,278,284,6,20,wolkig
1/12/2016 21:00,437,199,238,6,24,wolkig
1/12/2016 22:00,347,135,212,5,22,wolkig
1/12/2016 23:00,213,74,139,5,20,Regen
1/13/2016 0:00,90,37,53,4,20,Regen
1/13/2016 1:00,59,18,41,4,15,wolkig
1/13/2016 2:00,20,7,13,4,17,Regen
1/13/2016 3:00,4,4,0,4,17,Regen
1/13/2016 4:00,18,13,5,5,19,wolkig
1/13/2016 5:00,43,32,11,5,20,wolkig
1/13/2016 6:00,151,115,36,5,22,wolkig
1/13/2016 7:00,709,461,248,5,24,Regen
1/13/2016 8:00,1137,635,502,5,24,wolkig
1/13/2016 9:00,953,535,418,5,17,wolkig
1/13/2016 10:00,935,559,376,5,19,wolkig
1/13/2016 11:00,845,463,382,6,17,wolkig
1/13/2016 12:00,992,562,430,6,17,wolkig
1/13/2016 13:00,1011,540,471,6,13,wolkig
1/13/2016 14:00,958,532,426,6,19,wolkig
1/13/2016 15:00,1080,547,533,6,7,wolkig
1/13/2016 16:00,960,470,490,5,28,Regen
1/13/2016 17:00,1181,579,602,4,15,wolkig
1/13/2016 18:00,909,450,459,4,13,wolkig
1/13/2016 19:00,965,489,476,5,20,wolkig
1/13/2016 20:00,546,287,259,4,20,teilweise bewölkt
1/13/2016 21:00,374,144,230,3,17,teilweise bewölkt
1/13/2016 22:00,399,178,221,3,11,teilweise bewölkt
1/13/2016 23:00,247,102,145,3,11,teilweise bewölkt
1/14/2016 0:00,179,55,124,3,15,teilweise bewölkt
1/14/2016 1:00,107,38,69,2,13,teilweise bewölkt
1/14/2016 2:00,64,11,53,1,9,teilweise bewölkt
1/14/2016 3:00,44,15,29,1,9,wolkig
1/14/2016 4:00,33,12,21,1,9,teilweise bewölkt
1/14/2016 5:00,51,31,20,1,13,wolkig
1/14/2016 6:00,137,93,44,1,13,wolkig
1/14/2016 7:00,633,392,241,1,13,wolkig
1/14/2016 8:00,1005,575,430,2,17,Klarer Himmel
1/14/2016 9:00,925,565,360,2,19,Klarer Himmel
1/14/2016 10:00,846,526,320,4,22,wolkig
1/14/2016 11:00,943,487,456,4,22,Regen
1/14/2016 12:00,868,471,397,4,28,Regen
1/14/2016 13:00,906,462,444,4,20,Regen
1/14/2016 14:00,787,362,425,3,22,Regen
1/14/2016 15:00,864,414,450,2,19,Regen
1/14/2016 16:00,954,493,461,3,15,wolkig
1/14/2016 17:00,1051,578,473,3,15,wolkig
1/14/2016 18:00,903,490,413,3,15,teilweise bewölkt
1/14/2016 19:00,757,352,405,3,17,Regen
1/14/2016 20:00,529,234,295,2,17,wolkig
1/14/2016 21:00,343,170,173,3,17,Regen
1/14/2016 22:00,317,135,182,3,17,Regen
1/14/2016 23:00,217,66,151,3,15,Regen
1/15/2016 0:00,119,37,82,3,15,wolkig
1/15/2016 1:00,80,25,55,3,15,Regen
1/15/2016 2:00,31,8,23,2,15,Regen
1/15/2016 3:00,33,8,25,2,15,Schnee
1/15/2016 4:00,16,8,8,2,13,Schnee
1/15/2016 5:00,32,23,9,1,7,Schnee
1/15/2016 6:00,112,78,34,2,6,Schnee
1/15/2016 7:00,545,345,200,2,7,wolkig
1/15/2016 8:00,891,483,408,1,13,wolkig
1/15/2016 9:00,730,432,298,2,9,wolkig
1/15/2016 10:00,683,427,256,2,9,wolkig
1/15/2016 11:00,740,437,303,3,11,wolkig
1/15/2016 12:00,790,441,349,3,17,wolkig
1/15/2016 13:00,868,434,434,2,13,wolkig
1/15/2016 14:00,777,389,388,3,13,wolkig
1/15/2016 15:00,735,387,348,2,20,wolkig
1/15/2016 16:00,719,384,335,2,15,wolkig
1/15/2016 17:00,736,385,351,2,9,wolkig
1/15/2016 18:00,676,354,322,2,11,wolkig
1/15/2016 19:00,617,313,304,2,9,wolkig
1/15/2016 20:00,505,266,239,1,9,wolkig
1/15/2016 21:00,359,163,196,2,9,wolkig
1/15/2016 22:00,256,124,132,2,7,wolkig
1/15/2016 23:00,274,133,141,0,4,wolkig
1/16/2016 0:00,247,93,154,0,4,wolkig
1/16/2016 1:00,222,69,153,0,7,wolkig
1/16/2016 2:00,126,36,90,1,7,wolkig
1/16/2016 3:00,114,36,78,1,9,teilweise bewölkt
1/16/2016 4:00,63,14,49,1,9,teilweise bewölkt
1/16/2016 5:00,60,28,32,0,9,teilweise bewölkt
1/16/2016 6:00,40,28,12,0,13,wolkig
1/16/2016 7:00,98,82,16,1,20,Schnee
1/16/2016 8:00,174,122,52,1,20,Schnee
1/16/2016 9:00,327,222,105,2,22,Schnee
1/16/2016 10:00,306,219,87,2,20,Regen
1/16/2016 11:00,313,216,97,2,32,Regen
1/16/2016 12:00,356,234,122,1,26,Schnee
1/16/2016 13:00,355,196,159,1,30,wolkig
1/16/2016 14:00,435,213,222,2,24,wolkig
1/16/2016 15:00,375,200,175,1,17,Schnee
1/16/2016 16:00,375,206,169,1,13,Schnee
1/16/2016 17:00,340,131,209,1,11,teilweise bewölkt
1/16/2016 18:00,450,216,234,0,9,wolkig
1/16/2016 19:00,395,206,189,0,17,Schnee
1/16/2016 20:00,314,167,147,0,9,teilweise bewölkt
1/16/2016 21:00,270,136,134,-1,11,teilweise bewölkt
1/16/2016 22:00,198,84,114,0,17,Schnee
1/16/2016 23:00,198,88,110,0,17,teilweise bewölkt
1/17/2016 0:00,180,91,89,0,17,wolkig
1/17/2016 1:00,172,72,100,-1,13,wolkig
1/17/2016 2:00,113,35,78,-1,13,Klarer Himmel
1/17/2016 3:00,86,14,72,-1,17,wolkig
1/17/2016 4:00,72,21,51,0,13,wolkig
1/17/2016 5:00,48,11,37,-1,19,wolkig
1/17/2016 6:00,32,15,17,-1,15,wolkig
1/17/2016 7:00,24,18,6,-1,13,wolkig
1/17/2016 8:00,39,16,23,-1,13,wolkig
1/17/2016 9:00,131,108,23,-1,9,wolkig
1/17/2016 10:00,178,124,54,0,7,wolkig
1/17/2016 11:00,231,112,119,0,11,wolkig
1/17/2016 12:00,250,124,126,0,11,wolkig
1/17/2016 13:00,340,174,166,0,11,wolkig
1/17/2016 14:00,312,173,139,0,9,Schnee
1/17/2016 15:00,353,188,165,0,11,wolkig
1/17/2016 16:00,328,182,146,-1,9,teilweise bewölkt
1/17/2016 17:00,365,220,145,-2,2,teilweise bewölkt
1/17/2016 18:00,345,171,174,-3,2,Klarer Himmel
1/17/2016 19:00,307,124,183,-4,4,Klarer Himmel
1/17/2016 20:00,255,93,162,-5,2,Klarer Himmel
1/17/2016 21:00,126,59,67,-5,4,Nebel
1/17/2016 22:00,157,55,102,-6,2,Nebel
1/17/2016 23:00,100,40,60,-7,2,Klarer Himmel
1/18/2016 0:00,28,9,19,-6,2,Nebel
1/18/2016 1:00,17,9,8,-7,0,Klarer Himmel
1/18/2016 2:00,6,4,2,-7,0,Klarer Himmel
1/18/2016 3:00,7,6,1,-7,2,
1/18/2016 4:00,15,10,5,-7,6,Klarer Himmel
1/18/2016 5:00,42,26,16,-7,2,
1/18/2016 6:00,136,97,39,-7,2,
1/18/2016 7:00,548,392,156,-7,4,
1/18/2016 8:00,917,526,391,-6,6,Nebel
1/18/2016 9:00,754,433,321,-5,6,Nebel
1/18/2016 10:00,749,408,341,-4,6,
1/18/2016 11:00,709,334,375,-3,6,
1/18/2016 12:00,795,434,361,-2,7,Klarer Himmel
1/18/2016 13:00,952,495,457,-1,7,teilweise bewölkt
1/18/2016 14:00,947,522,425,-1,9,teilweise bewölkt
1/18/2016 15:00,1049,532,517,-1,6,Klarer Himmel
1/18/2016 16:00,1109,593,516,-2,6,Klarer Himmel
1/18/2016 17:00,1277,599,678,-3,6,Klarer Himmel
1/18/2016 18:00,1031,501,530,-3,4,Klarer Himmel
1/18/2016 19:00,884,414,470,-3,4,Klarer Himmel
1/18/2016 20:00,513,207,306,-4,7,Klarer Himmel
1/18/2016 21:00,335,132,203,-4,9,Klarer Himmel
1/18/2016 22:00,284,83,201,-5,6,Klarer Himmel
1/18/2016 23:00,193,60,133,-5,4,Klarer Himmel
1/19/2016 0:00,77,20,57,-5,6,Klarer Himmel
1/19/2016 1:00,35,7,28,-6,9,Klarer Himmel
1/19/2016 2:00,11,5,6,-7,4,Klarer Himmel
1/19/2016 3:00,12,10,2,-8,2,Klarer Himmel
1/19/2016 4:00,10,7,3,-8,2,Klarer Himmel
1/19/2016 5:00,41,26,15,-7,4,Klarer Himmel
1/19/2016 6:00,123,86,37,-8,4,Klarer Himmel
1/19/2016 7:00,626,362,264,-8,7,Klarer Himmel
1/19/2016 8:00,1056,626,430,-8,6,Klarer Himmel
1/19/2016 9:00,842,430,412,-7,6,Klarer Himmel
1/19/2016 10:00,842,490,352,-4,6,Klarer Himmel
1/19/2016 11:00,797,412,385,-3,13,Klarer Himmel
1/19/2016 12:00,954,560,394,-2,13,Klarer Himmel
1/19/2016 13:00,908,437,471,-1,13,Klarer Himmel
1/19/2016 14:00,900,474,426,-1,11,Klarer Himmel
1/19/2016 15:00,1080,523,557,-1,11,
1/19/2016 16:00,1067,559,508,-1,11,wolkig
1/19/2016 17:00,1182,576,606,-1,9,wolkig
1/19/2016 18:00,1030,516,514,-2,17,Schnee
1/19/2016 19:00,858,439,419,-2,9,Schnee
1/19/2016 20:00,545,223,322,-2,15,Schnee
1/19/2016 21:00,366,159,207,-1,11,wolkig
1/19/2016 22:00,329,117,212,-1,9,wolkig
1/19/2016 23:00,220,50,170,-1,13,Klarer Himmel
1/20/2016 0:00,102,38,64,-1,9,wolkig
1/20/2016 1:00,39,7,32,-1,9,wolkig
1/20/2016 2:00,12,4,8,-1,9,wolkig
1/20/2016 3:00,6,3,3,-1,9,Schnee
1/20/2016 4:00,28,19,9,-1,13,wolkig
1/20/2016 5:00,47,29,18,-1,13,wolkig
1/20/2016 6:00,138,108,30,0,13,wolkig
1/20/2016 7:00,671,449,222,-1,13,Schnee
1/20/2016 8:00,1027,588,439,0,15,wolkig
1/20/2016 9:00,814,429,385,0,17,wolkig
1/20/2016 10:00,783,456,327,1,17,wolkig
1/20/2016 11:00,775,408,367,1,15,Schnee
1/20/2016 12:00,834,456,378,2,19,wolkig
1/20/2016 13:00,903,461,442,3,15,wolkig
1/20/2016 14:00,826,431,395,2,15,wolkig
1/20/2016 15:00,898,452,446,2,11,wolkig
1/20/2016 16:00,990,523,467,2,11,wolkig
1/20/2016 17:00,1146,547,599,1,9,wolkig
1/20/2016 18:00,1036,487,549,1,6,wolkig
1/20/2016 19:00,879,433,446,1,6,wolkig
1/20/2016 20:00,544,265,279,1,4,wolkig
1/20/2016 21:00,384,156,228,1,4,wolkig
1/20/2016 22:00,456,257,199,1,4,wolkig
1/20/2016 23:00,311,151,160,1,4,wolkig
1/21/2016 0:00,165,81,84,0,4,wolkig
1/21/2016 1:00,95,45,50,-2,2,teilweise bewölkt
1/21/2016 2:00,79,25,54,-3,4,Nebel
1/21/2016 3:00,47,14,33,-4,2,Nebel
1/21/2016 4:00,49,17,32,-5,4,Nebel
1/21/2016 5:00,51,27,24,-4,4,Nebel
1/21/2016 6:00,128,86,42,-4,2,Nebel
1/21/2016 7:00,553,337,216,-3,4,wolkig
1/21/2016 8:00,967,530,437,-3,2,Nebel
1/21/2016 9:00,828,486,342,-3,4,wolkig
1/21/2016 10:00,755,446,309,-2,4,teilweise bewölkt
1/21/2016 11:00,884,458,426,-2,6,Nebel
1/21/2016 12:00,876,457,419,-3,7,Nebel
1/21/2016 13:00,898,456,442,-3,7,Nebel
1/21/2016 14:00,783,381,402,-3,6,Nebel
1/21/2016 15:00,924,475,449,-3,6,Nebel
1/21/2016 16:00,967,547,420,-2,4,Nebel
1/21/2016 17:00,1073,566,507,-2,7,Nebel
1/21/2016 18:00,939,497,442,-3,6,Nebel
1/21/2016 19:00,749,369,380,-3,6,Nebel
1/21/2016 20:00,514,216,298,-4,6,Nebel
1/21/2016 21:00,366,164,202,-5,4,wolkig
1/21/2016 22:00,275,112,163,-5,4,Nebel
1/21/2016 23:00,230,74,156,-6,2,
1/22/2016 0:00,103,38,65,-6,6,
1/22/2016 1:00,78,25,53,-6,6,
1/22/2016 2:00,38,6,32,-6,6,
1/22/2016 3:00,18,7,11,-6,6,
1/22/2016 4:00,25,11,14,-6,6,
1/22/2016 5:00,46,22,24,-6,7,
1/22/2016 6:00,131,92,39,-6,7,
1/22/2016 7:00,572,352,220,-6,7,
1/22/2016 8:00,821,438,383,-6,9,
1/22/2016 9:00,650,413,237,-5,9,
1/22/2016 10:00,691,440,251,-3,9,
1/22/2016 11:00,655,371,284,-2,11,
1/22/2016 12:00,776,447,329,-1,15,Klarer Himmel
1/22/2016 13:00,852,430,422,0,15,Klarer Himmel
1/22/2016 14:00,761,409,352,1,13,Klarer Himmel
1/22/2016 15:00,819,461,358,1,11,Klarer Himmel
1/22/2016 16:00,732,394,338,0,9,Klarer Himmel
1/22/2016 17:00,741,374,367,0,13,Klarer Himmel
1/22/2016 18:00,632,289,343,0,13,Klarer Himmel
1/22/2016 19:00,622,355,267,1,13,Klarer Himmel
1/22/2016 20:00,456,221,235,0,11,Klarer Himmel
1/22/2016 21:00,281,131,150,0,9,Regen
1/22/2016 22:00,274,86,188,0,11,Regen
1/22/2016 23:00,246,101,145,0,9,Regen
1/23/2016 0:00,239,71,168,1,9,Regen
1/23/2016 1:00,160,56,104,2,9,Regen
1/23/2016 2:00,127,41,86,3,11,Regen
1/23/2016 3:00,63,20,43,3,20,wolkig
1/23/2016 4:00,38,17,21,4,19,Regen
1/23/2016 5:00,26,17,9,4,17,wolkig
1/23/2016 6:00,38,21,17,5,9,wolkig
1/23/2016 7:00,52,40,12,5,13,wolkig
1/23/2016 8:00,190,127,63,5,15,wolkig
1/23/2016 9:00,353,272,81,6,22,wolkig
1/23/2016 10:00,427,287,140,6,15,wolkig
1/23/2016 11:00,460,310,150,6,15,wolkig
1/23/2016 12:00,501,329,172,7,17,wolkig
1/23/2016 13:00,534,308,226,7,24,wolkig
1/23/2016 14:00,509,288,221,6,17,wolkig
1/23/2016 15:00,477,241,236,6,17,wolkig
1/23/2016 16:00,380,164,216,6,11,wolkig
1/23/2016 17:00,381,148,233,6,13,Regen
1/23/2016 18:00,458,223,235,6,13,Regen
1/23/2016 19:00,395,183,212,6,13,wolkig
1/23/2016 20:00,375,225,150,6,11,wolkig
1/23/2016 21:00,295,191,104,6,9,wolkig
1/23/2016 22:00,210,105,105,6,11,wolkig
1/23/2016 23:00,236,92,144,6,9,wolkig
1/24/2016 0:00,218,89,129,5,7,wolkig
1/24/2016 1:00,199,62,137,5,9,wolkig
1/24/2016 2:00,148,43,105,5,6,
1/24/2016 3:00,99,24,75,4,6,Klarer Himmel
1/24/2016 4:00,74,26,48,4,7,Klarer Himmel
1/24/2016 5:00,48,11,37,5,9,Klarer Himmel
1/24/2016 6:00,30,14,16,4,9,Klarer Himmel
1/24/2016 7:00,34,23,11,4,7,wolkig
1/24/2016 8:00,66,41,25,4,7,Klarer Himmel
1/24/2016 9:00,212,178,34,4,11,Regen
1/24/2016 10:00,273,197,76,6,13,wolkig
1/24/2016 11:00,197,114,83,6,13,wolkig
1/24/2016 12:00,256,133,123,7,15,wolkig
1/24/2016 13:00,267,132,135,6,13,wolkig
1/24/2016 14:00,282,154,128,7,15,Regen
1/24/2016 15:00,279,143,136,7,13,Regen
1/24/2016 16:00,297,157,140,7,11,Regen
1/24/2016 17:00,268,108,160,7,7,Regen
1/24/2016 18:00,311,139,172,7,9,Regen
1/24/2016 19:00,285,102,183,7,9,Regen
1/24/2016 20:00,186,69,117,8,11,Regen
1/24/2016 21:00,165,71,94,8,13,wolkig
1/24/2016 22:00,182,52,130,9,17,wolkig
1/24/2016 23:00,92,39,53,9,15,wolkig
1/25/2016 0:00,60,23,37,9,15,wolkig
1/25/2016 1:00,25,11,14,9,15,wolkig
1/25/2016 2:00,6,4,2,9,15,wolkig
1/25/2016 3:00,7,4,3,9,15,wolkig
1/25/2016 4:00,16,13,3,9,15,wolkig
1/25/2016 5:00,45,37,8,9,11,wolkig
1/25/2016 6:00,144,105,39,9,11,wolkig
1/25/2016 7:00,644,442,202,9,6,wolkig
1/25/2016 8:00,1016,631,385,9,4,wolkig
1/25/2016 9:00,824,468,356,10,6,wolkig
1/25/2016 10:00,792,432,360,10,9,wolkig
1/25/2016 11:00,823,372,451,12,13,wolkig
1/25/2016 12:00,812,404,408,13,15,wolkig
1/25/2016 13:00,1000,517,483,13,19,wolkig
1/25/2016 14:00,917,457,460,13,17,wolkig
1/25/2016 15:00,1156,646,510,13,17,Klarer Himmel
1/25/2016 16:00,1206,668,538,12,13,Klarer Himmel
1/25/2016 17:00,1370,649,721,11,13,Klarer Himmel
1/25/2016 18:00,1062,485,577,10,11,Klarer Himmel
1/25/2016 19:00,895,393,502,8,9,Klarer Himmel
1/25/2016 20:00,571,224,347,9,9,Klarer Himmel
1/25/2016 21:00,374,169,205,11,15,Klarer Himmel
1/25/2016 22:00,352,133,219,11,24,wolkig
1/25/2016 23:00,154,64,90,11,17,wolkig
1/26/2016 0:00,90,24,66,11,17,wolkig
1/26/2016 1:00,34,9,25,11,20,wolkig
1/26/2016 2:00,19,5,14,11,20,wolkig
1/26/2016 3:00,15,6,9,10,20,wolkig
1/26/2016 4:00,16,8,8,10,20,wolkig
1/26/2016 5:00,58,38,20,10,20,wolkig
1/26/2016 6:00,160,108,52,9,17,wolkig
1/26/2016 7:00,796,495,301,9,13,teilweise bewölkt
1/26/2016 8:00,1084,659,425,9,11,Klarer Himmel
1/26/2016 9:00,990,552,438,9,7,wolkig
1/26/2016 10:00,957,549,408,10,15,wolkig
1/26/2016 11:00,1034,503,531,10,20,wolkig
1/26/2016 12:00,1001,527,474,11,19,wolkig
1/26/2016 13:00,940,446,494,10,17,Regen
1/26/2016 14:00,756,292,464,11,19,wolkig
1/26/2016 15:00,1058,546,512,11,26,wolkig
1/26/2016 16:00,1116,610,506,11,26,wolkig
1/26/2016 17:00,1230,631,599,11,22,wolkig
1/26/2016 18:00,1075,502,573,10,28,Klarer Himmel
1/26/2016 19:00,964,502,462,10,30,wolkig
1/26/2016 20:00,513,219,294,9,30,Regen
1/26/2016 21:00,441,149,292,9,28,Regen
1/26/2016 22:00,368,124,244,9,32,Regen
1/26/2016 23:00,210,74,136,9,33,Regen
1/27/2016 0:00,85,29,56,9,32,Regen
1/27/2016 1:00,55,13,42,9,28,wolkig
1/27/2016 2:00,17,6,11,10,24,wolkig
1/27/2016 3:00,5,3,2,10,28,wolkig
1/27/2016 4:00,16,13,3,10,30,wolkig
1/27/2016 5:00,46,32,14,10,32,wolkig
1/27/2016 6:00,136,106,30,11,33,wolkig
1/27/2016 7:00,659,420,239,11,30,wolkig
1/27/2016 8:00,1108,651,457,11,30,wolkig
1/27/2016 9:00,900,495,405,11,28,wolkig
1/27/2016 10:00,758,442,316,10,32,Regen
1/27/2016 11:00,697,365,332,10,26,Regen
1/27/2016 12:00,832,459,373,10,30,wolkig
1/27/2016 13:00,826,445,381,11,28,wolkig
1/27/2016 14:00,809,422,387,11,28,wolkig
1/27/2016 15:00,860,419,441,12,26,wolkig
1/27/2016 16:00,890,437,453,12,26,wolkig
1/27/2016 17:00,1145,594,551,12,32,wolkig
1/27/2016 18:00,933,405,528,12,28,wolkig
1/27/2016 19:00,784,416,368,11,26,wolkig
1/27/2016 20:00,593,262,331,10,24,Regen
1/27/2016 21:00,366,168,198,10,28,Regen
1/27/2016 22:00,393,144,249,10,28,Regen
1/27/2016 23:00,234,112,122,10,26,Regen
1/28/2016 0:00,162,53,109,10,26,Regen
1/28/2016 1:00,97,21,76,10,26,Regen
1/28/2016 2:00,51,18,33,8,24,Regen
1/28/2016 3:00,39,8,31,8,22,Regen
1/28/2016 4:00,33,7,26,7,19,wolkig
1/28/2016 5:00,51,33,18,7,22,wolkig
1/28/2016 6:00,124,94,30,7,20,wolkig
1/28/2016 7:00,645,401,244,6,19,teilweise bewölkt
1/28/2016 8:00,940,557,383,5,17,teilweise bewölkt
1/28/2016 9:00,847,487,360,6,19,teilweise bewölkt
1/28/2016 10:00,893,565,328,7,28,teilweise bewölkt
1/28/2016 11:00,890,437,453,7,30,teilweise bewölkt
1/28/2016 12:00,905,469,436,8,24,teilweise bewölkt
1/28/2016 13:00,1049,499,550,8,26,teilweise bewölkt
1/28/2016 14:00,963,480,483,8,22,teilweise bewölkt
1/28/2016 15:00,1083,583,500,8,20,teilweise bewölkt
1/28/2016 16:00,1067,553,514,7,17,teilweise bewölkt
1/28/2016 17:00,1160,590,570,6,13,Klarer Himmel
1/28/2016 18:00,997,484,513,5,11,Klarer Himmel
1/28/2016 19:00,858,361,497,5,13,Klarer Himmel
1/28/2016 20:00,514,245,269,5,15,Klarer Himmel
1/28/2016 21:00,379,190,189,4,13,Klarer Himmel
1/28/2016 22:00,374,154,220,4,11,Klarer Himmel
1/28/2016 23:00,242,91,151,4,15,Klarer Himmel
1/29/2016 0:00,148,52,96,4,13,Klarer Himmel
1/29/2016 1:00,63,16,47,4,17,Klarer Himmel
1/29/2016 2:00,35,17,18,4,20,Klarer Himmel
1/29/2016 3:00,16,7,9,5,20,Klarer Himmel
1/29/2016 4:00,21,15,6,5,28,wolkig
1/29/2016 5:00,39,28,11,5,22,wolkig
1/29/2016 6:00,112,87,25,6,24,wolkig
1/29/2016 7:00,576,376,200,6,28,wolkig
1/29/2016 8:00,892,507,385,6,26,wolkig
1/29/2016 9:00,748,475,273,7,28,wolkig
1/29/2016 10:00,788,464,324,7,30,wolkig
1/29/2016 11:00,781,415,366,8,33,wolkig
1/29/2016 12:00,819,435,384,8,32,wolkig
1/29/2016 13:00,812,387,425,9,33,wolkig
1/29/2016 14:00,744,376,368,9,32,wolkig
1/29/2016 15:00,733,396,337,9,39,wolkig
1/29/2016 16:00,691,359,332,9,33,wolkig
1/29/2016 17:00,688,348,340,9,33,wolkig
1/29/2016 18:00,696,330,366,9,33,wolkig
1/29/2016 19:00,511,258,253,9,30,wolkig
1/29/2016 20:00,485,230,255,8,32,wolkig
1/29/2016 21:00,308,144,164,9,32,Regen
1/29/2016 22:00,262,122,140,9,30,wolkig
1/29/2016 23:00,250,96,154,9,33,Regen
1/30/2016 0:00,210,93,117,9,32,Regen
1/30/2016 1:00,192,81,111,9,35,Regen
1/30/2016 2:00,135,40,95,9,35,wolkig
1/30/2016 3:00,85,24,61,9,41,wolkig
1/30/2016 4:00,53,18,35,8,32,Regen
1/30/2016 5:00,39,13,26,8,28,Regen
1/30/2016 6:00,22,14,8,8,32,Regen
1/30/2016 7:00,76,58,18,8,37,Regen
1/30/2016 8:00,151,96,55,9,33,Regen
1/30/2016 9:00,262,203,59,9,33,Regen
1/30/2016 10:00,218,149,69,9,33,Regen
1/30/2016 11:00,215,142,73,8,33,Regen
1/30/2016 12:00,223,137,86,8,24,Regen
1/30/2016 13:00,205,112,93,7,17,Regen
1/30/2016 14:00,247,99,148,7,32,Regen
1/30/2016 15:00,223,111,112,7,19,Regen
1/30/2016 16:00,192,81,111,6,19,wolkig
1/30/2016 17:00,258,114,144,6,20,wolkig
1/30/2016 18:00,283,120,163,5,20,wolkig
1/30/2016 19:00,352,187,165,4,22,teilweise bewölkt
1/30/2016 20:00,310,173,137,4,19,Klarer Himmel
1/30/2016 21:00,212,118,94,4,22,teilweise bewölkt
1/30/2016 22:00,173,54,119,4,22,Klarer Himmel
1/30/2016 23:00,144,53,91,4,30,teilweise bewölkt
1/31/2016 0:00,217,96,121,3,22,teilweise bewölkt
1/31/2016 1:00,145,62,83,3,22,teilweise bewölkt
1/31/2016 2:00,119,34,85,3,24,Klarer Himmel
1/31/2016 3:00,65,18,47,3,24,Klarer Himmel
1/31/2016 4:00,51,26,25,3,24,Klarer Himmel
1/31/2016 5:00,38,19,19,3,28,teilweise bewölkt
1/31/2016 6:00,22,15,7,3,22,Klarer Himmel
1/31/2016 7:00,29,16,13,3,22,Klarer Himmel
1/31/2016 8:00,65,38,27,3,26,Klarer Himmel
1/31/2016 9:00,182,148,34,4,22,Klarer Himmel
1/31/2016 10:00,260,204,56,4,22,Klarer Himmel
1/31/2016 11:00,225,136,89,5,24,Klarer Himmel
1/31/2016 12:00,253,165,88,6,24,wolkig
1/31/2016 13:00,296,155,141,5,20,wolkig
1/31/2016 14:00,338,175,163,6,20,Regen
1/31/2016 15:00,227,129,98,5,15,Regen
1/31/2016 16:00,293,146,147,5,11,Regen
1/31/2016 17:00,340,159,181,5,9,Regen
1/31/2016 18:00,249,104,145,5,9,Regen
1/31/2016 19:00,292,130,162,5,9,Regen
1/31/2016 20:00,204,65,139,6,7,Regen
1/31/2016 21:00,165,64,101,6,9,wolkig
1/31/2016 22:00,148,49,99,8,22,wolkig
1/31/2016 23:00,77,25,52,9,19,Regen
2/1/2016 0:00,38,13,25,9,20,wolkig
2/1/2016 1:00,25,14,11,9,13,Regen
2/1/2016 2:00,9,6,3,9,15,wolkig
2/1/2016 3:00,8,3,5,10,17,Regen
2/1/2016 4:00,17,13,4,10,20,Regen
2/1/2016 5:00,38,24,14,11,28,Regen
2/1/2016 6:00,115,83,32,11,28,wolkig
2/1/2016 7:00,544,384,160,11,26,Regen
2/1/2016 8:00,883,576,307,11,33,Regen
2/1/2016 9:00,749,454,295,11,28,Regen
2/1/2016 10:00,615,344,271,11,32,Regen
2/1/2016 11:00,683,308,375,11,30,Regen
2/1/2016 12:00,643,339,304,11,39,wolkig
2/1/2016 13:00,825,424,401,11,37,wolkig
2/1/2016 14:00,723,374,349,11,44,wolkig
2/1/2016 15:00,938,459,479,12,39,wolkig
2/1/2016 16:00,961,503,458,11,35,wolkig
2/1/2016 17:00,1126,542,584,11,33,Regen
2/1/2016 18:00,854,375,479,11,30,wolkig
2/1/2016 19:00,707,308,399,11,33,wolkig
2/1/2016 20:00,459,186,273,11,32,wolkig
2/1/2016 21:00,362,154,208,11,37,wolkig
2/1/2016 22:00,241,88,153,11,37,Regen
2/1/2016 23:00,162,49,113,12,35,wolkig
2/2/2016 0:00,78,26,52,10,37,Regen
2/2/2016 1:00,34,11,23,11,33,Regen
2/2/2016 2:00,23,3,20,11,32,wolkig
2/2/2016 3:00,7,4,3,10,33,wolkig
2/2/2016 4:00,19,11,8,10,43,teilweise bewölkt
2/2/2016 5:00,37,23,14,10,26,wolkig
2/2/2016 6:00,132,83,49,10,33,wolkig
2/2/2016 7:00,599,397,202,9,33,wolkig
2/2/2016 8:00,954,565,389,10,41,wolkig
2/2/2016 9:00,874,533,341,10,32,wolkig
2/2/2016 10:00,828,488,340,10,33,wolkig
2/2/2016 11:00,839,445,394,10,35,Regen
2/2/2016 12:00,908,531,377,8,50,Regen
2/2/2016 13:00,775,356,419,7,39,Regen
2/2/2016 14:00,748,365,383,8,32,Regen
2/2/2016 15:00,813,399,414,6,24,Regen
2/2/2016 16:00,860,423,437,7,20,teilweise bewölkt
2/2/2016 17:00,1070,536,534,7,28,wolkig
2/2/2016 18:00,868,430,438,7,28,wolkig
2/2/2016 19:00,810,385,425,7,37,teilweise bewölkt
2/2/2016 20:00,488,201,287,7,33,teilweise bewölkt
2/2/2016 21:00,384,153,231,7,33,wolkig
2/2/2016 22:00,319,109,210,7,33,Klarer Himmel
2/2/2016 23:00,199,73,126,7,30,Klarer Himmel
2/3/2016 0:00,73,30,43,6,30,teilweise bewölkt
2/3/2016 1:00,55,16,39,6,28,Klarer Himmel
2/3/2016 2:00,35,8,27,5,24,Klarer Himmel
2/3/2016 3:00,13,3,10,5,22,teilweise bewölkt
2/3/2016 4:00,17,14,3,4,20,teilweise bewölkt
2/3/2016 5:00,41,24,17,4,22,wolkig
2/3/2016 6:00,158,114,44,4,20,teilweise bewölkt
2/3/2016 7:00,691,490,201,4,17,teilweise bewölkt
2/3/2016 8:00,1004,627,377,4,15,teilweise bewölkt
2/3/2016 9:00,928,635,293,4,26,wolkig
2/3/2016 10:00,932,578,354,5,28,wolkig
2/3/2016 11:00,977,534,443,6,32,wolkig
2/3/2016 12:00,922,489,433,7,33,teilweise bewölkt
2/3/2016 13:00,946,459,487,7,32,teilweise bewölkt
2/3/2016 14:00,904,464,440,6,24,teilweise bewölkt
2/3/2016 15:00,939,434,505,5,30,teilweise bewölkt
2/3/2016 16:00,1016,526,490,4,24,wolkig
2/3/2016 17:00,1183,561,622,4,28,wolkig
2/3/2016 18:00,966,452,514,5,26,wolkig
2/3/2016 19:00,935,431,504,4,26,wolkig
2/3/2016 20:00,600,234,366,4,26,wolkig
2/3/2016 21:00,449,130,319,3,17,teilweise bewölkt
2/3/2016 22:00,477,201,276,3,17,teilweise bewölkt
2/3/2016 23:00,328,137,191,2,19,teilweise bewölkt
2/4/2016 0:00,196,91,105,3,19,teilweise bewölkt
2/4/2016 1:00,159,89,70,3,15,teilweise bewölkt
2/4/2016 2:00,110,82,28,2,19,teilweise bewölkt
2/4/2016 3:00,62,41,21,3,19,wolkig
2/4/2016 4:00,40,31,9,3,15,Klarer Himmel
2/4/2016 5:00,57,40,17,3,19,wolkig
2/4/2016 6:00,135,88,47,3,19,wolkig
2/4/2016 7:00,648,437,211,3,17,wolkig
2/4/2016 8:00,867,574,293,4,17,Regen
2/4/2016 9:00,732,474,258,3,19,Regen
2/4/2016 10:00,612,363,249,3,15,Regen
2/4/2016 11:00,683,378,305,4,15,Regen
2/4/2016 12:00,653,344,309,4,19,Regen
2/4/2016 13:00,613,318,295,3,13,Regen
2/4/2016 14:00,633,307,326,3,9,Regen
2/4/2016 15:00,749,387,362,3,6,Regen
2/4/2016 16:00,846,467,379,4,4,wolkig
2/4/2016 17:00,949,509,440,3,6,wolkig
2/4/2016 18:00,819,439,380,3,9,wolkig
2/4/2016 19:00,701,344,357,3,11,wolkig
2/4/2016 20:00,490,224,266,3,11,wolkig
2/4/2016 21:00,376,175,201,4,11,wolkig
2/4/2016 22:00,302,132,170,4,11,wolkig
2/4/2016 23:00,250,90,160,4,11,wolkig
2/5/2016 0:00,121,34,87,4,7,wolkig
2/5/2016 1:00,94,38,56,4,11,wolkig
2/5/2016 2:00,32,4,28,4,7,wolkig
2/5/2016 3:00,41,6,35,4,9,wolkig
2/5/2016 4:00,35,15,20,4,11,wolkig
2/5/2016 5:00,39,25,14,4,11,Regen
2/5/2016 6:00,112,70,42,4,11,Regen
2/5/2016 7:00,554,376,178,4,15,Regen
2/5/2016 8:00,744,499,245,4,13,Regen
2/5/2016 9:00,606,400,206,5,13,wolkig
2/5/2016 10:00,540,298,242,6,15,Regen
2/5/2016 11:00,550,299,251,6,13,wolkig
2/5/2016 12:00,605,327,278,8,17,wolkig
2/5/2016 13:00,762,403,359,8,15,wolkig
2/5/2016 14:00,716,371,345,10,15,wolkig
2/5/2016 15:00,717,358,359,10,15,wolkig
2/5/2016 16:00,666,342,324,10,15,wolkig
2/5/2016 17:00,684,330,354,9,15,wolkig
2/5/2016 18:00,631,302,329,10,17,wolkig
2/5/2016 19:00,548,275,273,9,13,wolkig
2/5/2016 20:00,493,233,260,9,13,Regen
2/5/2016 21:00,362,159,203,9,15,wolkig
2/5/2016 22:00,297,122,175,9,11,Regen
2/5/2016 23:00,315,153,162,9,13,wolkig
2/6/2016 0:00,193,80,113,10,15,wolkig
2/6/2016 1:00,152,54,98,9,13,wolkig
2/6/2016 2:00,105,61,44,10,15,wolkig
2/6/2016 3:00,84,45,39,9,11,wolkig
2/6/2016 4:00,64,31,33,9,13,wolkig
2/6/2016 5:00,61,27,34,8,11,teilweise bewölkt
2/6/2016 6:00,37,22,15,8,9,wolkig
2/6/2016 7:00,94,58,36,7,11,wolkig
2/6/2016 8:00,217,161,56,8,19,wolkig
2/6/2016 9:00,391,299,92,8,17,wolkig
2/6/2016 10:00,346,236,110,9,19,wolkig
2/6/2016 11:00,503,312,191,9,19,wolkig
2/6/2016 12:00,499,297,202,10,15,wolkig
2/6/2016 13:00,536,286,250,10,24,wolkig
2/6/2016 14:00,546,273,273,10,17,wolkig
2/6/2016 15:00,453,160,293,11,15,wolkig
2/6/2016 16:00,477,232,245,11,19,wolkig
2/6/2016 17:00,735,442,293,10,13,Klarer Himmel
2/6/2016 18:00,438,190,248,9,13,Klarer Himmel
2/6/2016 19:00,515,273,242,9,15,Klarer Himmel
2/6/2016 20:00,404,234,170,9,17,Klarer Himmel
2/6/2016 21:00,201,122,79,8,11,Klarer Himmel
2/6/2016 22:00,212,112,100,9,11,Klarer Himmel
2/6/2016 23:00,218,99,119,8,15,Klarer Himmel
2/7/2016 0:00,208,82,126,8,17,Klarer Himmel
2/7/2016 1:00,131,35,96,8,17,Klarer Himmel
2/7/2016 2:00,133,31,102,9,15,Klarer Himmel
2/7/2016 3:00,82,16,66,9,19,Klarer Himmel
2/7/2016 4:00,72,22,50,9,17,Klarer Himmel
2/7/2016 5:00,34,9,25,10,19,Klarer Himmel
2/7/2016 6:00,28,13,15,10,20,Klarer Himmel
2/7/2016 7:00,36,20,16,10,20,Regen
2/7/2016 8:00,60,40,20,11,20,wolkig
2/7/2016 9:00,281,226,55,11,24,Regen
2/7/2016 10:00,252,185,67,9,19,wolkig
2/7/2016 11:00,206,131,75,10,22,wolkig
2/7/2016 12:00,269,140,129,10,32,wolkig
2/7/2016 13:00,329,132,197,10,28,wolkig
2/7/2016 14:00,371,172,199,10,28,wolkig
2/7/2016 15:00,363,175,188,9,22,wolkig
2/7/2016 16:00,367,182,185,9,24,wolkig
2/7/2016 17:00,439,233,206,9,22,teilweise bewölkt
2/7/2016 18:00,395,202,193,8,24,teilweise bewölkt
2/7/2016 19:00,360,147,213,8,24,Klarer Himmel
2/7/2016 20:00,262,92,170,8,20,Klarer Himmel
2/7/2016 21:00,174,78,96,7,20,Klarer Himmel
2/7/2016 22:00,167,83,84,7,22,Klarer Himmel
2/7/2016 23:00,117,57,60,7,26,Klarer Himmel
2/8/2016 0:00,60,19,41,6,24,Klarer Himmel
2/8/2016 1:00,35,21,14,7,26,Klarer Himmel
2/8/2016 2:00,38,16,22,7,26,teilweise bewölkt
2/8/2016 3:00,20,8,12,8,28,wolkig
2/8/2016 4:00,126,76,50,8,32,wolkig
2/8/2016 5:00,52,24,28,8,33,Regen
2/8/2016 6:00,49,30,19,8,35,Regen
2/8/2016 7:00,90,53,37,7,28,Regen
2/8/2016 8:00,154,86,68,8,30,wolkig
2/8/2016 9:00,153,90,63,9,26,wolkig
2/8/2016 10:00,189,107,82,9,24,Regen
2/8/2016 11:00,244,145,99,10,39,Regen
2/8/2016 12:00,294,159,135,10,35,wolkig
2/8/2016 13:00,267,150,117,9,39,Regen
2/8/2016 14:00,275,163,112,9,33,wolkig
2/8/2016 15:00,280,153,127,9,39,wolkig
2/8/2016 16:00,280,133,147,9,39,wolkig
2/8/2016 17:00,292,148,144,9,37,wolkig
2/8/2016 18:00,252,120,132,8,39,Regen
2/8/2016 19:00,173,65,108,7,39,Regen
2/8/2016 20:00,181,68,113,7,43,Regen
2/8/2016 21:00,103,37,66,8,46,Regen
2/8/2016 22:00,118,38,80,7,41,Regen
2/8/2016 23:00,77,23,54,7,43,Regen
2/9/2016 0:00,46,15,31,7,43,Regen
2/9/2016 1:00,23,10,13,7,41,Regen
2/9/2016 2:00,15,4,11,7,35,wolkig
2/9/2016 3:00,5,3,2,7,39,wolkig
2/9/2016 4:00,13,10,3,6,32,Regen
2/9/2016 5:00,34,23,11,7,30,teilweise bewölkt
2/9/2016 6:00,100,69,31,7,32,wolkig
2/9/2016 7:00,479,322,157,7,30,
2/9/2016 8:00,685,430,255,6,24,Regen
2/9/2016 9:00,701,419,282,7,15,wolkig
2/9/2016 10:00,607,385,222,7,19,wolkig
2/9/2016 11:00,725,410,315,8,17,wolkig
2/9/2016 12:00,688,352,336,8,13,wolkig
2/9/2016 13:00,552,259,293,6,19,Regen
2/9/2016 14:00,443,229,214,4,13,Regen
2/9/2016 15:00,480,240,240,5,11,Regen
2/9/2016 16:00,588,300,288,5,11,Regen
2/9/2016 17:00,684,323,361,6,13,wolkig
2/9/2016 18:00,615,293,322,8,33,Regen
2/9/2016 19:00,528,225,303,1,37,Schnee
2/9/2016 20:00,338,167,171,0,32,Schnee
2/9/2016 21:00,236,100,136,1,22,Schnee
2/9/2016 22:00,216,69,147,2,26,teilweise bewölkt
2/9/2016 23:00,112,44,68,3,22,wolkig
2/10/2016 0:00,76,23,53,4,24,teilweise bewölkt
2/10/2016 1:00,24,6,18,4,24,teilweise bewölkt
2/10/2016 2:00,23,8,15,3,19,teilweise bewölkt
2/10/2016 3:00,11,6,5,4,22,wolkig
2/10/2016 4:00,11,8,3,4,20,wolkig
2/10/2016 5:00,31,20,11,4,17,wolkig
2/10/2016 6:00,101,74,27,1,19,Schnee
2/10/2016 7:00,511,361,150,1,15,Schnee
2/10/2016 8:00,788,511,277,2,11,wolkig
2/10/2016 9:00,707,432,275,3,17,wolkig
2/10/2016 10:00,705,437,268,4,17,wolkig
2/10/2016 11:00,621,338,283,4,17,Regen
2/10/2016 12:00,706,364,342,5,20,wolkig
2/10/2016 13:00,665,315,350,5,24,wolkig
2/10/2016 14:00,612,311,301,6,24,wolkig
2/10/2016 15:00,825,490,335,6,17,wolkig
2/10/2016 16:00,860,476,384,6,19,Regen
2/10/2016 17:00,823,437,386,5,19,Regen
2/10/2016 18:00,682,352,330,5,20,Regen
2/10/2016 19:00,778,371,407,5,20,wolkig
2/10/2016 20:00,494,256,238,5,20,wolkig
2/10/2016 21:00,291,107,184,5,26,wolkig
2/10/2016 22:00,372,152,220,4,20,wolkig
2/10/2016 23:00,213,95,118,3,20,teilweise bewölkt
2/11/2016 0:00,126,49,77,4,20,teilweise bewölkt
2/11/2016 1:00,99,27,72,4,20,wolkig
2/11/2016 2:00,41,5,36,4,19,Klarer Himmel
2/11/2016 3:00,45,9,36,4,17,Klarer Himmel
2/11/2016 4:00,28,11,17,3,17,wolkig
2/11/2016 5:00,44,29,15,3,17,wolkig
2/11/2016 6:00,136,92,44,3,20,wolkig
2/11/2016 7:00,706,488,218,3,17,wolkig
2/11/2016 8:00,844,512,332,4,17,teilweise bewölkt
2/11/2016 9:00,749,512,237,4,17,teilweise bewölkt
2/11/2016 10:00,736,439,297,5,20,teilweise bewölkt
2/11/2016 11:00,704,409,295,6,19,teilweise bewölkt
2/11/2016 12:00,691,394,297,6,26,teilweise bewölkt
2/11/2016 13:00,915,514,401,6,28,teilweise bewölkt
2/11/2016 14:00,915,473,442,7,24,teilweise bewölkt
2/11/2016 15:00,857,409,448,7,24,teilweise bewölkt
2/11/2016 16:00,904,456,448,6,15,teilweise bewölkt
2/11/2016 17:00,971,474,497,6,9,wolkig
2/11/2016 18:00,850,407,443,4,7,wolkig
2/11/2016 19:00,798,369,429,4,7,wolkig
2/11/2016 20:00,499,236,263,4,7,wolkig
2/11/2016 21:00,311,138,173,3,6,wolkig
2/11/2016 22:00,322,145,177,2,4,wolkig
2/11/2016 23:00,236,79,157,4,6,wolkig
2/12/2016 0:00,126,30,96,3,4,wolkig
2/12/2016 1:00,84,32,52,3,7,wolkig
2/12/2016 2:00,22,12,10,1,4,teilweise bewölkt
2/12/2016 3:00,27,9,18,2,6,wolkig
2/12/2016 4:00,35,9,26,2,6,Nebel
2/12/2016 5:00,45,27,18,1,4,wolkig
2/12/2016 6:00,128,95,33,1,4,wolkig
2/12/2016 7:00,644,438,206,1,4,Nebel
2/12/2016 8:00,757,500,257,2,6,wolkig
2/12/2016 9:00,697,465,232,2,6,wolkig
2/12/2016 10:00,652,408,244,3,6,wolkig
2/12/2016 11:00,653,331,322,4,15,wolkig
2/12/2016 12:00,733,374,359,5,9,wolkig
2/12/2016 13:00,987,562,425,6,11,wolkig
2/12/2016 14:00,711,327,384,6,11,wolkig
2/12/2016 15:00,894,465,429,6,7,wolkig
2/12/2016 16:00,789,423,366,5,6,teilweise bewölkt
2/12/2016 17:00,837,437,400,4,6,wolkig
2/12/2016 18:00,683,327,356,3,6,teilweise bewölkt
2/12/2016 19:00,649,368,281,2,7,teilweise bewölkt
2/12/2016 20:00,519,289,230,1,6,Klarer Himmel
2/12/2016 21:00,388,197,191,1,7,Klarer Himmel
2/12/2016 22:00,288,136,152,0,6,Klarer Himmel
2/12/2016 23:00,362,140,222,0,6,Klarer Himmel
2/13/2016 0:00,278,116,162,0,7,Klarer Himmel
2/13/2016 1:00,165,52,113,-1,4,Klarer Himmel
2/13/2016 2:00,112,29,83,-2,4,Klarer Himmel
2/13/2016 3:00,90,10,80,-1,6,Klarer Himmel
2/13/2016 4:00,72,11,61,-2,4,Klarer Himmel
2/13/2016 5:00,72,23,49,-2,6,Nebel
2/13/2016 6:00,60,30,30,-2,6,Nebel
2/13/2016 7:00,104,80,24,-2,6,Klarer Himmel
2/13/2016 8:00,252,189,63,-1,7,Klarer Himmel
2/13/2016 9:00,397,315,82,1,9,Klarer Himmel
2/13/2016 10:00,457,346,111,4,7,Klarer Himmel
2/13/2016 11:00,554,378,176,4,11,Klarer Himmel
2/13/2016 12:00,567,360,207,5,9,Klarer Himmel
2/13/2016 13:00,618,340,278,7,13,Klarer Himmel
2/13/2016 14:00,627,319,308,7,15,Klarer Himmel
2/13/2016 15:00,487,229,258,6,13,Klarer Himmel
2/13/2016 16:00,507,217,290,6,9,Klarer Himmel
2/13/2016 17:00,459,201,258,5,7,Klarer Himmel
2/13/2016 18:00,503,206,297,5,6,wolkig
2/13/2016 19:00,417,190,227,5,9,wolkig
2/13/2016 20:00,376,203,173,4,9,wolkig
2/13/2016 21:00,228,112,116,4,9,Regen
2/13/2016 22:00,214,93,121,4,9,Regen
2/13/2016 23:00,184,84,100,3,9,Schnee
2/14/2016 0:00,190,91,99,3,9,Schnee
2/14/2016 1:00,157,70,87,2,11,Schnee
2/14/2016 2:00,150,41,109,2,13,Schnee
2/14/2016 3:00,101,23,78,2,15,Schnee
2/14/2016 4:00,64,17,47,2,15,Schnee
2/14/2016 5:00,46,14,32,1,11,Schnee
2/14/2016 6:00,32,9,23,2,9,Schnee
2/14/2016 7:00,31,24,7,2,13,Schnee
2/14/2016 8:00,48,31,17,2,13,Schnee
2/14/2016 9:00,221,187,34,2,17,Schnee
2/14/2016 10:00,231,178,53,2,15,Schnee
2/14/2016 11:00,144,91,53,2,17,Schnee
2/14/2016 12:00,185,97,88,2,13,Schnee
2/14/2016 13:00,218,116,102,2,13,Regen
2/14/2016 14:00,234,122,112,2,6,Schnee
2/14/2016 15:00,196,88,108,1,7,Regen
2/14/2016 16:00,191,94,97,0,4,Schnee
2/14/2016 17:00,244,114,130,0,6,Schnee
2/14/2016 18:00,245,115,130,0,6,Schnee
2/14/2016 19:00,209,83,126,0,6,Schnee
2/14/2016 20:00,178,58,120,0,6,Schnee
2/14/2016 21:00,134,47,87,1,7,Schnee
2/14/2016 22:00,82,30,52,0,11,Schnee
2/14/2016 23:00,67,20,47,1,11,Schnee
2/15/2016 0:00,33,14,19,1,9,Schnee
2/15/2016 1:00,17,4,13,1,9,Schnee
2/15/2016 2:00,6,4,2,1,17,Schnee
2/15/2016 3:00,1,1,0,1,17,Schnee
2/15/2016 4:00,11,7,4,1,17,Schnee
2/15/2016 5:00,33,21,12,1,17,Schnee
2/15/2016 6:00,97,69,28,0,19,Schnee
2/15/2016 7:00,492,355,137,0,19,Schnee
2/15/2016 8:00,569,348,221,1,19,Schnee
2/15/2016 9:00,429,245,184,1,19,Schnee
2/15/2016 10:00,311,174,137,1,22,wolkig
2/15/2016 11:00,361,199,162,1,20,wolkig
2/15/2016 12:00,424,225,199,1,19,wolkig
2/15/2016 13:00,460,232,228,1,22,wolkig
2/15/2016 14:00,520,299,221,1,22,wolkig
2/15/2016 15:00,554,317,237,1,20,wolkig
2/15/2016 16:00,652,364,288,1,15,wolkig
2/15/2016 17:00,744,351,393,0,7,teilweise bewölkt
2/15/2016 18:00,678,315,363,0,15,teilweise bewölkt
2/15/2016 19:00,511,242,269,0,11,wolkig
2/15/2016 20:00,345,132,213,-1,6,teilweise bewölkt
2/15/2016 21:00,278,90,188,-2,2,wolkig
2/15/2016 22:00,175,53,122,-2,4,wolkig
2/15/2016 23:00,136,31,105,-3,2,wolkig
2/16/2016 0:00,100,22,78,-3,6,wolkig
2/16/2016 1:00,46,10,36,-2,2,wolkig
2/16/2016 2:00,29,14,15,-3,4,teilweise bewölkt
2/16/2016 3:00,21,7,14,-3,2,wolkig
2/16/2016 4:00,14,9,5,-5,2,Nebel
2/16/2016 5:00,43,27,16,-5,2,Nebel
2/16/2016 6:00,133,96,37,-5,2,Nebel
2/16/2016 7:00,606,413,193,-6,2,Nebel
2/16/2016 8:00,716,452,264,-4,2,Nebel
2/16/2016 9:00,678,408,270,-2,2,
2/16/2016 10:00,514,346,168,1,2,Klarer Himmel
2/16/2016 11:00,493,283,210,2,4,teilweise bewölkt
2/16/2016 12:00,595,316,279,2,9,teilweise bewölkt
2/16/2016 13:00,670,319,351,4,4,teilweise bewölkt
2/16/2016 14:00,766,447,319,3,7,Klarer Himmel
2/16/2016 15:00,651,344,307,3,6,Klarer Himmel
2/16/2016 16:00,826,392,434,2,7,Klarer Himmel
2/16/2016 17:00,957,443,514,1,6,
2/16/2016 18:00,780,371,409,0,6,Klarer Himmel
2/16/2016 19:00,667,313,354,-1,6,Klarer Himmel
2/16/2016 20:00,460,217,243,-1,6,Klarer Himmel
2/16/2016 21:00,319,113,206,-2,6,Klarer Himmel
2/16/2016 22:00,269,95,174,-2,9,Klarer Himmel
2/16/2016 23:00,185,61,124,-2,7,Klarer Himmel
2/17/2016 0:00,79,20,59,-2,6,Klarer Himmel
2/17/2016 1:00,55,12,43,-3,4,Klarer Himmel
2/17/2016 2:00,42,6,36,-3,4,Klarer Himmel
2/17/2016 3:00,21,6,15,-4,6,Klarer Himmel
2/17/2016 4:00,12,8,4,-4,11,Klarer Himmel
2/17/2016 5:00,40,34,6,-3,7,Klarer Himmel
2/17/2016 6:00,140,97,43,-3,11,Klarer Himmel
2/17/2016 7:00,643,464,179,-3,4,Klarer Himmel
2/17/2016 8:00,706,441,265,-2,7,Klarer Himmel
2/17/2016 9:00,609,398,211,0,9,Klarer Himmel
2/17/2016 10:00,541,323,218,1,13,Klarer Himmel
2/17/2016 11:00,595,356,239,2,15,teilweise bewölkt
2/17/2016 12:00,651,351,300,3,11,teilweise bewölkt
2/17/2016 13:00,692,337,355,2,9,wolkig
2/17/2016 14:00,749,404,345,3,9,teilweise bewölkt
2/17/2016 15:00,643,304,339,3,11,wolkig
2/17/2016 16:00,800,395,405,2,9,teilweise bewölkt
2/17/2016 17:00,840,418,422,1,4,teilweise bewölkt
2/17/2016 18:00,833,381,452,-1,2,teilweise bewölkt
2/17/2016 19:00,702,349,353,-2,4,teilweise bewölkt
2/17/2016 20:00,441,201,240,-3,0,Klarer Himmel
2/17/2016 21:00,290,108,182,-3,0,Nebel
2/17/2016 22:00,332,142,190,-4,0,Nebel
2/17/2016 23:00,218,87,131,-3,4,Nebel
2/18/2016 0:00,159,80,79,-4,0,Nebel
2/18/2016 1:00,112,21,91,-2,6,
2/18/2016 2:00,56,8,48,-2,2,wolkig
2/18/2016 3:00,36,9,27,-1,4,wolkig
2/18/2016 4:00,42,16,26,-1,4,wolkig
2/18/2016 5:00,49,30,19,-1,2,wolkig
2/18/2016 6:00,134,93,41,0,7,Schnee
2/18/2016 7:00,615,456,159,0,7,Schnee
2/18/2016 8:00,771,504,267,1,9,Schnee
2/18/2016 9:00,619,407,212,1,7,wolkig
2/18/2016 10:00,456,277,179,2,6,wolkig
2/18/2016 11:00,498,255,243,3,15,Klarer Himmel
2/18/2016 12:00,516,286,230,4,11,wolkig
2/18/2016 13:00,627,347,280,4,17,wolkig
2/18/2016 14:00,666,356,310,5,19,wolkig
2/18/2016 15:00,654,356,298,5,11,wolkig
2/18/2016 16:00,764,407,357,4,9,wolkig
2/18/2016 17:00,839,399,440,2,2,Klarer Himmel
2/18/2016 18:00,825,382,443,0,2,Klarer Himmel
2/18/2016 19:00,599,292,307,0,4,wolkig
2/18/2016 20:00,380,167,213,0,4,wolkig
2/18/2016 21:00,301,120,181,0,2,wolkig
2/18/2016 22:00,268,78,190,0,6,wolkig
2/18/2016 23:00,224,73,151,0,2,wolkig
2/19/2016 0:00,82,29,53,0,2,Klarer Himmel
2/19/2016 1:00,76,37,39,0,2,wolkig
2/19/2016 2:00,29,12,17,0,2,wolkig
2/19/2016 3:00,17,6,11,0,6,Klarer Himmel
2/19/2016 4:00,26,10,16,0,2,Klarer Himmel
2/19/2016 5:00,45,29,16,0,2,wolkig
2/19/2016 6:00,127,87,40,0,4,wolkig
2/19/2016 7:00,597,433,164,1,4,Schnee
2/19/2016 8:00,680,428,252,1,6,Schnee
2/19/2016 9:00,584,380,204,2,9,
2/19/2016 10:00,497,329,168,2,9,wolkig
2/19/2016 11:00,441,268,173,3,11,wolkig
2/19/2016 12:00,609,325,284,3,19,Regen
2/19/2016 13:00,671,314,357,3,13,Regen
2/19/2016 14:00,659,339,320,3,9,wolkig
2/19/2016 15:00,617,342,275,3,13,wolkig
2/19/2016 16:00,639,335,304,3,9,wolkig
2/19/2016 17:00,632,325,307,3,7,wolkig
2/19/2016 18:00,633,326,307,1,6,
2/19/2016 19:00,550,307,243,2,11,
2/19/2016 20:00,438,221,217,1,13,
2/19/2016 21:00,282,167,115,1,13,
2/19/2016 22:00,281,110,171,1,13,Klarer Himmel
2/19/2016 23:00,285,125,160,2,15,Klarer Himmel
2/20/2016 0:00,201,70,131,2,17,Klarer Himmel
2/20/2016 1:00,202,74,128,3,20,Klarer Himmel
2/20/2016 2:00,145,38,107,4,20,Klarer Himmel
2/20/2016 3:00,111,25,86,4,22,Regen
2/20/2016 4:00,71,16,55,4,26,Regen
2/20/2016 5:00,64,22,42,5,30,wolkig
2/20/2016 6:00,52,25,27,4,26,Regen
2/20/2016 7:00,94,44,50,4,24,Regen
2/20/2016 8:00,213,162,51,5,24,Regen
2/20/2016 9:00,218,176,42,5,22,Regen
2/20/2016 10:00,218,156,62,6,20,Regen
2/20/2016 11:00,344,217,127,7,24,Regen
2/20/2016 12:00,279,161,118,8,22,wolkig
2/20/2016 13:00,289,136,153,8,22,wolkig
2/20/2016 14:00,297,156,141,9,28,wolkig
2/20/2016 15:00,287,157,130,9,24,wolkig
2/20/2016 16:00,262,133,129,9,24,Regen
2/20/2016 17:00,269,133,136,8,30,Regen
2/20/2016 18:00,253,112,141,7,19,Regen
2/20/2016 19:00,330,150,180,8,20,wolkig
2/20/2016 20:00,274,139,135,7,15,Regen
2/20/2016 21:00,176,97,79,9,28,Regen
2/20/2016 22:00,167,78,89,9,30,Regen
2/20/2016 23:00,130,55,75,10,35,Regen
2/21/2016 0:00,134,68,66,10,39,Regen
2/21/2016 1:00,134,53,81,10,30,Regen
2/21/2016 2:00,107,34,73,8,26,Regen
2/21/2016 3:00,98,15,83,8,24,Regen
2/21/2016 4:00,62,15,47,8,24,Regen
2/21/2016 5:00,38,8,30,8,20,wolkig
2/21/2016 6:00,20,8,12,8,28,wolkig
2/21/2016 7:00,24,14,10,8,19,Regen
2/21/2016 8:00,41,21,20,8,17,Regen
2/21/2016 9:00,100,79,21,8,11,Regen
2/21/2016 10:00,139,101,38,8,11,Regen
2/21/2016 11:00,124,86,38,11,30,Regen
2/21/2016 12:00,134,80,54,11,32,Regen
2/21/2016 13:00,146,82,64,11,37,Regen
2/21/2016 14:00,171,94,77,11,37,Regen
2/21/2016 15:00,156,67,89,11,37,Regen
2/21/2016 16:00,201,102,99,11,30,Regen
2/21/2016 17:00,193,85,108,12,39,wolkig
2/21/2016 18:00,202,99,103,12,35,Regen
2/21/2016 19:00,179,56,123,12,41,Regen
2/21/2016 20:00,159,49,110,11,33,Regen
2/21/2016 21:00,89,34,55,12,44,Regen
2/21/2016 22:00,92,44,48,11,44,Regen
2/21/2016 23:00,69,29,40,11,41,Regen
2/22/2016 0:00,28,12,16,11,43,Regen
2/22/2016 1:00,16,5,11,11,43,wolkig
2/22/2016 2:00,4,1,3,10,39,Regen
2/22/2016 3:00,4,4,0,10,41,Regen
2/22/2016 4:00,12,10,2,10,28,Regen
2/22/2016 5:00,37,21,16,10,26,Regen
2/22/2016 6:00,110,78,32,9,30,Regen
2/22/2016 7:00,398,283,115,9,20,Regen
2/22/2016 8:00,591,375,216,7,7,Regen
2/22/2016 9:00,440,289,151,7,11,Regen
2/22/2016 10:00,282,150,132,6,17,Regen
2/22/2016 11:00,317,166,151,6,13,Regen
2/22/2016 12:00,354,170,184,6,13,Regen
2/22/2016 13:00,354,169,185,6,17,Regen
2/22/2016 14:00,312,161,151,5,19,Regen
2/22/2016 15:00,388,191,197,5,26,Regen
2/22/2016 16:00,486,236,250,5,15,wolkig
2/22/2016 17:00,686,344,342,5,15,Regen
2/22/2016 18:00,583,271,312,5,17,Regen
2/22/2016 19:00,467,220,247,5,17,Regen
2/22/2016 20:00,341,159,182,4,19,wolkig
2/22/2016 21:00,217,82,135,4,15,wolkig
2/22/2016 22:00,189,69,120,4,17,wolkig
2/22/2016 23:00,117,34,83,4,15,wolkig
2/23/2016 0:00,51,13,38,4,15,wolkig
2/23/2016 1:00,37,7,30,4,15,wolkig
2/23/2016 2:00,22,6,16,4,15,wolkig
2/23/2016 3:00,6,5,1,4,15,wolkig
2/23/2016 4:00,16,11,5,4,9,wolkig
2/23/2016 5:00,49,30,19,3,11,wolkig
2/23/2016 6:00,146,110,36,3,11,wolkig
2/23/2016 7:00,580,415,165,3,11,teilweise bewölkt
2/23/2016 8:00,715,473,242,4,7,teilweise bewölkt
2/23/2016 9:00,640,438,202,5,19,teilweise bewölkt
2/23/2016 10:00,429,261,168,6,17,teilweise bewölkt
2/23/2016 11:00,486,287,199,6,20,teilweise bewölkt
2/23/2016 12:00,597,312,285,8,20,teilweise bewölkt
2/23/2016 13:00,584,301,283,8,22,wolkig
2/23/2016 14:00,585,326,259,7,19,Regen
2/23/2016 15:00,672,334,338,6,13,wolkig
2/23/2016 16:00,724,327,397,6,20,teilweise bewölkt
2/23/2016 17:00,892,436,456,5,17,teilweise bewölkt
2/23/2016 18:00,795,420,375,4,17,teilweise bewölkt
2/23/2016 19:00,635,328,307,4,17,wolkig
2/23/2016 20:00,484,207,277,4,15,wolkig
2/23/2016 21:00,308,130,178,3,15,teilweise bewölkt
2/23/2016 22:00,377,141,236,2,13,teilweise bewölkt
2/23/2016 23:00,172,66,106,2,15,teilweise bewölkt
2/24/2016 0:00,97,36,61,1,13,Klarer Himmel
2/24/2016 1:00,58,12,46,1,13,Klarer Himmel
2/24/2016 2:00,28,6,22,1,13,Klarer Himmel
2/24/2016 3:00,8,3,5,1,9,teilweise bewölkt
2/24/2016 4:00,15,11,4,1,13,teilweise bewölkt
2/24/2016 5:00,42,28,14,0,7,wolkig
2/24/2016 6:00,149,108,41,0,9,
2/24/2016 7:00,609,435,174,0,9,Nebel
2/24/2016 8:00,824,551,273,1,9,
2/24/2016 9:00,621,394,227,3,13,Klarer Himmel
2/24/2016 10:00,567,375,192,4,17,teilweise bewölkt
2/24/2016 11:00,499,305,194,5,19,teilweise bewölkt
2/24/2016 12:00,653,356,297,7,19,teilweise bewölkt
2/24/2016 13:00,688,329,359,7,19,teilweise bewölkt
2/24/2016 14:00,604,291,313,5,15,Klarer Himmel
2/24/2016 15:00,620,320,300,6,20,Klarer Himmel
2/24/2016 16:00,771,392,379,5,9,Klarer Himmel
2/24/2016 17:00,956,469,487,4,9,Klarer Himmel
2/24/2016 18:00,849,418,431,3,6,Klarer Himmel
2/24/2016 19:00,701,388,313,4,6,wolkig
2/24/2016 20:00,477,228,249,2,6,wolkig
2/24/2016 21:00,379,163,216,2,7,wolkig
2/24/2016 22:00,340,138,202,2,7,Klarer Himmel
2/24/2016 23:00,245,109,136,1,6,Klarer Himmel
2/25/2016 0:00,120,64,56,0,7,Klarer Himmel
2/25/2016 1:00,110,42,68,0,7,Klarer Himmel
2/25/2016 2:00,61,12,49,0,9,Klarer Himmel
2/25/2016 3:00,37,4,33,-1,4,Klarer Himmel
2/25/2016 4:00,49,15,34,-2,4,Nebel
2/25/2016 5:00,58,36,22,-2,4,Nebel
2/25/2016 6:00,146,98,48,-1,9,Nebel
2/25/2016 7:00,597,419,178,-1,7,Nebel
2/25/2016 8:00,714,442,272,0,9,teilweise bewölkt
2/25/2016 9:00,664,405,259,2,15,teilweise bewölkt
2/25/2016 10:00,446,266,180,3,17,teilweise bewölkt
2/25/2016 11:00,473,271,202,5,22,teilweise bewölkt
2/25/2016 12:00,559,302,257,5,24,teilweise bewölkt
2/25/2016 13:00,631,326,305,4,26,teilweise bewölkt
2/25/2016 14:00,669,342,327,6,19,teilweise bewölkt
2/25/2016 15:00,686,351,335,4,19,Regen
2/25/2016 16:00,678,350,328,3,19,teilweise bewölkt
2/25/2016 17:00,789,420,369,2,13,Regen
2/25/2016 18:00,773,357,416,2,15,teilweise bewölkt
2/25/2016 19:00,607,313,294,1,11,Klarer Himmel
2/25/2016 20:00,413,194,219,1,11,Klarer Himmel
2/25/2016 21:00,345,152,193,0,9,Klarer Himmel
2/25/2016 22:00,275,87,188,0,7,teilweise bewölkt
2/25/2016 23:00,210,62,148,0,9,wolkig
2/26/2016 0:00,98,31,67,0,9,teilweise bewölkt
2/26/2016 1:00,45,10,35,0,9,Nebel
2/26/2016 2:00,23,6,17,-1,9,Nebel
2/26/2016 3:00,23,4,19,-1,7,Nebel
2/26/2016 4:00,20,14,6,-1,7,teilweise bewölkt
2/26/2016 5:00,40,30,10,-1,9,Nebel
2/26/2016 6:00,137,97,40,-1,9,wolkig
2/26/2016 7:00,510,365,145,-1,9,wolkig
2/26/2016 8:00,670,433,237,-1,7,wolkig
2/26/2016 9:00,500,334,166,0,6,wolkig
2/26/2016 10:00,431,274,157,0,7,wolkig
2/26/2016 11:00,437,238,199,1,9,wolkig
2/26/2016 12:00,654,392,262,2,7,wolkig
2/26/2016 13:00,572,271,301,3,7,teilweise bewölkt
2/26/2016 14:00,600,287,313,4,4,teilweise bewölkt
2/26/2016 15:00,648,322,326,4,2,wolkig
2/26/2016 16:00,614,352,262,4,4,wolkig
2/26/2016 17:00,627,333,294,3,6,Klarer Himmel
2/26/2016 18:00,538,259,279,2,4,Klarer Himmel
2/26/2016 19:00,472,248,224,1,4,Klarer Himmel
2/26/2016 20:00,347,180,167,1,4,Klarer Himmel
2/26/2016 21:00,305,150,155,1,4,Klarer Himmel
2/26/2016 22:00,267,100,167,1,4,Klarer Himmel
2/26/2016 23:00,237,90,147,0,6,wolkig
2/27/2016 0:00,176,86,90,-1,4,
2/27/2016 1:00,136,60,76,-1,4,
2/27/2016 2:00,105,27,78,0,4,Klarer Himmel
2/27/2016 3:00,92,28,64,-1,6,Klarer Himmel
2/27/2016 4:00,62,16,46,-1,6,Klarer Himmel
2/27/2016 5:00,38,13,25,-1,6,Klarer Himmel
2/27/2016 6:00,37,19,18,-1,4,Klarer Himmel
2/27/2016 7:00,91,58,33,-2,6,Klarer Himmel
2/27/2016 8:00,190,127,63,0,7,Klarer Himmel
2/27/2016 9:00,297,229,68,2,11,Klarer Himmel
2/27/2016 10:00,467,359,108,4,13,Klarer Himmel
2/27/2016 11:00,495,317,178,4,17,Klarer Himmel
2/27/2016 12:00,523,345,178,5,22,teilweise bewölkt
2/27/2016 13:00,536,312,224,6,22,teilweise bewölkt
2/27/2016 14:00,545,264,281,5,22,teilweise bewölkt
2/27/2016 15:00,464,247,217,5,20,teilweise bewölkt
2/27/2016 16:00,467,203,264,5,15,teilweise bewölkt
2/27/2016 17:00,478,189,289,4,15,teilweise bewölkt
2/27/2016 18:00,464,178,286,1,9,Klarer Himmel
2/27/2016 19:00,408,227,181,0,9,Klarer Himmel
2/27/2016 20:00,332,164,168,0,11,Klarer Himmel
2/27/2016 21:00,309,192,117,1,13,Klarer Himmel
2/27/2016 22:00,197,82,115,0,11,Klarer Himmel
2/27/2016 23:00,207,73,134,0,15,Klarer Himmel
2/28/2016 0:00,170,53,117,0,11,Klarer Himmel
2/28/2016 1:00,177,59,118,-2,9,Klarer Himmel
2/28/2016 2:00,146,55,91,-2,11,Klarer Himmel
2/28/2016 3:00,75,19,56,-2,9,Klarer Himmel
2/28/2016 4:00,45,12,33,-3,9,Klarer Himmel
2/28/2016 5:00,36,8,28,-3,11,Klarer Himmel
2/28/2016 6:00,27,8,19,-3,7,Klarer Himmel
2/28/2016 7:00,46,30,16,-2,9,Klarer Himmel
2/28/2016 8:00,68,34,34,0,13,Klarer Himmel
2/28/2016 9:00,167,129,38,1,17,Klarer Himmel
2/28/2016 10:00,253,181,72,3,20,Klarer Himmel
2/28/2016 11:00,244,151,93,4,20,Klarer Himmel
2/28/2016 12:00,254,136,118,5,28,Klarer Himmel
2/28/2016 13:00,308,169,139,6,19,teilweise bewölkt
2/28/2016 14:00,388,231,157,6,20,Klarer Himmel
2/28/2016 15:00,348,193,155,5,26,Klarer Himmel
2/28/2016 16:00,320,147,173,5,17,Klarer Himmel
2/28/2016 17:00,369,162,207,4,17,Klarer Himmel
2/28/2016 18:00,278,146,132,3,17,Klarer Himmel
2/28/2016 19:00,272,122,150,2,7,Klarer Himmel
2/28/2016 20:00,178,67,111,-1,7,Klarer Himmel
2/28/2016 21:00,149,58,91,1,15,Klarer Himmel
2/28/2016 22:00,98,49,49,0,7,Klarer Himmel
2/28/2016 23:00,106,22,84,-1,9,Klarer Himmel
2/29/2016 0:00,33,4,29,0,13,Klarer Himmel
2/29/2016 1:00,22,6,16,-1,11,Klarer Himmel
2/29/2016 2:00,11,5,6,-1,15,Klarer Himmel
2/29/2016 3:00,5,3,2,-2,11,Klarer Himmel
2/29/2016 4:00,17,15,2,-2,9,Klarer Himmel
2/29/2016 5:00,42,28,14,-2,11,Klarer Himmel
2/29/2016 6:00,136,100,36,-2,13,Klarer Himmel
2/29/2016 7:00,598,413,185,-2,13,Klarer Himmel
2/29/2016 8:00,712,482,230,0,15,Klarer Himmel
2/29/2016 9:00,637,378,259,1,19,Klarer Himmel
2/29/2016 10:00,506,316,190,3,19,Klarer Himmel
2/29/2016 11:00,430,229,201,4,20,Klarer Himmel
2/29/2016 12:00,611,325,286,4,22,Klarer Himmel
2/29/2016 13:00,625,316,309,5,19,teilweise bewölkt
2/29/2016 14:00,581,304,277,5,19,Klarer Himmel
2/29/2016 15:00,697,334,363,5,20,Klarer Himmel
2/29/2016 16:00,796,418,378,4,20,teilweise bewölkt
2/29/2016 17:00,938,456,482,2,17,Klarer Himmel
2/29/2016 18:00,765,345,420,1,13,Klarer Himmel
2/29/2016 19:00,636,329,307,0,11,Klarer Himmel
2/29/2016 20:00,382,167,215,0,13,Klarer Himmel
2/29/2016 21:00,268,112,156,-1,7,Klarer Himmel
2/29/2016 22:00,268,75,193,-2,4,Klarer Himmel
2/29/2016 23:00,151,42,109,-3,2,
3/1/2016 0:00,93,20,73,-3,0,
3/1/2016 1:00,45,7,38,-4,4,
3/1/2016 2:00,9,3,6,-5,2,
3/1/2016 3:00,10,5,5,-5,2,Nebel
3/1/2016 4:00,18,14,4,-5,2,Nebel
3/1/2016 5:00,34,21,13,-6,2,Nebel
3/1/2016 6:00,151,115,36,-5,0,Nebel
3/1/2016 7:00,604,426,178,-5,4,Nebel
3/1/2016 8:00,745,480,265,-3,6,
3/1/2016 9:00,597,393,204,-1,9,
3/1/2016 10:00,464,276,188,1,13,
3/1/2016 11:00,490,266,224,2,13,Klarer Himmel
3/1/2016 12:00,622,325,297,3,17,Klarer Himmel
3/1/2016 13:00,621,322,299,4,20,wolkig
3/1/2016 14:00,580,289,291,4,17,wolkig
3/1/2016 15:00,627,284,343,4,20,Regen
3/1/2016 16:00,655,323,332,3,20,Regen
3/1/2016 17:00,788,388,400,2,17,Regen
3/1/2016 18:00,669,318,351,2,17,Regen
3/1/2016 19:00,537,271,266,3,20,Regen
3/1/2016 20:00,363,167,196,3,19,Regen
3/1/2016 21:00,246,85,161,3,20,Regen
3/1/2016 22:00,223,76,147,4,22,wolkig
3/1/2016 23:00,123,37,86,5,24,wolkig
3/2/2016 0:00,77,18,59,5,20,wolkig
3/2/2016 1:00,60,17,43,5,17,wolkig
3/2/2016 2:00,29,12,17,5,15,Regen
3/2/2016 3:00,13,3,10,6,20,Regen
3/2/2016 4:00,14,12,2,6,19,Regen
3/2/2016 5:00,55,32,23,7,20,wolkig
3/2/2016 6:00,139,109,30,7,24,wolkig
3/2/2016 7:00,599,452,147,7,22,wolkig
3/2/2016 8:00,689,447,242,7,28,wolkig
3/2/2016 9:00,551,372,179,7,20,Regen
3/2/2016 10:00,298,188,110,4,28,Regen
3/2/2016 11:00,308,172,136,5,28,wolkig
3/2/2016 12:00,507,317,190,6,28,wolkig
3/2/2016 13:00,519,254,265,7,30,teilweise bewölkt
3/2/2016 14:00,497,244,253,6,28,teilweise bewölkt
3/2/2016 15:00,566,258,308,7,20,teilweise bewölkt
3/2/2016 16:00,628,333,295,6,13,wolkig
3/2/2016 17:00,709,364,345,6,11,wolkig
3/2/2016 18:00,759,357,402,6,11,wolkig
3/2/2016 19:00,584,301,283,5,11,wolkig
3/2/2016 20:00,385,190,195,5,19,Regen
3/2/2016 21:00,257,115,142,4,15,teilweise bewölkt
3/2/2016 22:00,328,138,190,4,17,wolkig
3/2/2016 23:00,174,77,97,4,22,wolkig
3/3/2016 0:00,128,54,74,4,20,wolkig
3/3/2016 1:00,89,17,72,4,20,Regen
3/3/2016 2:00,58,13,45,3,20,Regen
3/3/2016 3:00,47,12,35,3,19,Regen
3/3/2016 4:00,39,16,23,3,19,Regen
3/3/2016 5:00,69,42,27,3,19,Regen
3/3/2016 6:00,137,103,34,3,19,wolkig
3/3/2016 7:00,616,438,178,3,19,wolkig
3/3/2016 8:00,747,493,254,3,17,wolkig
3/3/2016 9:00,596,405,191,4,22,wolkig
3/3/2016 10:00,479,281,198,5,19,wolkig
3/3/2016 11:00,446,255,191,5,19,wolkig
3/3/2016 12:00,583,313,270,6,24,wolkig
3/3/2016 13:00,601,311,290,5,24,wolkig
3/3/2016 14:00,759,429,330,2,20,Regen
3/3/2016 15:00,630,299,331,5,17,wolkig
3/3/2016 16:00,852,401,451,2,17,Regen
3/3/2016 17:00,847,390,457,4,13,teilweise bewölkt
3/3/2016 18:00,743,374,369,3,11,teilweise bewölkt
3/3/2016 19:00,644,312,332,2,7,teilweise bewölkt
3/3/2016 20:00,420,225,195,1,6,Klarer Himmel
3/3/2016 21:00,353,174,179,1,4,Nebel
3/3/2016 22:00,280,125,155,0,4,Nebel
3/3/2016 23:00,206,81,125,-2,7,Nebel
3/4/2016 0:00,144,79,65,-2,6,Nebel
3/4/2016 1:00,97,42,55,0,9,Nebel
3/4/2016 2:00,51,10,41,0,9,Klarer Himmel
3/4/2016 3:00,69,5,64,0,9,Klarer Himmel
3/4/2016 4:00,57,14,43,0,11,Klarer Himmel
3/4/2016 5:00,74,33,41,0,11,
3/4/2016 6:00,126,91,35,0,11,
3/4/2016 7:00,581,414,167,0,9,
3/4/2016 8:00,616,376,240,2,17,wolkig
3/4/2016 9:00,519,334,185,2,15,wolkig
3/4/2016 10:00,386,244,142,3,17,wolkig
3/4/2016 11:00,413,234,179,4,15,wolkig
3/4/2016 12:00,520,267,253,4,20,Regen
3/4/2016 13:00,492,252,240,4,24,Regen
3/4/2016 14:00,455,175,280,2,26,Regen
3/4/2016 15:00,378,181,197,2,22,Regen
3/4/2016 16:00,357,191,166,1,15,Regen
3/4/2016 17:00,402,186,216,2,15,Regen
3/4/2016 18:00,382,171,211,3,11,wolkig
3/4/2016 19:00,371,197,174,3,11,wolkig
3/4/2016 20:00,273,159,114,3,9,wolkig
3/4/2016 21:00,227,107,120,3,7,wolkig
3/4/2016 22:00,202,79,123,3,7,wolkig
3/4/2016 23:00,184,84,100,3,7,wolkig
3/5/2016 0:00,159,89,70,3,6,wolkig
3/5/2016 1:00,127,50,77,3,2,wolkig
3/5/2016 2:00,118,35,83,2,2,Nebel
3/5/2016 3:00,70,14,56,0,2,Nebel
3/5/2016 4:00,44,9,35,2,2,Nebel
3/5/2016 5:00,60,19,41,2,6,Nebel
3/5/2016 6:00,38,21,17,2,4,Nebel
3/5/2016 7:00,67,50,17,2,4,Nebel
3/5/2016 8:00,133,95,38,2,6,wolkig
3/5/2016 9:00,263,196,67,2,11,wolkig
3/5/2016 10:00,320,213,107,3,9,wolkig
3/5/2016 11:00,322,211,111,4,7,wolkig
3/5/2016 12:00,402,254,148,5,7,wolkig
3/5/2016 13:00,440,265,175,5,6,wolkig
3/5/2016 14:00,393,193,200,5,9,wolkig
3/5/2016 15:00,387,206,181,6,7,wolkig
3/5/2016 16:00,388,203,185,5,7,wolkig
3/5/2016 17:00,383,207,176,5,6,wolkig
3/5/2016 18:00,426,218,208,4,0,Klarer Himmel
3/5/2016 19:00,277,150,127,4,2,
3/5/2016 20:00,316,148,168,3,2,
3/5/2016 21:00,237,140,97,1,4,
3/5/2016 22:00,245,114,131,0,2,Nebel
3/5/2016 23:00,182,68,114,0,0,Nebel
3/6/2016 0:00,200,68,132,-2,0,Nebel
3/6/2016 1:00,160,65,95,-2,4,Nebel
3/6/2016 2:00,126,35,91,-2,4,Nebel
3/6/2016 3:00,94,29,65,-3,2,Nebel
3/6/2016 4:00,40,8,32,-2,0,Nebel
3/6/2016 5:00,35,7,28,-3,2,Nebel
3/6/2016 6:00,26,11,15,-3,2,Nebel
3/6/2016 7:00,35,25,10,-3,4,Nebel
3/6/2016 8:00,65,39,26,-1,2,Nebel
3/6/2016 9:00,160,119,41,2,2,Nebel
3/6/2016 10:00,210,143,67,4,4,
3/6/2016 11:00,252,176,76,5,4,teilweise bewölkt
3/6/2016 12:00,259,180,79,6,7,teilweise bewölkt
3/6/2016 13:00,326,216,110,6,2,teilweise bewölkt
3/6/2016 14:00,290,141,149,6,4,teilweise bewölkt
3/6/2016 15:00,291,159,132,7,6,teilweise bewölkt
3/6/2016 16:00,376,151,225,5,7,wolkig
3/6/2016 17:00,297,138,159,3,6,wolkig
3/6/2016 18:00,285,160,125,3,7,wolkig
3/6/2016 19:00,281,159,122,3,7,wolkig
3/6/2016 20:00,199,68,131,1,4,wolkig
3/6/2016 21:00,118,54,64,1,6,wolkig
3/6/2016 22:00,184,43,141,2,9,wolkig
3/6/2016 23:00,72,19,53,2,13,Regen
3/7/2016 0:00,40,9,31,2,11,teilweise bewölkt
3/7/2016 1:00,21,7,14,1,6,teilweise bewölkt
3/7/2016 2:00,11,3,8,1,6,Nebel
3/7/2016 3:00,2,1,1,1,7,Nebel
3/7/2016 4:00,9,8,1,1,6,wolkig
3/7/2016 5:00,49,30,19,1,7,Schnee
3/7/2016 6:00,134,95,39,1,6,wolkig
3/7/2016 7:00,601,409,192,2,6,wolkig
3/7/2016 8:00,636,396,240,2,7,Regen
3/7/2016 9:00,517,351,166,2,9,wolkig
3/7/2016 10:00,417,247,170,3,6,wolkig
3/7/2016 11:00,394,223,171,3,7,wolkig
3/7/2016 12:00,505,293,212,3,9,wolkig
3/7/2016 13:00,492,247,245,4,7,wolkig
3/7/2016 14:00,535,272,263,4,6,wolkig
3/7/2016 15:00,584,271,313,5,11,teilweise bewölkt
3/7/2016 16:00,704,397,307,5,6,teilweise bewölkt
3/7/2016 17:00,874,433,441,5,6,teilweise bewölkt
3/7/2016 18:00,749,346,403,2,2,teilweise bewölkt
3/7/2016 19:00,582,307,275,0,2,Klarer Himmel
3/7/2016 20:00,344,161,183,0,4,Klarer Himmel
3/7/2016 21:00,268,110,158,-1,2,Klarer Himmel
3/7/2016 22:00,234,95,139,-2,2,Nebel
3/7/2016 23:00,139,21,118,-2,2,Nebel
3/8/2016 0:00,69,22,47,-3,0,Nebel
3/8/2016 1:00,37,9,28,-3,0,Nebel
3/8/2016 2:00,18,5,13,-3,2,Nebel
3/8/2016 3:00,7,4,3,-4,2,Nebel
3/8/2016 4:00,10,8,2,-4,4,Nebel
3/8/2016 5:00,47,28,19,-4,0,Nebel
3/8/2016 6:00,157,115,42,-4,0,Nebel
3/8/2016 7:00,594,401,193,-2,4,teilweise bewölkt
3/8/2016 8:00,692,407,285,-1,4,Nebel
3/8/2016 9:00,606,412,194,0,7,wolkig
3/8/2016 10:00,420,243,177,2,7,Regen
3/8/2016 11:00,430,249,181,4,11,wolkig
3/8/2016 12:00,497,254,243,5,17,wolkig
3/8/2016 13:00,522,280,242,5,15,teilweise bewölkt
3/8/2016 14:00,539,289,250,6,19,teilweise bewölkt
3/8/2016 15:00,549,258,291,6,20,wolkig
3/8/2016 16:00,770,380,390,5,15,wolkig
3/8/2016 17:00,846,404,442,5,11,wolkig
3/8/2016 18:00,749,368,381,4,11,
3/8/2016 19:00,605,306,299,3,9,wolkig
3/8/2016 20:00,371,175,196,3,11,wolkig
3/8/2016 21:00,296,125,171,3,13,Klarer Himmel
3/8/2016 22:00,263,91,172,2,13,Klarer Himmel
3/8/2016 23:00,158,54,104,2,11,Klarer Himmel
3/9/2016 0:00,74,20,54,1,9,Klarer Himmel
3/9/2016 1:00,42,8,34,1,9,Klarer Himmel
3/9/2016 2:00,11,3,8,0,11,Klarer Himmel
3/9/2016 3:00,15,6,9,0,11,Klarer Himmel
3/9/2016 4:00,10,5,5,0,9,Klarer Himmel
3/9/2016 5:00,47,32,15,-1,9,Klarer Himmel
3/9/2016 6:00,154,118,36,-1,9,Klarer Himmel
3/9/2016 7:00,611,427,184,0,7,Klarer Himmel
3/9/2016 8:00,758,463,295,1,15,Klarer Himmel
3/9/2016 9:00,615,408,207,3,15,Klarer Himmel
3/9/2016 10:00,446,279,167,5,24,Klarer Himmel
3/9/2016 11:00,492,294,198,6,22,Klarer Himmel
3/9/2016 12:00,573,314,259,7,22,Klarer Himmel
3/9/2016 13:00,613,340,273,7,24,Klarer Himmel
3/9/2016 14:00,617,323,294,7,20,Klarer Himmel
3/9/2016 15:00,664,346,318,7,22,Klarer Himmel
3/9/2016 16:00,768,369,399,8,15,Klarer Himmel
3/9/2016 17:00,896,451,445,7,11,Klarer Himmel
3/9/2016 18:00,881,414,467,7,9,Klarer Himmel
3/9/2016 19:00,703,368,335,6,7,Klarer Himmel
3/9/2016 20:00,432,222,210,5,4,Klarer Himmel
3/9/2016 21:00,292,123,169,4,6,Klarer Himmel
3/9/2016 22:00,310,114,196,4,6,Klarer Himmel
3/9/2016 23:00,179,67,112,3,6,Klarer Himmel
3/10/2016 0:00,144,66,78,2,6,Klarer Himmel
3/10/2016 1:00,95,29,66,3,7,Klarer Himmel
3/10/2016 2:00,33,5,28,3,6,Klarer Himmel
3/10/2016 3:00,69,14,55,0,9,Klarer Himmel
3/10/2016 4:00,26,12,14,1,9,
3/10/2016 5:00,60,39,21,0,9,
3/10/2016 6:00,152,109,43,-1,7,
3/10/2016 7:00,639,439,200,0,7,
3/10/2016 8:00,727,439,288,2,11,
3/10/2016 9:00,608,388,220,3,17,
3/10/2016 10:00,456,262,194,5,13,Klarer Himmel
3/10/2016 11:00,423,260,163,6,13,wolkig
3/10/2016 12:00,539,315,224,6,15,wolkig
3/10/2016 13:00,572,297,275,7,13,wolkig
3/10/2016 14:00,669,361,308,6,15,wolkig
3/10/2016 15:00,670,317,353,7,13,wolkig
3/10/2016 16:00,779,404,375,7,11,wolkig
3/10/2016 17:00,851,412,439,7,7,wolkig
3/10/2016 18:00,802,398,404,6,9,wolkig
3/10/2016 19:00,597,307,290,5,9,wolkig
3/10/2016 20:00,402,189,213,5,6,wolkig
3/10/2016 21:00,302,124,178,5,4,wolkig
3/10/2016 22:00,255,89,166,6,9,wolkig
3/10/2016 23:00,177,63,114,5,11,wolkig
3/11/2016 0:00,97,33,64,4,9,wolkig
3/11/2016 1:00,38,15,23,2,9,teilweise bewölkt
3/11/2016 2:00,17,5,12,1,6,Nebel
3/11/2016 3:00,18,6,12,1,7,Nebel
3/11/2016 4:00,23,9,14,2,6,wolkig
3/11/2016 5:00,44,29,15,3,9,wolkig
3/11/2016 6:00,153,119,34,3,9,wolkig
3/11/2016 7:00,586,405,181,3,6,wolkig
3/11/2016 8:00,708,428,280,4,9,wolkig
3/11/2016 9:00,474,300,174,3,15,wolkig
3/11/2016 10:00,425,238,187,3,11,wolkig
3/11/2016 11:00,406,244,162,4,15,wolkig
3/11/2016 12:00,487,275,212,4,13,wolkig
3/11/2016 13:00,622,307,315,4,11,wolkig
3/11/2016 14:00,642,349,293,4,11,wolkig
3/11/2016 15:00,602,316,286,4,11,wolkig
3/11/2016 16:00,601,308,293,5,15,wolkig
3/11/2016 17:00,661,325,336,4,11,wolkig
3/11/2016 18:00,611,311,300,3,9,teilweise bewölkt
3/11/2016 19:00,479,284,195,2,6,Klarer Himmel
3/11/2016 20:00,399,196,203,2,7,Klarer Himmel
3/11/2016 21:00,269,127,142,2,4,teilweise bewölkt
3/11/2016 22:00,272,132,140,1,4,Klarer Himmel
3/11/2016 23:00,190,85,105,-1,4,Klarer Himmel
3/12/2016 0:00,193,78,115,0,4,Klarer Himmel
3/12/2016 1:00,172,82,90,-1,6,
3/12/2016 2:00,108,40,68,0,6,
3/12/2016 3:00,71,9,62,0,4,
3/12/2016 4:00,44,6,38,-2,6,
3/12/2016 5:00,70,24,46,-2,2,Nebel
3/12/2016 6:00,51,30,21,-2,2,Nebel
3/12/2016 7:00,92,75,17,-2,4,Nebel
3/12/2016 8:00,175,118,57,2,6,wolkig
3/12/2016 9:00,327,261,66,4,11,wolkig
3/12/2016 10:00,387,281,106,4,6,wolkig
3/12/2016 11:00,459,281,178,4,7,wolkig
3/12/2016 12:00,445,272,173,5,9,wolkig
3/12/2016 13:00,486,271,215,5,11,wolkig
3/12/2016 14:00,465,221,244,6,11,wolkig
3/12/2016 15:00,425,191,234,6,7,wolkig
3/12/2016 16:00,364,165,199,5,13,teilweise bewölkt
3/12/2016 17:00,420,187,233,5,11,teilweise bewölkt
3/12/2016 18:00,364,167,197,4,9,teilweise bewölkt
3/12/2016 19:00,344,166,178,3,7,teilweise bewölkt
3/12/2016 20:00,307,159,148,2,7,Klarer Himmel
3/12/2016 21:00,188,93,95,1,7,wolkig
3/12/2016 22:00,189,88,101,2,7,teilweise bewölkt
3/12/2016 23:00,183,97,86,2,9,teilweise bewölkt
3/13/2016 0:00,195,72,123,2,6,wolkig
3/13/2016 1:00,147,57,90,2,7,wolkig
3/13/2016 2:00,115,43,72,3,7,wolkig
3/13/2016 3:00,78,18,60,3,6,wolkig
3/13/2016 4:00,62,5,57,3,6,wolkig
3/13/2016 5:00,43,21,22,3,9,wolkig
3/13/2016 6:00,32,13,19,3,9,wolkig
3/13/2016 7:00,38,25,13,3,13,wolkig
3/13/2016 8:00,77,44,33,4,17,wolkig
3/13/2016 9:00,126,96,30,4,13,wolkig
3/13/2016 10:00,210,155,55,4,11,wolkig
3/13/2016 11:00,187,116,71,4,13,wolkig
3/13/2016 12:00,223,110,113,5,13,wolkig
3/13/2016 13:00,317,181,136,5,24,teilweise bewölkt
3/13/2016 14:00,375,225,150,5,19,wolkig
3/13/2016 15:00,380,210,170,5,11,teilweise bewölkt
3/13/2016 16:00,353,180,173,6,13,Klarer Himmel
3/13/2016 17:00,354,182,172,6,9,Klarer Himmel
3/13/2016 18:00,330,154,176,4,6,teilweise bewölkt
3/13/2016 19:00,218,107,111,4,15,teilweise bewölkt
3/13/2016 20:00,207,91,116,2,15,teilweise bewölkt
3/13/2016 21:00,137,52,85,2,11,wolkig
3/13/2016 22:00,117,52,65,2,17,wolkig
3/13/2016 23:00,74,26,48,1,17,wolkig
3/14/2016 0:00,47,7,40,1,7,wolkig
3/14/2016 1:00,12,4,8,1,6,wolkig
3/14/2016 2:00,3,1,2,0,6,Klarer Himmel
3/14/2016 3:00,5,4,1,-1,6,Klarer Himmel
3/14/2016 4:00,13,9,4,-1,6,Klarer Himmel
3/14/2016 5:00,44,29,15,-1,7,
3/14/2016 6:00,152,111,41,-1,7,
3/14/2016 7:00,630,443,187,-1,9,
3/14/2016 8:00,748,433,315,1,7,Klarer Himmel
3/14/2016 9:00,599,365,234,3,11,Klarer Himmel
3/14/2016 10:00,506,283,223,4,13,Klarer Himmel
3/14/2016 11:00,517,261,256,6,11,Klarer Himmel
3/14/2016 12:00,617,339,278,7,15,Klarer Himmel
3/14/2016 13:00,557,299,258,8,17,Klarer Himmel
3/14/2016 14:00,628,348,280,9,17,Klarer Himmel
3/14/2016 15:00,670,334,336,9,20,Klarer Himmel
3/14/2016 16:00,843,407,436,9,20,Klarer Himmel
3/14/2016 17:00,913,482,431,8,15,Klarer Himmel
3/14/2016 18:00,889,407,482,6,13,Klarer Himmel
3/14/2016 19:00,630,292,338,5,7,Klarer Himmel
3/14/2016 20:00,388,176,212,4,2,Klarer Himmel
3/14/2016 21:00,307,139,168,3,0,Klarer Himmel
3/14/2016 22:00,227,85,142,1,2,Klarer Himmel
3/14/2016 23:00,124,46,78,1,4,Klarer Himmel
3/15/2016 0:00,69,18,51,0,2,Klarer Himmel
3/15/2016 1:00,37,7,30,1,4,Klarer Himmel
3/15/2016 2:00,33,7,26,-1,4,
3/15/2016 3:00,9,2,7,-1,2,wolkig
3/15/2016 4:00,15,11,4,-1,7,wolkig
3/15/2016 5:00,41,26,15,2,4,wolkig
3/15/2016 6:00,168,125,43,2,4,Nebel
3/15/2016 7:00,650,440,210,2,2,Regen
3/15/2016 8:00,760,448,312,4,6,Regen
3/15/2016 9:00,658,404,254,4,13,wolkig
3/15/2016 10:00,434,248,186,5,11,wolkig
3/15/2016 11:00,508,257,251,6,11,wolkig
3/15/2016 12:00,620,271,349,6,11,wolkig
3/15/2016 13:00,551,287,264,6,11,wolkig
3/15/2016 14:00,638,322,316,7,15,wolkig
3/15/2016 15:00,667,357,310,8,19,wolkig
3/15/2016 16:00,804,404,400,7,13,Regen
3/15/2016 17:00,903,453,450,7,15,wolkig
3/15/2016 18:00,782,389,393,7,17,teilweise bewölkt
3/15/2016 19:00,656,351,305,5,17,teilweise bewölkt
3/15/2016 20:00,404,175,229,5,13,teilweise bewölkt
3/15/2016 21:00,321,127,194,5,17,Klarer Himmel
3/15/2016 22:00,290,106,184,4,11,Klarer Himmel
3/15/2016 23:00,172,49,123,3,11,Klarer Himmel
3/16/2016 0:00,95,27,68,2,9,Klarer Himmel
3/16/2016 1:00,66,24,42,1,7,Klarer Himmel
3/16/2016 2:00,27,7,20,2,9,wolkig
3/16/2016 3:00,13,2,11,3,11,wolkig
3/16/2016 4:00,13,9,4,3,15,wolkig
3/16/2016 5:00,43,28,15,3,11,wolkig
3/16/2016 6:00,175,133,42,3,17,wolkig
3/16/2016 7:00,620,429,191,3,13,wolkig
3/16/2016 8:00,831,469,362,4,20,teilweise bewölkt
3/16/2016 9:00,705,457,248,5,15,teilweise bewölkt
3/16/2016 10:00,529,334,195,6,15,wolkig
3/16/2016 11:00,527,299,228,6,19,wolkig
3/16/2016 12:00,626,336,290,7,19,wolkig
3/16/2016 13:00,595,317,278,7,19,wolkig
3/16/2016 14:00,567,294,273,8,19,teilweise bewölkt
3/16/2016 15:00,699,337,362,8,22,teilweise bewölkt
3/16/2016 16:00,761,394,367,8,17,teilweise bewölkt
3/16/2016 17:00,920,458,462,8,15,teilweise bewölkt
3/16/2016 18:00,863,414,449,6,9,teilweise bewölkt
3/16/2016 19:00,688,382,306,6,6,Klarer Himmel
3/16/2016 20:00,493,270,223,6,7,Klarer Himmel
3/16/2016 21:00,337,147,190,5,7,Klarer Himmel
3/16/2016 22:00,279,130,149,4,7,Klarer Himmel
3/16/2016 23:00,311,131,180,3,4,Klarer Himmel
3/17/2016 0:00,166,55,111,2,6,Klarer Himmel
3/17/2016 1:00,136,47,89,1,2,Klarer Himmel
3/17/2016 2:00,78,22,56,2,6,Klarer Himmel
3/17/2016 3:00,53,6,47,1,7,Klarer Himmel
3/17/2016 4:00,63,22,41,0,4,Klarer Himmel
3/17/2016 5:00,52,33,19,0,6,Klarer Himmel
3/17/2016 6:00,152,107,45,0,7,Klarer Himmel
3/17/2016 7:00,653,459,194,1,6,Klarer Himmel
3/17/2016 8:00,780,480,300,4,9,Klarer Himmel
3/17/2016 9:00,599,397,202,7,13,Klarer Himmel
3/17/2016 10:00,509,276,233,9,15,Klarer Himmel
3/17/2016 11:00,543,324,219,10,17,Klarer Himmel
3/17/2016 12:00,605,333,272,10,11,Klarer Himmel
3/17/2016 13:00,659,316,343,11,15,Klarer Himmel
3/17/2016 14:00,746,400,346,11,15,Klarer Himmel
3/17/2016 15:00,786,391,395,12,11,Klarer Himmel
3/17/2016 16:00,863,414,449,12,11,Klarer Himmel
3/17/2016 17:00,931,447,484,11,11,Klarer Himmel
3/17/2016 18:00,844,409,435,8,6,Klarer Himmel
3/17/2016 19:00,650,303,347,6,2,Klarer Himmel
3/17/2016 20:00,460,221,239,3,2,Klarer Himmel
3/17/2016 21:00,334,136,198,3,2,Klarer Himmel
3/17/2016 22:00,305,136,169,1,6,Klarer Himmel
3/17/2016 23:00,230,82,148,2,2,Klarer Himmel
3/18/2016 0:00,127,30,97,1,6,
3/18/2016 1:00,105,24,81,1,6,
3/18/2016 2:00,52,14,38,1,13,Nebel
3/18/2016 3:00,23,3,20,1,11,Nebel
3/18/2016 4:00,35,17,18,1,7,wolkig
3/18/2016 5:00,52,33,19,1,13,wolkig
3/18/2016 6:00,143,102,41,1,7,wolkig
3/18/2016 7:00,564,384,180,2,11,Regen
3/18/2016 8:00,684,396,288,3,11,Regen
3/18/2016 9:00,541,344,197,4,13,wolkig
3/18/2016 10:00,389,260,129,4,13,Regen
3/18/2016 11:00,444,264,180,5,11,wolkig
3/18/2016 12:00,579,307,272,5,13,wolkig
3/18/2016 13:00,634,315,319,6,13,wolkig
3/18/2016 14:00,589,286,303,6,15,wolkig
3/18/2016 15:00,610,329,281,6,13,wolkig
3/18/2016 16:00,574,321,253,6,15,wolkig
3/18/2016 17:00,643,306,337,6,13,wolkig
3/18/2016 18:00,567,263,304,5,9,wolkig
3/18/2016 19:00,437,235,202,5,11,Regen
3/18/2016 20:00,381,218,163,5,9,wolkig
3/18/2016 21:00,254,126,128,5,6,wolkig
3/18/2016 22:00,245,93,152,5,7,wolkig
3/18/2016 23:00,246,96,150,5,7,wolkig
3/19/2016 0:00,181,65,116,5,9,wolkig
3/19/2016 1:00,133,59,74,5,6,wolkig
3/19/2016 2:00,99,41,58,5,7,wolkig
3/19/2016 3:00,72,16,56,5,9,wolkig
3/19/2016 4:00,43,11,32,5,2,wolkig
3/19/2016 5:00,47,17,30,5,6,wolkig
3/19/2016 6:00,49,27,22,5,7,wolkig
3/19/2016 7:00,72,50,22,5,7,wolkig
3/19/2016 8:00,161,115,46,5,9,wolkig
3/19/2016 9:00,317,242,75,5,9,wolkig
3/19/2016 10:00,382,294,88,5,9,wolkig
3/19/2016 11:00,387,259,128,5,9,wolkig
3/19/2016 12:00,431,271,160,5,13,wolkig
3/19/2016 13:00,413,251,162,5,7,wolkig
3/19/2016 14:00,422,216,206,6,7,wolkig
3/19/2016 15:00,381,196,185,6,9,wolkig
3/19/2016 16:00,354,161,193,7,9,wolkig
3/19/2016 17:00,375,158,217,7,7,wolkig
3/19/2016 18:00,424,188,236,6,11,wolkig
3/19/2016 19:00,353,185,168,6,9,wolkig
3/19/2016 20:00,349,183,166,6,11,wolkig
3/19/2016 21:00,265,158,107,6,11,wolkig
3/19/2016 22:00,182,94,88,5,7,wolkig
3/19/2016 23:00,192,87,105,5,7,wolkig
3/20/2016 0:00,203,94,109,5,9,wolkig
3/20/2016 1:00,196,93,103,5,11,Regen
3/20/2016 2:00,98,30,68,5,11,Regen
3/20/2016 3:00,70,25,45,4,11,Regen
3/20/2016 4:00,72,16,56,4,11,Regen
3/20/2016 5:00,49,14,35,4,9,Regen
3/20/2016 6:00,40,13,27,4,9,wolkig
3/20/2016 7:00,32,15,17,4,13,wolkig
3/20/2016 8:00,48,31,17,5,13,wolkig
3/20/2016 9:00,164,124,40,6,13,wolkig
3/20/2016 10:00,254,181,73,6,15,Regen
3/20/2016 11:00,288,205,83,7,20,wolkig
3/20/2016 12:00,270,138,132,7,19,Regen
3/20/2016 13:00,379,231,148,7,19,wolkig
3/20/2016 14:00,329,191,138,7,17,Regen
3/20/2016 15:00,348,181,167,7,17,Regen
3/20/2016 16:00,273,126,147,7,17,Regen
3/20/2016 17:00,311,143,168,7,11,wolkig
3/20/2016 18:00,270,125,145,7,13,wolkig
3/20/2016 19:00,216,103,113,7,9,wolkig
3/20/2016 20:00,181,65,116,7,9,wolkig
3/20/2016 21:00,109,46,63,7,9,wolkig
3/20/2016 22:00,118,41,77,7,9,wolkig
3/20/2016 23:00,105,38,67,6,15,wolkig
3/21/2016 0:00,33,10,23,6,13,Regen
3/21/2016 1:00,11,4,7,6,13,wolkig
3/21/2016 2:00,8,3,5,6,11,Regen
3/21/2016 3:00,2,1,1,6,13,wolkig
3/21/2016 4:00,14,9,5,6,11,wolkig
3/21/2016 5:00,43,26,17,5,9,Regen
3/21/2016 6:00,110,82,28,5,7,Regen
3/21/2016 7:00,376,236,140,6,15,Regen
3/21/2016 8:00,590,338,252,6,13,Regen
3/21/2016 9:00,479,302,177,7,19,wolkig
3/21/2016 10:00,383,221,162,7,13,wolkig
3/21/2016 11:00,412,240,172,9,19,wolkig
3/21/2016 12:00,440,253,187,9,19,wolkig
3/21/2016 13:00,484,263,221,9,20,wolkig
3/21/2016 14:00,464,267,197,8,22,wolkig
3/21/2016 15:00,528,276,252,8,24,wolkig
3/21/2016 16:00,631,295,336,8,22,wolkig
3/21/2016 17:00,756,365,391,8,20,wolkig
3/21/2016 18:00,653,353,300,7,9,wolkig
3/21/2016 19:00,417,192,225,7,20,Regen
3/21/2016 20:00,312,143,169,6,11,wolkig
3/21/2016 21:00,217,84,133,6,15,wolkig
3/21/2016 22:00,205,63,142,6,17,wolkig
3/21/2016 23:00,155,53,102,6,13,wolkig
3/22/2016 0:00,77,26,51,6,13,wolkig
3/22/2016 1:00,55,9,46,6,15,wolkig
3/22/2016 2:00,9,2,7,6,13,Regen
3/22/2016 3:00,16,9,7,5,13,wolkig
3/22/2016 4:00,16,12,4,5,15,wolkig
3/22/2016 5:00,43,27,16,5,13,wolkig
3/22/2016 6:00,127,90,37,6,11,Regen
3/22/2016 7:00,389,256,133,6,13,Regen
3/22/2016 8:00,624,360,264,6,15,wolkig
3/22/2016 9:00,539,342,197,7,13,wolkig
3/22/2016 10:00,453,284,169,8,15,wolkig
3/22/2016 11:00,443,282,161,8,17,Regen
3/22/2016 12:00,494,270,224,8,11,Regen
3/22/2016 13:00,494,239,255,8,13,Regen
3/22/2016 14:00,542,310,232,9,7,Regen
3/22/2016 15:00,550,302,248,8,9,Regen
3/22/2016 16:00,634,330,304,8,9,Regen
3/22/2016 17:00,753,341,412,8,13,Regen
3/22/2016 18:00,616,276,340,7,17,Regen
3/22/2016 19:00,495,252,243,7,11,Regen
3/22/2016 20:00,374,174,200,7,11,Regen
3/22/2016 21:00,261,130,131,7,6,Regen
3/22/2016 22:00,226,91,135,7,9,Regen
3/22/2016 23:00,157,57,100,7,13,Regen
3/23/2016 0:00,97,48,49,6,13,Regen
3/23/2016 1:00,43,12,31,7,11,wolkig
3/23/2016 2:00,30,5,25,6,9,Regen
3/23/2016 3:00,26,3,23,6,13,Regen
3/23/2016 4:00,20,12,8,6,7,Regen
3/23/2016 5:00,43,29,14,6,9,wolkig
3/23/2016 6:00,108,81,27,6,11,Regen
3/23/2016 7:00,375,258,117,6,11,wolkig
3/23/2016 8:00,606,370,236,6,11,Regen
3/23/2016 9:00,603,382,221,7,13,wolkig
3/23/2016 10:00,482,322,160,7,11,wolkig
3/23/2016 11:00,540,325,215,8,20,wolkig
3/23/2016 12:00,495,274,221,8,13,teilweise bewölkt
3/23/2016 13:00,513,261,252,8,15,wolkig
3/23/2016 14:00,505,274,231,9,20,wolkig
3/23/2016 15:00,589,286,303,9,13,wolkig
3/23/2016 16:00,640,323,317,9,19,wolkig
3/23/2016 17:00,785,382,403,8,15,
3/23/2016 18:00,742,393,349,8,11,wolkig
3/23/2016 19:00,564,267,297,7,7,wolkig
3/23/2016 20:00,422,225,197,6,13,wolkig
3/23/2016 21:00,262,132,130,5,7,teilweise bewölkt
3/23/2016 22:00,266,122,144,5,7,wolkig
3/23/2016 23:00,252,110,142,4,6,wolkig
3/24/2016 0:00,150,55,95,3,4,wolkig
3/24/2016 1:00,121,35,86,3,6,wolkig
3/24/2016 2:00,88,27,61,3,6,wolkig
3/24/2016 3:00,81,17,64,3,7,wolkig
3/24/2016 4:00,50,16,34,2,6,wolkig
3/24/2016 5:00,57,28,29,1,2,wolkig
3/24/2016 6:00,110,78,32,2,0,wolkig
3/24/2016 7:00,377,245,132,4,4,wolkig
3/24/2016 8:00,477,267,210,5,6,wolkig
3/24/2016 9:00,439,276,163,5,7,wolkig
3/24/2016 10:00,380,230,150,6,6,wolkig
3/24/2016 11:00,412,247,165,6,9,Regen
3/24/2016 12:00,500,325,175,7,9,Regen
3/24/2016 13:00,491,280,211,8,15,wolkig
3/24/2016 14:00,567,320,247,8,13,wolkig
3/24/2016 15:00,541,282,259,8,13,wolkig
3/24/2016 16:00,566,293,273,8,9,
3/24/2016 17:00,653,340,313,8,7,wolkig
3/24/2016 18:00,604,307,297,8,13,wolkig
3/24/2016 19:00,416,209,207,8,11,Regen
3/24/2016 20:00,294,152,142,8,13,Regen
3/24/2016 21:00,215,103,112,7,11,Regen
3/24/2016 22:00,144,56,88,7,11,Regen
3/24/2016 23:00,130,47,83,6,9,Regen
3/25/2016 0:00,94,34,60,6,11,Regen
3/25/2016 1:00,98,34,64,6,9,Regen
3/25/2016 2:00,64,21,43,6,9,Regen
3/25/2016 3:00,33,10,23,6,15,Regen
3/25/2016 4:00,18,8,10,6,15,Regen
3/25/2016 5:00,8,2,6,6,15,Regen
3/25/2016 6:00,28,19,9,6,17,Regen
3/25/2016 7:00,28,18,10,6,15,Regen
3/25/2016 8:00,36,26,10,7,17,Regen
3/25/2016 9:00,69,41,28,7,17,Regen
3/25/2016 10:00,71,41,30,7,17,Regen
3/25/2016 11:00,67,43,24,7,19,Regen
3/25/2016 12:00,101,63,38,8,15,Regen
3/25/2016 13:00,78,35,43,8,13,Regen
3/25/2016 14:00,98,63,35,8,13,Regen
3/25/2016 15:00,92,58,34,8,13,Regen
3/25/2016 16:00,102,46,56,8,11,wolkig
3/25/2016 17:00,132,75,57,8,9,wolkig
3/25/2016 18:00,169,88,81,8,6,wolkig
3/25/2016 19:00,103,52,51,7,6,wolkig
3/25/2016 20:00,123,67,56,6,9,wolkig
3/25/2016 21:00,81,35,46,6,9,wolkig
3/25/2016 22:00,80,39,41,7,11,wolkig
3/25/2016 23:00,56,27,29,7,17,wolkig
3/26/2016 0:00,61,28,33,7,6,wolkig
3/26/2016 1:00,53,21,32,6,7,wolkig
3/26/2016 2:00,33,15,18,6,2,wolkig
3/26/2016 3:00,9,2,7,4,2,Nebel
3/26/2016 4:00,14,8,6,3,7,Nebel
3/26/2016 5:00,26,16,10,1,6,Nebel
3/26/2016 6:00,33,24,9,3,9,Nebel
3/26/2016 7:00,57,45,12,5,7,Nebel
3/26/2016 8:00,151,100,51,7,13,teilweise bewölkt
3/26/2016 9:00,261,200,61,9,13,teilweise bewölkt
3/26/2016 10:00,352,260,92,10,19,teilweise bewölkt
3/26/2016 11:00,426,276,150,12,20,teilweise bewölkt
3/26/2016 12:00,498,287,211,13,24,teilweise bewölkt
3/26/2016 13:00,402,227,175,14,19,Klarer Himmel
3/26/2016 14:00,481,250,231,14,20,wolkig
3/26/2016 15:00,404,182,222,15,22,Klarer Himmel
3/26/2016 16:00,359,186,173,15,32,Klarer Himmel
3/26/2016 17:00,374,141,233,14,22,Klarer Himmel
3/26/2016 18:00,298,125,173,13,17,Klarer Himmel
3/26/2016 19:00,248,106,142,12,17,Klarer Himmel
3/26/2016 20:00,196,104,92,12,19,Klarer Himmel
3/26/2016 21:00,127,84,43,11,19,Klarer Himmel
3/26/2016 22:00,117,55,62,10,15,Klarer Himmel
3/26/2016 23:00,129,58,71,10,20,Klarer Himmel
3/27/2016 0:00,92,39,53,9,13,Klarer Himmel
3/27/2016 1:00,96,26,70,9,9,Klarer Himmel
3/27/2016 3:00,0,0,0,,,
3/27/2016 3:00,60,9,51,9,9,Klarer Himmel
3/27/2016 4:00,63,19,44,10,17,Klarer Himmel
3/27/2016 5:00,39,11,28,10,15,Klarer Himmel
3/27/2016 6:00,32,11,21,10,7,Regen
3/27/2016 7:00,37,22,15,9,9,wolkig
3/27/2016 8:00,31,12,19,9,28,Regen
3/27/2016 9:00,54,37,17,8,19,Regen
3/27/2016 10:00,53,35,18,8,24,Regen
3/27/2016 11:00,56,45,11,8,19,wolkig
3/27/2016 12:00,76,46,30,9,24,wolkig
3/27/2016 13:00,83,39,44,10,20,wolkig
3/27/2016 14:00,127,63,64,11,32,teilweise bewölkt
3/27/2016 15:00,116,60,56,12,28,wolkig
3/27/2016 16:00,156,82,74,12,19,Regen
3/27/2016 17:00,128,63,65,12,24,wolkig
3/27/2016 18:00,124,71,53,12,19,teilweise bewölkt
3/27/2016 19:00,154,60,94,11,13,Klarer Himmel
3/27/2016 20:00,125,61,64,10,15,Klarer Himmel
3/27/2016 21:00,115,48,67,9,19,Klarer Himmel
3/27/2016 22:00,75,37,38,9,19,Klarer Himmel
3/27/2016 23:00,60,32,28,8,15,teilweise bewölkt
3/28/2016 0:00,53,28,25,8,17,Klarer Himmel
3/28/2016 1:00,48,28,20,7,13,Klarer Himmel
3/28/2016 2:00,28,6,22,8,17,Klarer Himmel
3/28/2016 3:00,32,8,24,8,19,Klarer Himmel
3/28/2016 4:00,25,2,23,7,19,Klarer Himmel
3/28/2016 5:00,17,5,12,8,20,Klarer Himmel
3/28/2016 6:00,19,8,11,8,24,Klarer Himmel
3/28/2016 7:00,27,18,9,8,20,Klarer Himmel
3/28/2016 8:00,34,23,11,9,28,Klarer Himmel
3/28/2016 9:00,62,43,19,9,43,Regen
3/28/2016 10:00,64,41,23,10,28,Regen
3/28/2016 11:00,117,65,52,11,35,wolkig
3/28/2016 12:00,127,82,45,12,37,wolkig
3/28/2016 13:00,130,65,65,12,37,wolkig
3/28/2016 14:00,115,69,46,11,32,Regen
3/28/2016 15:00,74,34,40,9,19,wolkig
3/28/2016 16:00,113,52,61,10,15,wolkig
3/28/2016 17:00,129,68,61,10,24,teilweise bewölkt
3/28/2016 18:00,154,73,81,10,19,teilweise bewölkt
3/28/2016 19:00,188,101,87,10,19,teilweise bewölkt
3/28/2016 20:00,128,68,60,9,15,wolkig
3/28/2016 21:00,89,40,49,9,15,teilweise bewölkt
3/28/2016 22:00,86,34,52,8,17,teilweise bewölkt
3/28/2016 23:00,73,29,44,8,11,wolkig
3/29/2016 0:00,42,20,22,8,19,wolkig
3/29/2016 1:00,27,9,18,7,26,Regen
3/29/2016 2:00,14,4,10,7,15,Regen
3/29/2016 3:00,9,1,8,6,22,wolkig
3/29/2016 4:00,18,11,7,6,22,wolkig
3/29/2016 5:00,43,25,18,6,24,wolkig
3/29/2016 6:00,88,61,27,6,24,wolkig
3/29/2016 7:00,331,202,129,6,24,Regen
3/29/2016 8:00,474,292,182,7,26,wolkig
3/29/2016 9:00,437,280,157,7,24,wolkig
3/29/2016 10:00,336,210,126,7,28,wolkig
3/29/2016 11:00,398,239,159,8,28,Regen
3/29/2016 12:00,394,210,184,8,20,wolkig
3/29/2016 13:00,405,221,184,9,26,wolkig
3/29/2016 14:00,409,215,194,10,28,wolkig
3/29/2016 15:00,450,232,218,11,37,wolkig
3/29/2016 16:00,513,274,239,9,26,Regen
3/29/2016 17:00,639,309,330,10,26,wolkig
3/29/2016 18:00,617,305,312,10,26,wolkig
3/29/2016 19:00,506,247,259,9,20,teilweise bewölkt
3/29/2016 20:00,338,139,199,8,11,teilweise bewölkt
3/29/2016 21:00,234,93,141,7,7,teilweise bewölkt
3/29/2016 22:00,202,85,117,5,7,Klarer Himmel
3/29/2016 23:00,162,73,89,6,9,Klarer Himmel
3/30/2016 0:00,83,28,55,6,9,Klarer Himmel
3/30/2016 1:00,62,12,50,6,11,Klarer Himmel
3/30/2016 2:00,16,5,11,7,15,Regen
3/30/2016 3:00,12,4,8,7,17,Regen
3/30/2016 4:00,17,11,6,8,17,wolkig
3/30/2016 5:00,52,35,17,9,15,wolkig
3/30/2016 6:00,124,94,30,9,22,wolkig
3/30/2016 7:00,343,231,112,7,24,wolkig
3/30/2016 8:00,604,373,231,8,22,wolkig
3/30/2016 9:00,556,359,197,8,26,wolkig
3/30/2016 10:00,467,296,171,9,28,wolkig
3/30/2016 11:00,523,327,196,10,28,wolkig
3/30/2016 12:00,568,324,244,11,28,wolkig
3/30/2016 13:00,564,319,245,11,32,wolkig
3/30/2016 14:00,569,300,269,11,28,wolkig
3/30/2016 15:00,601,308,293,12,30,wolkig
3/30/2016 16:00,679,339,340,12,32,wolkig
3/30/2016 17:00,774,366,408,12,30,wolkig
3/30/2016 18:00,762,336,426,11,22,wolkig
3/30/2016 19:00,617,322,295,10,20,wolkig
3/30/2016 20:00,444,243,201,9,9,wolkig
3/30/2016 21:00,313,150,163,8,7,wolkig
3/30/2016 22:00,249,95,154,8,6,Klarer Himmel
3/30/2016 23:00,232,89,143,7,4,wolkig
3/31/2016 0:00,165,69,96,6,2,Klarer Himmel
3/31/2016 1:00,91,32,59,5,2,Klarer Himmel
3/31/2016 2:00,80,14,66,5,2,Klarer Himmel
3/31/2016 3:00,45,14,31,5,2,Klarer Himmel
3/31/2016 4:00,65,17,48,5,0,Klarer Himmel
3/31/2016 5:00,74,37,37,4,2,Klarer Himmel
3/31/2016 6:00,102,66,36,4,2,Klarer Himmel
3/31/2016 7:00,364,216,148,4,4,wolkig
3/31/2016 8:00,590,348,242,6,2,Klarer Himmel
3/31/2016 9:00,565,356,209,7,4,wolkig
3/31/2016 10:00,436,283,153,8,4,wolkig
3/31/2016 11:00,457,294,163,9,11,wolkig
3/31/2016 12:00,515,306,209,10,11,wolkig
3/31/2016 13:00,520,266,254,10,19,wolkig
3/31/2016 14:00,558,307,251,10,17,wolkig
3/31/2016 15:00,619,326,293,11,17,wolkig
3/31/2016 16:00,717,363,354,10,17,wolkig
3/31/2016 17:00,690,322,368,10,17,wolkig
3/31/2016 18:00,706,333,373,9,17,wolkig
3/31/2016 19:00,569,284,285,9,15,wolkig
3/31/2016 20:00,397,190,207,8,9,wolkig
3/31/2016 21:00,265,107,158,8,17,wolkig
3/31/2016 22:00,257,89,168,7,17,Klarer Himmel
3/31/2016 23:00,199,81,118,7,17,Klarer Himmel
4/1/2016 0:00,125,31,94,6,20,Klarer Himmel
4/1/2016 1:00,47,13,34,6,19,Klarer Himmel
4/1/2016 2:00,20,11,9,6,11,Klarer Himmel
4/1/2016 3:00,18,11,7,5,9,Klarer Himmel
4/1/2016 4:00,19,14,5,5,13,Klarer Himmel
4/1/2016 5:00,40,20,20,3,9,teilweise bewölkt
4/1/2016 6:00,109,86,23,2,6,Klarer Himmel
4/1/2016 7:00,398,269,129,2,4,Klarer Himmel
4/1/2016 8:00,666,405,261,5,9,Klarer Himmel
4/1/2016 9:00,563,333,230,6,9,Klarer Himmel
4/1/2016 10:00,466,259,207,8,6,Klarer Himmel
4/1/2016 11:00,456,263,193,9,6,teilweise bewölkt
4/1/2016 12:00,641,411,230,11,7,teilweise bewölkt
4/1/2016 13:00,647,334,313,12,9,teilweise bewölkt
4/1/2016 14:00,647,343,304,13,9,teilweise bewölkt
4/1/2016 15:00,697,394,303,13,9,teilweise bewölkt
4/1/2016 16:00,770,399,371,14,6,Klarer Himmel
4/1/2016 17:00,760,366,394,13,13,Klarer Himmel
4/1/2016 18:00,696,321,375,12,6,Klarer Himmel
4/1/2016 19:00,589,278,311,11,4,Klarer Himmel
4/1/2016 20:00,496,281,215,10,6,Klarer Himmel
4/1/2016 21:00,369,183,186,9,6,Klarer Himmel
4/1/2016 22:00,272,125,147,8,6,Klarer Himmel
4/1/2016 23:00,238,116,122,8,6,Klarer Himmel
4/2/2016 0:00,282,86,196,7,6,Klarer Himmel
4/2/2016 1:00,188,63,125,6,4,Klarer Himmel
4/2/2016 2:00,105,39,66,6,6,Klarer Himmel
4/2/2016 3:00,97,29,68,5,6,Klarer Himmel
4/2/2016 4:00,82,32,50,5,6,Klarer Himmel
4/2/2016 5:00,72,26,46,5,7,Klarer Himmel
4/2/2016 6:00,47,24,23,4,6,Klarer Himmel
4/2/2016 7:00,62,44,18,4,6,Klarer Himmel
4/2/2016 8:00,188,124,64,6,7,Klarer Himmel
4/2/2016 9:00,314,239,75,8,13,Klarer Himmel
4/2/2016 10:00,450,337,113,10,9,Klarer Himmel
4/2/2016 11:00,538,358,180,11,9,Klarer Himmel
4/2/2016 12:00,630,404,226,13,11,Klarer Himmel
4/2/2016 13:00,656,396,260,14,11,teilweise bewölkt
4/2/2016 14:00,742,408,334,14,13,teilweise bewölkt
4/2/2016 15:00,616,331,285,14,13,Klarer Himmel
4/2/2016 16:00,561,261,300,15,9,Klarer Himmel
4/2/2016 17:00,587,246,341,15,7,Klarer Himmel
4/2/2016 18:00,551,256,295,14,4,Klarer Himmel
4/2/2016 19:00,515,244,271,14,6,Klarer Himmel
4/2/2016 20:00,401,207,194,12,6,Klarer Himmel
4/2/2016 21:00,286,126,160,12,6,Klarer Himmel
4/2/2016 22:00,230,95,135,13,6,Klarer Himmel
4/2/2016 23:00,200,86,114,13,6,Klarer Himmel
4/3/2016 0:00,241,98,143,12,7,Klarer Himmel
4/3/2016 1:00,232,96,136,12,2,Klarer Himmel
4/3/2016 2:00,156,50,106,11,6,Klarer Himmel
4/3/2016 3:00,132,28,104,12,6,Regen
4/3/2016 4:00,68,28,40,11,4,Klarer Himmel
4/3/2016 5:00,39,9,30,11,6,Klarer Himmel
4/3/2016 6:00,39,20,19,11,6,Klarer Himmel
4/3/2016 7:00,34,23,11,11,4,Klarer Himmel
4/3/2016 8:00,91,70,21,12,9,Klarer Himmel
4/3/2016 9:00,129,78,51,13,6,Klarer Himmel
4/3/2016 10:00,241,148,93,14,9,Klarer Himmel
4/3/2016 11:00,230,136,94,15,11,wolkig
4/3/2016 12:00,335,205,130,16,7,wolkig
4/3/2016 13:00,360,203,157,17,11,Klarer Himmel
4/3/2016 14:00,494,306,188,19,13,Klarer Himmel
4/3/2016 15:00,562,330,232,20,9,wolkig
4/3/2016 16:00,631,378,253,20,19,wolkig
4/3/2016 17:00,606,294,312,20,9,wolkig
4/3/2016 18:00,548,231,317,20,7,wolkig
4/3/2016 19:00,427,171,256,19,2,wolkig
4/3/2016 20:00,328,99,229,18,6,wolkig
4/3/2016 21:00,188,61,127,18,11,Klarer Himmel
4/3/2016 22:00,192,51,141,17,13,Klarer Himmel
4/3/2016 23:00,113,39,74,16,11,Regen
4/4/2016 0:00,54,15,39,15,11,Regen
4/4/2016 1:00,30,11,19,15,11,Regen
4/4/2016 2:00,11,5,6,14,7,Regen
4/4/2016 3:00,5,5,0,13,9,Klarer Himmel
4/4/2016 4:00,15,11,4,14,13,Klarer Himmel
4/4/2016 5:00,52,35,17,14,11,Klarer Himmel
4/4/2016 6:00,162,124,38,13,15,Klarer Himmel
4/4/2016 7:00,726,503,223,14,13,wolkig
4/4/2016 8:00,916,515,401,15,13,wolkig
4/4/2016 9:00,681,375,306,17,19,teilweise bewölkt
4/4/2016 10:00,601,341,260,17,19,teilweise bewölkt
4/4/2016 11:00,626,382,244,18,19,wolkig
4/4/2016 12:00,722,389,333,19,22,teilweise bewölkt
4/4/2016 13:00,722,358,364,18,32,wolkig
4/4/2016 14:00,782,415,367,15,32,wolkig
4/4/2016 15:00,835,386,449,16,22,wolkig
4/4/2016 16:00,881,442,439,16,19,wolkig
4/4/2016 17:00,1048,524,524,15,19,wolkig
4/4/2016 18:00,902,412,490,15,11,wolkig
4/4/2016 19:00,796,378,418,14,7,Klarer Himmel
4/4/2016 20:00,526,242,284,11,2,Klarer Himmel
4/4/2016 21:00,366,170,196,9,4,Klarer Himmel
4/4/2016 22:00,321,122,199,11,6,Klarer Himmel
4/4/2016 23:00,186,63,123,11,6,Klarer Himmel
4/5/2016 0:00,112,33,79,10,6,teilweise bewölkt
4/5/2016 1:00,51,9,42,10,4,teilweise bewölkt
4/5/2016 2:00,38,16,22,11,6,Klarer Himmel
4/5/2016 3:00,29,7,22,11,4,Klarer Himmel
4/5/2016 4:00,23,11,12,12,4,wolkig
4/5/2016 5:00,47,34,13,12,6,wolkig
4/5/2016 6:00,152,120,32,12,6,wolkig
4/5/2016 7:00,654,445,209,11,11,wolkig
4/5/2016 8:00,934,524,410,12,11,Regen
4/5/2016 9:00,641,383,258,12,11,Regen
4/5/2016 10:00,456,262,194,13,9,Regen
4/5/2016 11:00,490,248,242,13,11,Regen
4/5/2016 12:00,481,235,246,12,9,Regen
4/5/2016 13:00,587,261,326,12,9,Regen
4/5/2016 14:00,554,316,238,12,17,Regen
4/5/2016 15:00,668,355,313,11,17,Regen
4/5/2016 16:00,678,322,356,11,15,Regen
4/5/2016 17:00,856,418,438,11,11,Regen
4/5/2016 18:00,713,327,386,11,11,Regen
4/5/2016 19:00,770,452,318,11,6,wolkig
4/5/2016 20:00,470,249,221,10,9,teilweise bewölkt
4/5/2016 21:00,298,140,158,10,9,
4/5/2016 22:00,340,111,229,9,11,
4/5/2016 23:00,201,55,146,8,7,
4/6/2016 0:00,117,35,82,8,6,
4/6/2016 1:00,57,19,38,7,7,
4/6/2016 2:00,52,5,47,7,9,Nebel
4/6/2016 3:00,14,4,10,7,11,Nebel
4/6/2016 4:00,24,10,14,8,13,wolkig
4/6/2016 5:00,52,33,19,8,15,wolkig
4/6/2016 6:00,149,114,35,8,15,wolkig
4/6/2016 7:00,675,478,197,8,15,wolkig
4/6/2016 8:00,810,447,363,8,15,wolkig
4/6/2016 9:00,719,468,251,8,17,wolkig
4/6/2016 10:00,567,326,241,9,19,wolkig
4/6/2016 11:00,592,318,274,9,20,wolkig
4/6/2016 12:00,635,323,312,11,20,wolkig
4/6/2016 13:00,694,354,340,12,30,teilweise bewölkt
4/6/2016 14:00,722,378,344,12,30,wolkig
4/6/2016 15:00,811,403,408,12,33,wolkig
4/6/2016 16:00,817,419,398,12,28,Regen
4/6/2016 17:00,1006,482,524,12,26,Regen
4/6/2016 18:00,932,444,488,12,26,Regen
4/6/2016 19:00,721,364,357,11,20,wolkig
4/6/2016 20:00,545,271,274,11,22,Regen
4/6/2016 21:00,383,170,213,9,20,Regen
4/6/2016 22:00,346,141,205,8,46,Regen
4/6/2016 23:00,267,123,144,7,20,Klarer Himmel
4/7/2016 0:00,215,108,107,7,17,Regen
4/7/2016 1:00,127,36,91,7,15,wolkig
4/7/2016 2:00,103,15,88,6,13,teilweise bewölkt
4/7/2016 3:00,75,3,72,6,15,teilweise bewölkt
4/7/2016 4:00,94,20,74,6,22,teilweise bewölkt
4/7/2016 5:00,72,36,36,6,17,Klarer Himmel
4/7/2016 6:00,170,121,49,6,15,teilweise bewölkt
4/7/2016 7:00,640,433,207,6,13,teilweise bewölkt
4/7/2016 8:00,809,474,335,6,20,teilweise bewölkt
4/7/2016 9:00,660,396,264,7,22,teilweise bewölkt
4/7/2016 10:00,539,314,225,8,26,teilweise bewölkt
4/7/2016 11:00,547,314,233,9,30,teilweise bewölkt
4/7/2016 12:00,614,333,281,10,30,teilweise bewölkt
4/7/2016 13:00,730,357,373,10,28,wolkig
4/7/2016 14:00,758,410,348,11,33,teilweise bewölkt
4/7/2016 15:00,780,392,388,11,30,teilweise bewölkt
4/7/2016 16:00,842,435,407,12,30,teilweise bewölkt
4/7/2016 17:00,990,518,472,11,22,teilweise bewölkt
4/7/2016 18:00,1031,509,522,10,24,teilweise bewölkt
4/7/2016 19:00,766,346,420,8,13,teilweise bewölkt
4/7/2016 20:00,548,279,269,8,11,teilweise bewölkt
4/7/2016 21:00,350,167,183,7,13,Klarer Himmel
4/7/2016 22:00,282,119,163,7,13,Klarer Himmel
4/7/2016 23:00,353,139,214,7,15,Klarer Himmel
4/8/2016 0:00,142,37,105,6,13,Klarer Himmel
4/8/2016 1:00,95,38,57,5,9,Klarer Himmel
4/8/2016 2:00,57,16,41,5,7,Klarer Himmel
4/8/2016 3:00,32,13,19,3,6,teilweise bewölkt
4/8/2016 4:00,31,15,16,3,6,teilweise bewölkt
4/8/2016 5:00,52,31,21,4,7,wolkig
4/8/2016 6:00,169,132,37,5,13,wolkig
4/8/2016 7:00,657,467,190,5,9,wolkig
4/8/2016 8:00,766,448,318,6,11,wolkig
4/8/2016 9:00,568,351,217,6,11,wolkig
4/8/2016 10:00,504,310,194,7,13,wolkig
4/8/2016 11:00,524,324,200,8,9,wolkig
4/8/2016 12:00,610,354,256,9,13,wolkig
4/8/2016 13:00,726,340,386,10,13,wolkig
4/8/2016 14:00,759,404,355,11,11,wolkig
4/8/2016 15:00,756,403,353,11,13,wolkig
4/8/2016 16:00,731,392,339,11,13,wolkig
4/8/2016 17:00,836,434,402,11,13,wolkig
4/8/2016 18:00,747,369,378,11,7,wolkig
4/8/2016 19:00,738,380,358,10,6,wolkig
4/8/2016 20:00,517,248,269,7,4,teilweise bewölkt
4/8/2016 21:00,401,171,230,7,4,Klarer Himmel
4/8/2016 22:00,297,135,162,7,4,Klarer Himmel
4/8/2016 23:00,278,98,180,5,2,Klarer Himmel
4/9/2016 0:00,222,81,141,4,4,Klarer Himmel
4/9/2016 1:00,207,84,123,3,2,Klarer Himmel
4/9/2016 2:00,190,77,113,2,2,Nebel
4/9/2016 3:00,108,33,75,2,2,Nebel
4/9/2016 4:00,80,21,59,1,2,Nebel
4/9/2016 5:00,62,24,38,2,6,Nebel
4/9/2016 6:00,62,43,19,2,6,Nebel
4/9/2016 7:00,103,68,35,3,4,Nebel
4/9/2016 8:00,231,157,74,5,4,
4/9/2016 9:00,364,280,84,7,7,
4/9/2016 10:00,536,387,149,10,11,Klarer Himmel
4/9/2016 11:00,608,407,201,12,11,teilweise bewölkt
4/9/2016 12:00,738,497,241,13,9,teilweise bewölkt
4/9/2016 13:00,826,490,336,13,7,teilweise bewölkt
4/9/2016 14:00,746,406,340,14,15,teilweise bewölkt
4/9/2016 15:00,746,383,363,15,11,Klarer Himmel
4/9/2016 16:00,759,349,410,15,9,Klarer Himmel
4/9/2016 17:00,721,345,376,15,9,teilweise bewölkt
4/9/2016 18:00,753,339,414,14,13,Klarer Himmel
4/9/2016 19:00,753,394,359,13,6,Klarer Himmel
4/9/2016 20:00,550,259,291,12,6,Klarer Himmel
4/9/2016 21:00,442,220,222,11,6,Klarer Himmel
4/9/2016 22:00,353,154,199,11,7,Klarer Himmel
4/9/2016 23:00,321,110,211,10,7,Klarer Himmel
4/10/2016 0:00,329,152,177,10,7,Klarer Himmel
4/10/2016 1:00,247,89,158,10,6,Klarer Himmel
4/10/2016 2:00,170,59,111,10,7,Klarer Himmel
4/10/2016 3:00,151,46,105,10,6,Klarer Himmel
4/10/2016 4:00,100,32,68,10,7,Klarer Himmel
4/10/2016 5:00,70,17,53,10,9,Klarer Himmel
4/10/2016 6:00,55,36,19,10,7,Klarer Himmel
4/10/2016 7:00,47,27,20,9,6,Klarer Himmel
4/10/2016 8:00,84,59,25,10,9,Klarer Himmel
4/10/2016 9:00,176,131,45,12,11,Klarer Himmel
4/10/2016 10:00,281,194,87,13,9,wolkig
4/10/2016 11:00,330,229,101,14,9,wolkig
4/10/2016 12:00,524,314,210,15,9,wolkig
4/10/2016 13:00,568,314,254,16,13,wolkig
4/10/2016 14:00,710,432,278,16,9,teilweise bewölkt
4/10/2016 15:00,769,424,345,17,11,teilweise bewölkt
4/10/2016 16:00,689,362,327,17,15,teilweise bewölkt
4/10/2016 17:00,794,380,414,16,11,teilweise bewölkt
4/10/2016 18:00,756,345,411,15,7,Klarer Himmel
4/10/2016 19:00,640,279,361,15,7,Klarer Himmel
4/10/2016 20:00,477,173,304,13,6,Klarer Himmel
4/10/2016 21:00,358,129,229,12,7,Klarer Himmel
4/10/2016 22:00,259,109,150,11,7,Klarer Himmel
4/10/2016 23:00,117,33,84,11,9,Klarer Himmel
4/11/2016 0:00,62,17,45,10,11,Klarer Himmel
4/11/2016 1:00,21,6,15,9,11,Klarer Himmel
4/11/2016 2:00,17,1,16,8,11,Klarer Himmel
4/11/2016 3:00,2,2,0,8,13,Klarer Himmel
4/11/2016 4:00,18,12,6,8,9,Klarer Himmel
4/11/2016 5:00,44,32,12,7,11,Klarer Himmel
4/11/2016 6:00,167,124,43,7,11,Klarer Himmel
4/11/2016 7:00,883,614,269,7,11,Klarer Himmel
4/11/2016 8:00,1104,659,445,9,15,Klarer Himmel
4/11/2016 9:00,982,536,446,10,17,Klarer Himmel
4/11/2016 10:00,911,532,379,11,19,Klarer Himmel
4/11/2016 11:00,1065,551,514,12,17,teilweise bewölkt
4/11/2016 12:00,1086,594,492,13,13,teilweise bewölkt
4/11/2016 13:00,1338,669,669,14,19,Klarer Himmel
4/11/2016 14:00,1169,617,552,16,15,Klarer Himmel
4/11/2016 15:00,1410,734,676,16,17,Klarer Himmel
4/11/2016 16:00,1453,816,637,16,15,Klarer Himmel
4/11/2016 17:00,1725,886,839,16,13,Klarer Himmel
4/11/2016 18:00,1542,756,786,16,17,Klarer Himmel
4/11/2016 19:00,1242,589,653,14,13,Klarer Himmel
4/11/2016 20:00,971,416,555,13,9,Klarer Himmel
4/11/2016 21:00,624,211,413,12,9,Klarer Himmel
4/11/2016 22:00,442,132,310,11,7,Klarer Himmel
4/11/2016 23:00,318,98,220,10,9,Klarer Himmel
4/12/2016 0:00,128,40,88,9,7,Klarer Himmel
4/12/2016 1:00,93,16,77,9,9,Klarer Himmel
4/12/2016 2:00,43,7,36,9,7,Klarer Himmel
4/12/2016 3:00,37,6,31,8,7,Klarer Himmel
4/12/2016 4:00,25,9,16,8,6,Klarer Himmel
4/12/2016 5:00,51,32,19,8,11,
4/12/2016 6:00,193,143,50,8,7,
4/12/2016 7:00,958,640,318,8,7,Regen
4/12/2016 8:00,1235,700,535,9,4,
4/12/2016 9:00,1251,716,535,10,7,
4/12/2016 10:00,1104,576,528,13,4,teilweise bewölkt
4/12/2016 11:00,1074,616,458,15,9,Klarer Himmel
4/12/2016 12:00,1119,589,530,16,7,teilweise bewölkt
4/12/2016 13:00,1311,678,633,18,9,teilweise bewölkt
4/12/2016 14:00,1183,616,567,18,6,teilweise bewölkt
4/12/2016 15:00,1403,730,673,18,7,Klarer Himmel
4/12/2016 16:00,1489,731,758,18,7,Klarer Himmel
4/12/2016 17:00,1679,877,802,18,4,Klarer Himmel
4/12/2016 18:00,1448,716,732,18,6,Klarer Himmel
4/12/2016 19:00,1250,637,613,16,4,Klarer Himmel
4/12/2016 20:00,1107,542,565,15,6,Klarer Himmel
4/12/2016 21:00,573,244,329,12,22,
4/12/2016 22:00,525,163,362,11,13,Regen
4/12/2016 23:00,428,175,253,10,4,wolkig
4/13/2016 0:00,191,67,124,10,13,wolkig
4/13/2016 1:00,91,10,81,10,9,wolkig
4/13/2016 2:00,60,12,48,9,6,wolkig
4/13/2016 3:00,78,5,73,8,2,Nebel
4/13/2016 4:00,80,9,71,9,7,wolkig
4/13/2016 5:00,53,31,22,8,6,wolkig
4/13/2016 6:00,178,136,42,8,6,Nebel
4/13/2016 7:00,1200,862,338,8,7,teilweise bewölkt
4/13/2016 8:00,1296,723,573,9,4,wolkig
4/13/2016 9:00,1114,693,421,10,4,wolkig
4/13/2016 10:00,1224,643,581,11,4,wolkig
4/13/2016 11:00,1057,582,475,12,4,wolkig
4/13/2016 12:00,1221,657,564,13,6,wolkig
4/13/2016 13:00,1289,694,595,13,6,wolkig
4/13/2016 14:00,1237,609,628,14,4,wolkig
4/13/2016 15:00,1294,683,611,14,6,wolkig
4/13/2016 16:00,1371,671,700,14,9,wolkig
4/13/2016 17:00,1566,804,762,14,9,wolkig
4/13/2016 18:00,1370,682,688,14,7,wolkig
4/13/2016 19:00,1473,854,619,13,6,wolkig
4/13/2016 20:00,1119,540,579,10,24,Regen
4/13/2016 21:00,770,310,460,9,2,wolkig
4/13/2016 22:00,689,217,472,9,6,wolkig
4/13/2016 23:00,585,257,328,9,2,wolkig
4/14/2016 0:00,389,197,192,8,4,wolkig
4/14/2016 1:00,286,91,195,7,2,Nebel
4/14/2016 2:00,231,73,158,6,7,Nebel
4/14/2016 3:00,239,73,166,6,4,Nebel
4/14/2016 4:00,160,81,79,4,4,Nebel
4/14/2016 5:00,111,58,53,3,6,Nebel
4/14/2016 6:00,161,117,44,4,2,Nebel
4/14/2016 7:00,829,542,287,4,2,Nebel
4/14/2016 8:00,1235,672,563,7,6,
4/14/2016 9:00,1074,672,402,10,4,Klarer Himmel
4/14/2016 10:00,977,570,407,13,4,Klarer Himmel
4/14/2016 11:00,1090,610,480,14,7,teilweise bewölkt
4/14/2016 12:00,1076,571,505,14,13,teilweise bewölkt
4/14/2016 13:00,1276,636,640,16,13,teilweise bewölkt
4/14/2016 14:00,1167,562,605,15,15,Klarer Himmel
4/14/2016 15:00,1443,805,638,16,13,teilweise bewölkt
4/14/2016 16:00,1423,790,633,15,15,teilweise bewölkt
4/14/2016 17:00,1474,732,742,14,11,wolkig
4/14/2016 18:00,1312,621,691,14,6,wolkig
4/14/2016 19:00,1141,541,600,14,4,Klarer Himmel
4/14/2016 20:00,893,451,442,11,4,Klarer Himmel
4/14/2016 21:00,608,247,361,8,4,Klarer Himmel
4/14/2016 22:00,400,150,250,7,4,Klarer Himmel
4/14/2016 23:00,485,172,313,8,4,Klarer Himmel
4/15/2016 0:00,184,75,109,10,2,wolkig
4/15/2016 1:00,82,30,52,10,7,Regen
4/15/2016 2:00,55,5,50,9,6,Klarer Himmel
4/15/2016 3:00,35,5,30,8,11,Klarer Himmel
4/15/2016 4:00,34,13,21,8,11,Klarer Himmel
4/15/2016 5:00,49,28,21,10,13,Regen
4/15/2016 6:00,127,96,31,9,4,Regen
4/15/2016 7:00,552,385,167,9,4,Regen
4/15/2016 8:00,785,440,345,9,6,Regen
4/15/2016 9:00,729,456,273,9,6,wolkig
4/15/2016 10:00,788,380,408,10,7,wolkig
4/15/2016 11:00,724,449,275,12,15,Regen
4/15/2016 12:00,787,416,371,11,17,Regen
4/15/2016 13:00,746,383,363,12,20,Regen
4/15/2016 14:00,777,414,363,11,32,Regen
4/15/2016 15:00,705,380,325,12,24,Regen
4/15/2016 16:00,685,352,333,12,19,wolkig
4/15/2016 17:00,788,415,373,12,28,Klarer Himmel
4/15/2016 18:00,781,415,366,13,17,teilweise bewölkt
4/15/2016 19:00,827,465,362,12,9,teilweise bewölkt
4/15/2016 20:00,816,531,285,8,6,teilweise bewölkt
4/15/2016 21:00,604,315,289,9,2,wolkig
4/15/2016 22:00,502,185,317,7,6,Klarer Himmel
4/15/2016 23:00,369,112,257,6,4,Klarer Himmel
4/16/2016 0:00,323,146,177,6,6,Klarer Himmel
4/16/2016 1:00,267,88,179,7,4,teilweise bewölkt
4/16/2016 2:00,180,38,142,8,7,teilweise bewölkt
4/16/2016 3:00,117,33,84,9,7,wolkig
4/16/2016 4:00,84,25,59,9,13,wolkig
4/16/2016 5:00,60,24,36,10,17,teilweise bewölkt
4/16/2016 6:00,59,38,21,11,17,wolkig
4/16/2016 7:00,126,105,21,11,24,wolkig
4/16/2016 8:00,212,143,69,10,32,Regen
4/16/2016 9:00,373,269,104,11,15,wolkig
4/16/2016 10:00,395,287,108,12,37,teilweise bewölkt
4/16/2016 11:00,488,333,155,13,28,teilweise bewölkt
4/16/2016 12:00,586,364,222,13,28,teilweise bewölkt
4/16/2016 13:00,612,353,259,15,26,Regen
4/16/2016 14:00,499,252,247,11,35,Regen
4/16/2016 15:00,603,283,320,13,32,Regen
4/16/2016 16:00,519,272,247,12,22,Regen
4/16/2016 17:00,481,197,284,11,19,Regen
4/16/2016 18:00,533,261,272,11,22,Regen
4/16/2016 19:00,473,233,240,10,19,wolkig
4/16/2016 20:00,516,298,218,9,17,wolkig
4/16/2016 21:00,385,207,178,8,15,wolkig
4/16/2016 22:00,338,144,194,7,9,wolkig
4/16/2016 23:00,241,79,162,6,6,wolkig
4/17/2016 0:00,236,112,124,6,7,teilweise bewölkt
4/17/2016 1:00,238,123,115,5,6,Klarer Himmel
4/17/2016 2:00,188,54,134,3,6,Klarer Himmel
4/17/2016 3:00,143,43,100,3,6,teilweise bewölkt
4/17/2016 4:00,94,29,65,4,6,wolkig
4/17/2016 5:00,72,20,52,4,4,wolkig
4/17/2016 6:00,31,13,18,5,7,wolkig
4/17/2016 7:00,42,26,16,5,7,Regen
4/17/2016 8:00,85,62,23,6,13,Regen
4/17/2016 9:00,182,144,38,7,13,Regen
4/17/2016 10:00,271,172,99,7,13,wolkig
4/17/2016 11:00,354,203,151,9,19,teilweise bewölkt
4/17/2016 12:00,442,248,194,10,19,teilweise bewölkt
4/17/2016 13:00,496,273,223,10,17,teilweise bewölkt
4/17/2016 14:00,559,351,208,9,20,Regen
4/17/2016 15:00,582,351,231,10,20,teilweise bewölkt
4/17/2016 16:00,588,354,234,9,15,Regen
4/17/2016 17:00,621,338,283,9,17,Regen
4/17/2016 18:00,688,349,339,8,15,teilweise bewölkt
4/17/2016 19:00,550,253,297,8,9,teilweise bewölkt
4/17/2016 20:00,424,155,269,7,6,teilweise bewölkt
4/17/2016 21:00,260,113,147,4,2,Klarer Himmel
4/17/2016 22:00,219,66,153,4,2,Klarer Himmel
4/17/2016 23:00,139,61,78,3,4,teilweise bewölkt
4/18/2016 0:00,70,20,50,3,6,teilweise bewölkt
4/18/2016 1:00,28,8,20,2,2,Klarer Himmel
4/18/2016 2:00,10,5,5,2,2,Klarer Himmel
4/18/2016 3:00,8,3,5,0,2,Klarer Himmel
4/18/2016 4:00,21,16,5,0,2,Nebel
4/18/2016 5:00,44,33,11,0,4,Nebel
4/18/2016 6:00,171,123,48,0,2,Nebel
4/18/2016 7:00,824,556,268,2,4,Klarer Himmel
4/18/2016 8:00,1285,751,534,6,11,Klarer Himmel
4/18/2016 9:00,1050,593,457,8,20,Klarer Himmel
4/18/2016 10:00,1016,564,452,9,20,teilweise bewölkt
4/18/2016 11:00,1028,550,478,11,24,teilweise bewölkt
4/18/2016 12:00,1131,532,599,11,28,teilweise bewölkt
4/18/2016 13:00,1298,637,661,11,24,wolkig
4/18/2016 14:00,1135,610,525,11,22,wolkig
4/18/2016 15:00,1406,767,639,12,24,wolkig
4/18/2016 16:00,1322,660,662,12,28,wolkig
4/18/2016 17:00,1690,826,864,12,30,wolkig
4/18/2016 18:00,1310,632,678,11,28,wolkig
4/18/2016 19:00,1243,599,644,11,20,wolkig
4/18/2016 20:00,693,293,400,10,20,teilweise bewölkt
4/18/2016 21:00,449,195,254,9,17,Klarer Himmel
4/18/2016 22:00,452,152,300,9,20,wolkig
4/18/2016 23:00,216,93,123,9,17,Klarer Himmel
4/19/2016 0:00,104,33,71,9,17,Klarer Himmel
4/19/2016 1:00,52,15,37,9,15,wolkig
4/19/2016 2:00,13,6,7,8,22,wolkig
4/19/2016 3:00,9,6,3,8,15,wolkig
4/19/2016 4:00,17,10,7,8,17,wolkig
4/19/2016 5:00,39,30,9,8,15,wolkig
4/19/2016 6:00,157,124,33,8,17,Klarer Himmel
4/19/2016 7:00,961,646,315,8,17,Klarer Himmel
4/19/2016 8:00,1451,885,566,9,17,wolkig
4/19/2016 9:00,1273,666,607,10,22,wolkig
4/19/2016 10:00,1200,612,588,11,22,wolkig
4/19/2016 11:00,1111,625,486,12,19,teilweise bewölkt
4/19/2016 12:00,1150,590,560,13,17,wolkig
4/19/2016 13:00,1243,651,592,14,20,wolkig
4/19/2016 14:00,1216,613,603,13,19,teilweise bewölkt
4/19/2016 15:00,1312,741,571,12,19,teilweise bewölkt
4/19/2016 16:00,1513,644,869,13,24,teilweise bewölkt
4/19/2016 17:00,1574,815,759,13,26,teilweise bewölkt
4/19/2016 18:00,1472,743,729,12,24,teilweise bewölkt
4/19/2016 19:00,1256,704,552,10,20,teilweise bewölkt
4/19/2016 20:00,951,454,497,8,17,teilweise bewölkt
4/19/2016 21:00,560,228,332,7,13,Klarer Himmel
4/19/2016 22:00,592,192,400,7,11,teilweise bewölkt
4/19/2016 23:00,321,122,199,6,11,teilweise bewölkt
4/20/2016 0:00,121,37,84,5,6,Klarer Himmel
4/20/2016 1:00,95,23,72,4,4,Klarer Himmel
4/20/2016 2:00,48,19,29,2,6,Klarer Himmel
4/20/2016 3:00,44,5,39,2,4,Klarer Himmel
4/20/2016 4:00,30,14,16,1,0,teilweise bewölkt
4/20/2016 5:00,58,46,12,1,4,Nebel
4/20/2016 6:00,174,132,42,1,4,Nebel
4/20/2016 7:00,1003,747,256,3,2,teilweise bewölkt
4/20/2016 8:00,1480,821,659,6,7,teilweise bewölkt
4/20/2016 9:00,1152,694,458,8,11,teilweise bewölkt
4/20/2016 10:00,1233,659,574,9,9,teilweise bewölkt
4/20/2016 11:00,1078,603,475,10,11,teilweise bewölkt
4/20/2016 12:00,1170,612,558,10,11,teilweise bewölkt
4/20/2016 13:00,1263,613,650,11,9,teilweise bewölkt
4/20/2016 14:00,1287,699,588,12,7,Klarer Himmel
4/20/2016 15:00,1432,741,691,13,9,Klarer Himmel
4/20/2016 16:00,1410,711,699,13,11,Klarer Himmel
4/20/2016 17:00,1603,753,850,13,15,Klarer Himmel
4/20/2016 18:00,1507,679,828,13,11,Klarer Himmel
4/20/2016 19:00,1315,713,602,12,11,Klarer Himmel
4/20/2016 20:00,991,497,494,9,7,Klarer Himmel
4/20/2016 21:00,558,270,288,9,13,Klarer Himmel
4/20/2016 22:00,567,202,365,8,15,Klarer Himmel
4/20/2016 23:00,423,178,245,6,9,Klarer Himmel
4/21/2016 0:00,249,132,117,5,7,Klarer Himmel
4/21/2016 1:00,158,45,113,4,4,Klarer Himmel
4/21/2016 2:00,101,12,89,3,4,Klarer Himmel
4/21/2016 3:00,92,18,74,3,2,Klarer Himmel
4/21/2016 4:00,103,14,89,2,6,Klarer Himmel
4/21/2016 5:00,105,48,57,3,6,Klarer Himmel
4/21/2016 6:00,179,122,57,3,2,Klarer Himmel
4/21/2016 7:00,833,535,298,5,6,Klarer Himmel
4/21/2016 8:00,1243,683,560,7,6,Klarer Himmel
4/21/2016 9:00,1048,617,431,10,6,Klarer Himmel
4/21/2016 10:00,1091,613,478,11,9,Klarer Himmel
4/21/2016 11:00,1091,627,464,12,9,Klarer Himmel
4/21/2016 12:00,1119,564,555,14,9,Klarer Himmel
4/21/2016 13:00,1326,699,627,14,9,Klarer Himmel
4/21/2016 14:00,1316,677,639,16,9,Klarer Himmel
4/21/2016 15:00,1495,804,691,16,13,Klarer Himmel
4/21/2016 16:00,1497,795,702,16,13,Klarer Himmel
4/21/2016 17:00,1666,831,835,16,9,Klarer Himmel
4/21/2016 18:00,1508,735,773,15,15,Klarer Himmel
4/21/2016 19:00,1282,565,717,14,13,Klarer Himmel
4/21/2016 20:00,862,333,529,11,9,Klarer Himmel
4/21/2016 21:00,613,237,376,8,7,Klarer Himmel
4/21/2016 22:00,477,177,300,9,17,Klarer Himmel
4/21/2016 23:00,363,168,195,8,20,Klarer Himmel
4/22/2016 0:00,159,50,109,6,11,Klarer Himmel
4/22/2016 1:00,78,14,64,4,4,Klarer Himmel
4/22/2016 2:00,47,17,30,4,2,Klarer Himmel
4/22/2016 3:00,24,6,18,2,9,Klarer Himmel
4/22/2016 4:00,19,9,10,2,2,Klarer Himmel
4/22/2016 5:00,64,43,21,2,2,Nebel
4/22/2016 6:00,149,115,34,2,4,Nebel
4/22/2016 7:00,760,532,228,5,6,Klarer Himmel
4/22/2016 8:00,1186,711,475,7,15,wolkig
4/22/2016 9:00,1001,620,381,8,22,wolkig
4/22/2016 10:00,864,460,404,9,13,wolkig
4/22/2016 11:00,886,540,346,10,7,wolkig
4/22/2016 12:00,985,523,462,11,11,wolkig
4/22/2016 13:00,1060,487,573,12,11,Klarer Himmel
4/22/2016 14:00,1117,549,568,13,4,Klarer Himmel
4/22/2016 15:00,980,528,452,13,15,Klarer Himmel
4/22/2016 16:00,999,523,476,13,13,Klarer Himmel
4/22/2016 17:00,1047,521,526,13,13,Klarer Himmel
4/22/2016 18:00,973,494,479,12,15,Klarer Himmel
4/22/2016 19:00,807,412,395,11,15,Klarer Himmel
4/22/2016 20:00,639,333,306,10,17,Klarer Himmel
4/22/2016 21:00,481,176,305,9,15,Klarer Himmel
4/22/2016 22:00,378,146,232,8,15,Klarer Himmel
4/22/2016 23:00,342,158,184,7,15,Klarer Himmel
4/23/2016 0:00,331,136,195,6,11,Klarer Himmel
4/23/2016 1:00,266,109,157,6,7,Klarer Himmel
4/23/2016 2:00,186,59,127,5,7,Klarer Himmel
4/23/2016 3:00,179,52,127,5,7,Klarer Himmel
4/23/2016 4:00,81,20,61,4,7,Klarer Himmel
4/23/2016 5:00,67,21,46,4,4,Klarer Himmel
4/23/2016 6:00,44,34,10,4,6,Klarer Himmel
4/23/2016 7:00,157,132,25,4,11,wolkig
4/23/2016 8:00,228,149,79,6,15,wolkig
4/23/2016 9:00,345,256,89,6,15,wolkig
4/23/2016 10:00,412,275,137,6,13,teilweise bewölkt
4/23/2016 11:00,428,265,163,7,15,teilweise bewölkt
4/23/2016 12:00,531,317,214,7,20,teilweise bewölkt
4/23/2016 13:00,548,281,267,9,17,wolkig
4/23/2016 14:00,539,307,232,9,13,teilweise bewölkt
4/23/2016 15:00,481,241,240,7,20,teilweise bewölkt
4/23/2016 16:00,527,224,303,9,22,teilweise bewölkt
4/23/2016 17:00,463,214,249,8,19,teilweise bewölkt
4/23/2016 18:00,463,215,248,7,9,teilweise bewölkt
4/23/2016 19:00,419,228,191,6,17,Regen
4/23/2016 20:00,392,208,184,5,13,teilweise bewölkt
4/23/2016 21:00,295,163,132,5,11,teilweise bewölkt
4/23/2016 22:00,250,123,127,3,6,teilweise bewölkt
4/23/2016 23:00,235,94,141,3,9,teilweise bewölkt
4/24/2016 0:00,284,96,188,2,11,teilweise bewölkt
4/24/2016 1:00,182,55,127,2,11,Klarer Himmel
4/24/2016 2:00,188,53,135,3,13,wolkig
4/24/2016 3:00,139,38,101,2,11,teilweise bewölkt
4/24/2016 4:00,83,34,49,2,13,teilweise bewölkt
4/24/2016 5:00,37,13,24,1,13,teilweise bewölkt
4/24/2016 6:00,47,22,25,1,15,teilweise bewölkt
4/24/2016 7:00,45,26,19,2,17,teilweise bewölkt
4/24/2016 8:00,87,53,34,4,19,teilweise bewölkt
4/24/2016 9:00,178,127,51,5,24,teilweise bewölkt
4/24/2016 10:00,264,176,88,6,19,teilweise bewölkt
4/24/2016 11:00,205,127,78,5,22,teilweise bewölkt
4/24/2016 12:00,252,125,127,5,4,teilweise bewölkt
4/24/2016 13:00,311,174,137,6,19,teilweise bewölkt
4/24/2016 14:00,337,188,149,8,24,teilweise bewölkt
4/24/2016 15:00,309,167,142,7,30,teilweise bewölkt
4/24/2016 16:00,359,188,171,5,6,teilweise bewölkt
4/24/2016 17:00,410,201,209,6,7,teilweise bewölkt
4/24/2016 18:00,370,159,211,6,20,wolkig
4/24/2016 19:00,333,140,193,6,9,teilweise bewölkt
4/24/2016 20:00,279,103,176,4,13,Regen
4/24/2016 21:00,226,92,134,4,19,teilweise bewölkt
4/24/2016 22:00,172,56,116,1,11,teilweise bewölkt
4/24/2016 23:00,135,38,97,1,11,teilweise bewölkt
4/25/2016 0:00,44,9,35,1,7,wolkig
4/25/2016 1:00,24,16,8,1,9,teilweise bewölkt
4/25/2016 2:00,3,2,1,0,9,Klarer Himmel
4/25/2016 3:00,5,1,4,1,9,teilweise bewölkt
4/25/2016 4:00,16,13,3,0,7,teilweise bewölkt
4/25/2016 5:00,41,26,15,1,9,Nebel
4/25/2016 6:00,151,115,36,1,13,teilweise bewölkt
4/25/2016 7:00,673,475,198,2,11,Klarer Himmel
4/25/2016 8:00,1142,679,463,4,19,teilweise bewölkt
4/25/2016 9:00,955,539,416,6,19,wolkig
4/25/2016 10:00,934,506,428,6,28,wolkig
4/25/2016 11:00,875,468,407,7,24,teilweise bewölkt
4/25/2016 12:00,974,482,492,9,28,wolkig
4/25/2016 13:00,1117,565,552,8,32,Regen
4/25/2016 14:00,941,469,472,8,22,wolkig
4/25/2016 15:00,1138,563,575,7,32,Regen
4/25/2016 16:00,1098,517,581,6,22,Regen
4/25/2016 17:00,1188,617,571,4,19,Regen
4/25/2016 18:00,1040,542,498,4,13,Regen
4/25/2016 19:00,863,479,384,3,17,Regen
4/25/2016 20:00,514,213,301,3,7,wolkig
4/25/2016 21:00,321,125,196,3,9,wolkig
4/25/2016 22:00,274,111,163,4,17,wolkig
4/25/2016 23:00,170,48,122,3,13,wolkig
4/26/2016 0:00,155,28,127,3,17,wolkig
4/26/2016 1:00,120,12,108,2,15,teilweise bewölkt
4/26/2016 2:00,74,11,63,2,13,teilweise bewölkt
4/26/2016 3:00,56,7,49,1,15,Klarer Himmel
4/26/2016 4:00,36,11,25,1,13,Klarer Himmel
4/26/2016 5:00,52,34,18,1,13,Klarer Himmel
4/26/2016 6:00,164,120,44,1,19,Schnee
4/26/2016 7:00,795,545,250,3,22,wolkig
4/26/2016 8:00,1286,787,499,3,30,Schnee
4/26/2016 9:00,881,414,467,3,28,Regen
4/26/2016 10:00,964,538,426,4,30,wolkig
4/26/2016 11:00,840,443,397,5,33,Regen
4/26/2016 12:00,916,463,453,2,9,Schnee
4/26/2016 13:00,1072,566,506,6,30,Regen
4/26/2016 14:00,986,499,487,1,13,Schnee
4/26/2016 15:00,1000,518,482,6,28,teilweise bewölkt
4/26/2016 16:00,1289,609,680,7,22,wolkig
4/26/2016 17:00,1360,697,663,6,30,wolkig
4/26/2016 18:00,1230,616,614,5,22,Regen
4/26/2016 19:00,1046,578,468,4,26,Regen
4/26/2016 20:00,682,315,367,4,26,wolkig
4/26/2016 21:00,503,174,329,4,22,teilweise bewölkt
4/26/2016 22:00,367,113,254,4,32,wolkig
4/26/2016 23:00,259,76,183,4,28,Regen
4/27/2016 0:00,106,37,69,4,32,wolkig
4/27/2016 1:00,54,23,31,3,20,teilweise bewölkt
4/27/2016 2:00,47,36,11,3,19,wolkig
4/27/2016 3:00,40,33,7,2,13,teilweise bewölkt
4/27/2016 4:00,33,31,2,3,11,wolkig
4/27/2016 5:00,46,35,11,3,9,wolkig
4/27/2016 6:00,147,117,30,3,11,Regen
4/27/2016 7:00,665,504,161,3,19,Regen
4/27/2016 8:00,951,531,420,4,17,Regen
4/27/2016 9:00,812,486,326,3,22,Regen
4/27/2016 10:00,933,502,431,5,20,wolkig
4/27/2016 11:00,793,436,357,7,20,Regen
4/27/2016 12:00,923,483,440,8,24,Regen
4/27/2016 13:00,959,487,472,4,30,Regen
4/27/2016 14:00,950,475,475,4,9,wolkig
4/27/2016 15:00,979,487,492,8,22,Regen
4/27/2016 16:00,1054,491,563,9,24,wolkig
4/27/2016 17:00,1204,639,565,9,20,wolkig
4/27/2016 18:00,1077,542,535,5,24,Regen
4/27/2016 19:00,967,515,452,6,7,wolkig
4/27/2016 20:00,707,341,366,5,9,wolkig
4/27/2016 21:00,403,184,219,5,7,teilweise bewölkt
4/27/2016 22:00,426,155,271,4,17,teilweise bewölkt
4/27/2016 23:00,365,156,209,4,11,Klarer Himmel
4/28/2016 0:00,225,94,131,2,9,Klarer Himmel
4/28/2016 1:00,93,44,49,2,11,Klarer Himmel
4/28/2016 2:00,72,31,41,2,11,Klarer Himmel
4/28/2016 3:00,70,20,50,2,13,Klarer Himmel
4/28/2016 4:00,79,28,51,1,11,Klarer Himmel
4/28/2016 5:00,83,36,47,2,9,teilweise bewölkt
4/28/2016 6:00,165,133,32,1,11,teilweise bewölkt
4/28/2016 7:00,679,458,221,2,11,teilweise bewölkt
4/28/2016 8:00,1237,727,510,5,19,teilweise bewölkt
4/28/2016 9:00,1050,630,420,7,17,teilweise bewölkt
4/28/2016 10:00,922,554,368,7,13,teilweise bewölkt
4/28/2016 11:00,916,542,374,6,20,Regen
4/28/2016 12:00,1033,482,551,7,9,wolkig
4/28/2016 13:00,1132,519,613,8,22,Regen
4/28/2016 14:00,982,499,483,11,9,teilweise bewölkt
4/28/2016 15:00,1242,676,566,10,17,teilweise bewölkt
4/28/2016 16:00,1230,643,587,10,20,Regen
4/28/2016 17:00,1216,613,603,9,13,wolkig
4/28/2016 18:00,1247,627,620,7,13,wolkig
4/28/2016 19:00,1052,481,571,6,9,wolkig
4/28/2016 20:00,663,314,349,6,13,Klarer Himmel
4/28/2016 21:00,464,248,216,5,9,Klarer Himmel
4/28/2016 22:00,467,244,223,5,9,Klarer Himmel
4/28/2016 23:00,336,141,195,5,9,Klarer Himmel
4/29/2016 0:00,179,67,112,4,9,Klarer Himmel
4/29/2016 1:00,70,23,47,3,7,
4/29/2016 2:00,84,18,66,3,11,
4/29/2016 3:00,61,9,52,3,15,Klarer Himmel
4/29/2016 4:00,67,18,49,3,15,Klarer Himmel
4/29/2016 5:00,50,30,20,4,17,Klarer Himmel
4/29/2016 6:00,150,117,33,4,17,Klarer Himmel
4/29/2016 7:00,644,427,217,6,20,Klarer Himmel
4/29/2016 8:00,1108,689,419,8,19,Klarer Himmel
4/29/2016 9:00,833,491,342,10,26,wolkig
4/29/2016 10:00,875,451,424,10,33,wolkig
4/29/2016 11:00,751,453,298,10,26,wolkig
4/29/2016 12:00,925,456,469,11,26,Regen
4/29/2016 13:00,933,480,453,11,26,Regen
4/29/2016 14:00,817,384,433,8,17,Regen
4/29/2016 15:00,720,392,328,8,13,Regen
4/29/2016 16:00,711,395,316,9,20,Regen
4/29/2016 17:00,814,435,379,9,17,Regen
4/29/2016 18:00,772,405,367,8,19,Regen
4/29/2016 19:00,561,277,284,7,11,Regen
4/29/2016 20:00,506,289,217,7,11,wolkig
4/29/2016 21:00,385,221,164,7,17,wolkig
4/29/2016 22:00,273,131,142,7,13,Klarer Himmel
4/29/2016 23:00,216,100,116,7,9,Klarer Himmel
4/30/2016 0:00,266,97,169,6,7,Klarer Himmel
4/30/2016 1:00,161,52,109,6,7,Klarer Himmel
4/30/2016 2:00,147,49,98,6,7,Klarer Himmel
4/30/2016 3:00,144,30,114,7,7,Regen
4/30/2016 4:00,80,12,68,6,13,Regen
4/30/2016 5:00,55,16,39,5,6,Regen
4/30/2016 6:00,56,27,29,5,4,Regen
4/30/2016 7:00,90,68,22,5,6,Regen
4/30/2016 8:00,147,98,49,6,9,Regen
4/30/2016 9:00,269,199,70,7,7,Regen
4/30/2016 10:00,329,229,100,8,6,Regen
4/30/2016 11:00,383,254,129,8,6,Regen
4/30/2016 12:00,510,326,184,9,4,Regen
4/30/2016 13:00,445,246,199,8,6,Regen
4/30/2016 14:00,558,295,263,10,7,wolkig
4/30/2016 15:00,539,252,287,10,6,wolkig
4/30/2016 16:00,462,191,271,10,4,wolkig
4/30/2016 17:00,522,221,301,11,2,wolkig
4/30/2016 18:00,501,228,273,10,7,wolkig
4/30/2016 19:00,542,306,236,10,6,wolkig
4/30/2016 20:00,507,257,250,9,4,wolkig
4/30/2016 21:00,291,180,111,9,17,wolkig
4/30/2016 22:00,240,131,109,8,17,Klarer Himmel
4/30/2016 23:00,266,143,123,6,15,Klarer Himmel
5/1/2016 0:00,313,178,135,6,15,Klarer Himmel
5/1/2016 1:00,309,129,180,6,13,wolkig
5/1/2016 2:00,205,45,160,6,11,wolkig
5/1/2016 3:00,167,38,129,6,13,wolkig
5/1/2016 4:00,167,25,142,5,13,wolkig
5/1/2016 5:00,71,18,53,5,13,wolkig
5/1/2016 6:00,44,19,25,5,9,wolkig
5/1/2016 7:00,54,40,14,6,17,wolkig
5/1/2016 8:00,72,48,24,7,17,wolkig
5/1/2016 9:00,140,97,43,8,17,wolkig
5/1/2016 10:00,306,235,71,9,19,wolkig
5/1/2016 11:00,412,253,159,11,20,teilweise bewölkt
5/1/2016 12:00,579,384,195,12,19,teilweise bewölkt
5/1/2016 13:00,703,483,220,13,17,teilweise bewölkt
5/1/2016 14:00,741,490,251,13,19,teilweise bewölkt
5/1/2016 15:00,805,472,333,14,19,teilweise bewölkt
5/1/2016 16:00,734,394,340,14,17,teilweise bewölkt
5/1/2016 17:00,722,311,411,14,19,Klarer Himmel
5/1/2016 18:00,608,253,355,14,15,Klarer Himmel
5/1/2016 19:00,601,230,371,13,15,Klarer Himmel
5/1/2016 20:00,479,173,306,11,11,Klarer Himmel
5/1/2016 21:00,374,123,251,9,6,Klarer Himmel
5/1/2016 22:00,263,67,196,7,4,Klarer Himmel
5/1/2016 23:00,139,47,92,7,2,Klarer Himmel
5/2/2016 0:00,94,36,58,6,2,Klarer Himmel
5/2/2016 1:00,24,8,16,5,2,Klarer Himmel
5/2/2016 2:00,16,6,10,4,0,Klarer Himmel
5/2/2016 3:00,4,3,1,3,2,Klarer Himmel
5/2/2016 4:00,12,4,8,3,2,Klarer Himmel
5/2/2016 5:00,51,38,13,2,2,Nebel
5/2/2016 6:00,172,129,43,3,2,Nebel
5/2/2016 7:00,807,551,256,6,0,Klarer Himmel
5/2/2016 8:00,1140,688,452,9,6,Klarer Himmel
5/2/2016 9:00,893,493,400,12,4,Klarer Himmel
5/2/2016 10:00,1037,589,448,14,2,
5/2/2016 11:00,942,522,420,16,7,teilweise bewölkt
5/2/2016 12:00,1102,556,546,18,11,teilweise bewölkt
5/2/2016 13:00,1111,548,563,18,9,Klarer Himmel
5/2/2016 14:00,1009,604,405,19,9,Klarer Himmel
5/2/2016 15:00,1413,737,676,19,6,Klarer Himmel
5/2/2016 16:00,1450,773,677,19,9,Klarer Himmel
5/2/2016 17:00,1758,853,905,19,11,Klarer Himmel
5/2/2016 18:00,1463,639,824,19,7,Klarer Himmel
5/2/2016 19:00,1260,571,689,17,7,Klarer Himmel
5/2/2016 20:00,842,370,472,15,7,Klarer Himmel
5/2/2016 21:00,604,250,354,13,4,Klarer Himmel
5/2/2016 22:00,418,170,248,12,6,Klarer Himmel
5/2/2016 23:00,255,106,149,11,2,Klarer Himmel
5/3/2016 0:00,103,25,78,13,7,Klarer Himmel
5/3/2016 1:00,51,19,32,13,9,Klarer Himmel
5/3/2016 2:00,16,7,9,12,9,Klarer Himmel
5/3/2016 3:00,8,5,3,12,7,wolkig
5/3/2016 4:00,8,5,3,12,7,wolkig
5/3/2016 5:00,37,30,7,12,7,wolkig
5/3/2016 6:00,158,119,39,9,17,Regen
5/3/2016 7:00,540,349,191,8,11,Regen
5/3/2016 8:00,1135,685,450,9,11,wolkig
5/3/2016 9:00,1042,553,489,9,20,wolkig
5/3/2016 10:00,1031,566,465,11,17,teilweise bewölkt
5/3/2016 11:00,946,534,412,13,19,teilweise bewölkt
5/3/2016 12:00,1117,581,536,12,26,Regen
5/3/2016 13:00,1076,544,532,14,17,teilweise bewölkt
5/3/2016 14:00,1083,548,535,14,24,teilweise bewölkt
5/3/2016 15:00,1186,596,590,14,26,teilweise bewölkt
5/3/2016 16:00,1335,666,669,14,24,teilweise bewölkt
5/3/2016 17:00,1571,780,791,14,20,Klarer Himmel
5/3/2016 18:00,1386,730,656,14,22,Klarer Himmel
5/3/2016 19:00,1246,678,568,12,26,Klarer Himmel
5/3/2016 20:00,974,454,520,11,13,Klarer Himmel
5/3/2016 21:00,549,225,324,10,11,Klarer Himmel
5/3/2016 22:00,546,192,354,8,9,Klarer Himmel
5/3/2016 23:00,369,126,243,6,4,Klarer Himmel
5/4/2016 0:00,137,39,98,5,4,Klarer Himmel
5/4/2016 1:00,55,12,43,4,2,Klarer Himmel
5/4/2016 2:00,21,10,11,3,0,Klarer Himmel
5/4/2016 3:00,9,0,9,2,2,Klarer Himmel
5/4/2016 4:00,11,9,2,2,4,Nebel
5/4/2016 5:00,50,39,11,1,0,Nebel
5/4/2016 6:00,188,151,37,1,0,Nebel
5/4/2016 7:00,945,660,285,5,2,Klarer Himmel
5/4/2016 8:00,1358,758,600,9,2,teilweise bewölkt
5/4/2016 9:00,1081,636,445,10,9,teilweise bewölkt
5/4/2016 10:00,1169,657,512,10,6,teilweise bewölkt
5/4/2016 11:00,1021,599,422,12,11,teilweise bewölkt
5/4/2016 12:00,1209,654,555,12,6,teilweise bewölkt
5/4/2016 13:00,1167,609,558,13,9,teilweise bewölkt
5/4/2016 14:00,1216,578,638,13,11,Klarer Himmel
5/4/2016 15:00,1249,621,628,15,6,Klarer Himmel
5/4/2016 16:00,1344,657,687,15,6,Klarer Himmel
5/4/2016 17:00,1465,722,743,15,9,Klarer Himmel
5/4/2016 18:00,1281,630,651,15,6,Klarer Himmel
5/4/2016 19:00,1224,646,578,14,7,Klarer Himmel
5/4/2016 20:00,896,417,479,12,4,Klarer Himmel
5/4/2016 21:00,688,280,408,10,4,Klarer Himmel
5/4/2016 22:00,567,220,347,7,4,Klarer Himmel
5/4/2016 23:00,459,179,280,8,4,Klarer Himmel
5/5/2016 0:00,518,283,235,7,4,Klarer Himmel
5/5/2016 1:00,403,189,214,6,6,Klarer Himmel
5/5/2016 2:00,242,91,151,4,4,Klarer Himmel
5/5/2016 3:00,226,90,136,5,6,Klarer Himmel
5/5/2016 4:00,167,71,96,4,4,Klarer Himmel
5/5/2016 5:00,95,36,59,3,4,Klarer Himmel
5/5/2016 6:00,56,34,22,7,7,Klarer Himmel
5/5/2016 7:00,95,77,18,9,7,Klarer Himmel
5/5/2016 8:00,160,114,46,11,9,Klarer Himmel
5/5/2016 9:00,276,192,84,13,9,Klarer Himmel
5/5/2016 10:00,378,246,132,14,17,Klarer Himmel
5/5/2016 11:00,417,215,202,16,17,Klarer Himmel
5/5/2016 12:00,610,350,260,17,11,Klarer Himmel
5/5/2016 13:00,607,350,257,18,11,Klarer Himmel
5/5/2016 14:00,796,498,298,18,13,Klarer Himmel
5/5/2016 15:00,722,423,299,18,19,Klarer Himmel
5/5/2016 16:00,748,417,331,19,13,Klarer Himmel
5/5/2016 17:00,792,368,424,19,15,Klarer Himmel
5/5/2016 18:00,762,363,399,19,13,Klarer Himmel
5/5/2016 19:00,635,238,397,18,7,Klarer Himmel
5/5/2016 20:00,507,175,332,17,6,Klarer Himmel
5/5/2016 21:00,364,158,206,15,7,Klarer Himmel
5/5/2016 22:00,316,113,203,14,6,Klarer Himmel
5/5/2016 23:00,228,76,152,13,7,Klarer Himmel
5/6/2016 0:00,155,43,112,13,7,Klarer Himmel
5/6/2016 1:00,80,23,57,13,7,Klarer Himmel
5/6/2016 2:00,31,8,23,12,7,Klarer Himmel
5/6/2016 3:00,16,6,10,12,7,Klarer Himmel
5/6/2016 4:00,23,10,13,11,7,Klarer Himmel
5/6/2016 5:00,37,26,11,11,7,Klarer Himmel
5/6/2016 6:00,119,89,30,12,7,Klarer Himmel
5/6/2016 7:00,437,304,133,13,9,Klarer Himmel
5/6/2016 8:00,814,495,319,15,11,Klarer Himmel
5/6/2016 9:00,720,483,237,17,17,Klarer Himmel
5/6/2016 10:00,880,505,375,18,17,Klarer Himmel
5/6/2016 11:00,893,543,350,20,13,Klarer Himmel
5/6/2016 12:00,945,521,424,21,19,Klarer Himmel
5/6/2016 13:00,1027,534,493,23,20,Klarer Himmel
5/6/2016 14:00,987,482,505,23,19,Klarer Himmel
5/6/2016 15:00,1003,522,481,24,19,Klarer Himmel
5/6/2016 16:00,1006,528,478,25,17,Klarer Himmel
5/6/2016 17:00,1098,525,573,25,19,Klarer Himmel
5/6/2016 18:00,1007,508,499,24,17,Klarer Himmel
5/6/2016 19:00,982,519,463,24,13,Klarer Himmel
5/6/2016 20:00,669,305,364,22,7,Klarer Himmel
5/6/2016 21:00,473,199,274,19,6,Klarer Himmel
5/6/2016 22:00,473,143,330,18,6,Klarer Himmel
5/6/2016 23:00,319,106,213,17,6,Klarer Himmel
5/7/2016 0:00,344,90,254,16,7,Klarer Himmel
5/7/2016 1:00,240,73,167,16,6,Klarer Himmel
5/7/2016 2:00,145,51,94,15,6,Klarer Himmel
5/7/2016 3:00,127,30,97,14,6,Klarer Himmel
5/7/2016 4:00,67,22,45,14,7,Klarer Himmel
5/7/2016 5:00,53,25,28,13,7,Klarer Himmel
5/7/2016 6:00,62,41,21,14,9,Klarer Himmel
5/7/2016 7:00,145,119,26,16,9,Klarer Himmel
5/7/2016 8:00,274,194,80,18,11,Klarer Himmel
5/7/2016 9:00,441,308,133,20,9,Klarer Himmel
5/7/2016 10:00,627,425,202,22,11,Klarer Himmel
5/7/2016 11:00,681,465,216,23,17,Klarer Himmel
5/7/2016 12:00,792,503,289,24,17,Klarer Himmel
5/7/2016 13:00,744,410,334,25,19,Klarer Himmel
5/7/2016 14:00,750,385,365,25,17,Klarer Himmel
5/7/2016 15:00,851,414,437,25,17,Klarer Himmel
5/7/2016 16:00,725,298,427,25,22,Klarer Himmel
5/7/2016 17:00,776,356,420,25,17,Klarer Himmel
5/7/2016 18:00,758,356,402,25,15,Klarer Himmel
5/7/2016 19:00,713,359,354,24,11,Klarer Himmel
5/7/2016 20:00,624,256,368,22,7,Klarer Himmel
5/7/2016 21:00,469,202,267,20,9,Klarer Himmel
5/7/2016 22:00,415,193,222,20,9,Klarer Himmel
5/7/2016 23:00,428,213,215,18,7,Klarer Himmel
5/8/2016 0:00,295,126,169,18,11,Klarer Himmel
5/8/2016 1:00,210,82,128,17,9,Klarer Himmel
5/8/2016 2:00,153,26,127,16,7,Klarer Himmel
5/8/2016 3:00,91,13,78,16,9,Klarer Himmel
5/8/2016 4:00,49,15,34,15,9,Klarer Himmel
5/8/2016 5:00,46,18,28,15,13,Klarer Himmel
5/8/2016 6:00,42,22,20,16,11,Klarer Himmel
5/8/2016 7:00,48,29,19,17,11,Klarer Himmel
5/8/2016 8:00,73,35,38,18,15,Klarer Himmel
5/8/2016 9:00,231,175,56,20,15,Klarer Himmel
5/8/2016 10:00,405,258,147,22,17,Klarer Himmel
5/8/2016 11:00,356,215,141,23,20,Klarer Himmel
5/8/2016 12:00,580,383,197,23,20,Klarer Himmel
5/8/2016 13:00,624,378,246,23,19,Klarer Himmel
5/8/2016 14:00,629,349,280,24,19,Klarer Himmel
5/8/2016 15:00,695,385,310,25,19,Klarer Himmel
5/8/2016 16:00,725,328,397,25,19,Klarer Himmel
5/8/2016 17:00,686,312,374,24,19,Klarer Himmel
5/8/2016 18:00,598,252,346,24,17,Klarer Himmel
5/8/2016 19:00,547,216,331,23,17,Klarer Himmel
5/8/2016 20:00,484,215,269,21,11,Klarer Himmel
5/8/2016 21:00,307,110,197,20,9,Klarer Himmel
5/8/2016 22:00,330,94,236,19,9,Klarer Himmel
5/8/2016 23:00,167,47,120,18,9,Klarer Himmel
5/9/2016 0:00,63,27,36,18,13,Klarer Himmel
5/9/2016 1:00,30,12,18,17,11,Klarer Himmel
5/9/2016 2:00,12,2,10,17,11,Klarer Himmel
5/9/2016 3:00,1,0,1,16,11,Klarer Himmel
5/9/2016 4:00,9,5,4,16,9,Klarer Himmel
5/9/2016 5:00,43,29,14,16,11,Klarer Himmel
5/9/2016 6:00,177,134,43,16,9,Klarer Himmel
5/9/2016 7:00,824,559,265,18,11,Klarer Himmel
5/9/2016 8:00,1255,703,552,19,15,Klarer Himmel
5/9/2016 9:00,935,540,395,19,13,Klarer Himmel
5/9/2016 10:00,1032,558,474,21,13,Klarer Himmel
5/9/2016 11:00,976,484,492,22,19,Klarer Himmel
5/9/2016 12:00,1168,571,597,22,17,Klarer Himmel
5/9/2016 13:00,1058,517,541,23,17,Klarer Himmel
5/9/2016 14:00,1186,586,600,24,17,Klarer Himmel
5/9/2016 15:00,1470,691,779,25,20,Klarer Himmel
5/9/2016 16:00,1400,673,727,25,22,Klarer Himmel
5/9/2016 17:00,1745,857,888,25,20,Klarer Himmel
5/9/2016 18:00,1663,815,848,24,17,Klarer Himmel
5/9/2016 19:00,1239,650,589,23,11,Klarer Himmel
5/9/2016 20:00,936,436,500,21,7,Klarer Himmel
5/9/2016 21:00,637,245,392,20,7,Klarer Himmel
5/9/2016 22:00,524,159,365,19,7,Klarer Himmel
5/9/2016 23:00,313,110,203,18,9,Klarer Himmel
5/10/2016 0:00,137,61,76,18,7,Klarer Himmel
5/10/2016 1:00,46,15,31,17,9,Klarer Himmel
5/10/2016 2:00,23,7,16,17,9,Klarer Himmel
5/10/2016 3:00,14,7,7,16,7,Klarer Himmel
5/10/2016 4:00,14,12,2,16,7,Klarer Himmel
5/10/2016 5:00,52,31,21,16,9,wolkig
5/10/2016 6:00,201,145,56,16,9,Klarer Himmel
5/10/2016 7:00,940,623,317,17,9,Klarer Himmel
5/10/2016 8:00,1442,824,618,19,13,Klarer Himmel
5/10/2016 9:00,1290,659,631,21,11,Klarer Himmel
5/10/2016 10:00,1204,656,548,22,13,Klarer Himmel
5/10/2016 11:00,1022,556,466,23,20,Klarer Himmel
5/10/2016 12:00,1240,599,641,24,20,Klarer Himmel
5/10/2016 13:00,1185,583,602,24,13,Klarer Himmel
5/10/2016 14:00,1301,629,672,24,13,Klarer Himmel
5/10/2016 15:00,1398,686,712,24,15,Klarer Himmel
5/10/2016 16:00,1513,782,731,24,13,Klarer Himmel
5/10/2016 17:00,1845,1014,831,24,9,Klarer Himmel
5/10/2016 18:00,1615,760,855,23,9,Klarer Himmel
5/10/2016 19:00,1432,716,716,22,7,Klarer Himmel
5/10/2016 20:00,914,426,488,21,7,Klarer Himmel
5/10/2016 21:00,672,280,392,21,9,Klarer Himmel
5/10/2016 22:00,600,219,381,20,9,Klarer Himmel
5/10/2016 23:00,365,116,249,19,6,Klarer Himmel
5/11/2016 0:00,188,56,132,19,6,Klarer Himmel
5/11/2016 1:00,109,18,91,18,4,Klarer Himmel
5/11/2016 2:00,46,12,34,18,4,Klarer Himmel
5/11/2016 3:00,19,9,10,17,4,Klarer Himmel
5/11/2016 4:00,27,14,13,17,6,Klarer Himmel
5/11/2016 5:00,54,39,15,16,6,Klarer Himmel
5/11/2016 6:00,214,152,62,16,6,Klarer Himmel
5/11/2016 7:00,1020,736,284,18,7,Klarer Himmel
5/11/2016 8:00,1413,737,676,19,7,Klarer Himmel
5/11/2016 9:00,1153,661,492,19,7,Klarer Himmel
5/11/2016 10:00,1245,646,599,22,9,
5/11/2016 11:00,1135,638,497,23,11,teilweise bewölkt
5/11/2016 12:00,1267,683,584,23,17,Klarer Himmel
5/11/2016 13:00,1219,612,607,24,15,Klarer Himmel
5/11/2016 14:00,1235,597,638,25,17,Klarer Himmel
5/11/2016 15:00,1300,627,673,26,15,Klarer Himmel
5/11/2016 16:00,1497,758,739,25,19,Klarer Himmel
5/11/2016 17:00,1584,827,757,25,20,Klarer Himmel
5/11/2016 18:00,1545,796,749,24,17,Klarer Himmel
5/11/2016 19:00,1358,711,647,22,13,Klarer Himmel
5/11/2016 20:00,950,446,504,21,13,Klarer Himmel
5/11/2016 21:00,719,289,430,20,11,Klarer Himmel
5/11/2016 22:00,708,263,445,19,7,Klarer Himmel
5/11/2016 23:00,464,177,287,18,9,Klarer Himmel
5/12/2016 0:00,346,164,182,17,7,Klarer Himmel
5/12/2016 1:00,201,50,151,16,7,Klarer Himmel
5/12/2016 2:00,111,30,81,15,11,Klarer Himmel
5/12/2016 3:00,98,33,65,15,9,Klarer Himmel
5/12/2016 4:00,59,20,39,15,9,Klarer Himmel
5/12/2016 5:00,73,37,36,14,13,Klarer Himmel
5/12/2016 6:00,211,156,55,15,15,Klarer Himmel
5/12/2016 7:00,878,573,305,16,13,Klarer Himmel
5/12/2016 8:00,1284,646,638,18,15,Klarer Himmel
5/12/2016 9:00,1055,602,453,20,19,Klarer Himmel
5/12/2016 10:00,1112,569,543,21,19,Klarer Himmel
5/12/2016 11:00,1092,601,491,22,19,Klarer Himmel
5/12/2016 12:00,1165,585,580,24,17,Klarer Himmel
5/12/2016 13:00,1240,582,658,24,22,Klarer Himmel
5/12/2016 14:00,1314,673,641,24,20,Klarer Himmel
5/12/2016 15:00,1368,727,641,24,19,Klarer Himmel
5/12/2016 16:00,1432,757,675,25,15,Klarer Himmel
5/12/2016 17:00,1531,756,775,23,17,Klarer Himmel
5/12/2016 18:00,1416,682,734,24,17,Klarer Himmel
5/12/2016 19:00,1160,586,574,23,15,Klarer Himmel
5/12/2016 20:00,889,407,482,21,7,Klarer Himmel
5/12/2016 21:00,634,294,340,19,11,Klarer Himmel
5/12/2016 22:00,488,194,294,19,19,Klarer Himmel
5/12/2016 23:00,548,259,289,18,17,Klarer Himmel
5/13/2016 0:00,296,168,128,17,11,Klarer Himmel
5/13/2016 1:00,171,58,113,16,11,Klarer Himmel
5/13/2016 2:00,118,18,100,15,15,Klarer Himmel
5/13/2016 3:00,93,4,89,14,17,Klarer Himmel
5/13/2016 4:00,70,19,51,13,13,Klarer Himmel
5/13/2016 5:00,68,32,36,11,11,Klarer Himmel
5/13/2016 6:00,168,113,55,12,11,Klarer Himmel
5/13/2016 7:00,724,483,241,13,17,Klarer Himmel
5/13/2016 8:00,1094,662,432,15,15,Klarer Himmel
5/13/2016 9:00,845,462,383,17,9,Klarer Himmel
5/13/2016 10:00,841,442,399,19,13,Klarer Himmel
5/13/2016 11:00,899,513,386,20,24,Klarer Himmel
5/13/2016 12:00,958,539,419,22,17,Klarer Himmel
5/13/2016 13:00,1060,534,526,22,22,Klarer Himmel
5/13/2016 14:00,1040,492,548,22,24,Klarer Himmel
5/13/2016 15:00,1038,539,499,23,22,Klarer Himmel
5/13/2016 16:00,946,496,450,21,24,Klarer Himmel
5/13/2016 17:00,1010,519,491,22,24,Klarer Himmel
5/13/2016 18:00,912,491,421,21,26,Klarer Himmel
5/13/2016 19:00,841,453,388,19,24,Klarer Himmel
5/13/2016 20:00,665,336,329,16,20,Klarer Himmel
5/13/2016 21:00,538,240,298,13,22,Klarer Himmel
5/13/2016 22:00,372,160,212,11,24,Klarer Himmel
5/13/2016 23:00,328,154,174,9,20,Klarer Himmel
5/14/2016 0:00,246,86,160,9,19,wolkig
5/14/2016 1:00,240,76,164,8,20,wolkig
5/14/2016 2:00,128,47,81,8,15,wolkig
5/14/2016 3:00,105,33,72,8,15,wolkig
5/14/2016 4:00,83,21,62,8,13,wolkig
5/14/2016 5:00,65,22,43,7,11,wolkig
5/14/2016 6:00,58,34,24,7,9,wolkig
5/14/2016 7:00,166,127,39,8,17,wolkig
5/14/2016 8:00,234,169,65,8,19,wolkig
5/14/2016 9:00,310,227,83,9,19,wolkig
5/14/2016 10:00,446,320,126,10,20,wolkig
5/14/2016 11:00,476,317,159,10,19,teilweise bewölkt
5/14/2016 12:00,542,325,217,11,20,wolkig
5/14/2016 13:00,519,264,255,11,22,wolkig
5/14/2016 14:00,481,233,248,12,19,teilweise bewölkt
5/14/2016 15:00,488,238,250,11,20,teilweise bewölkt
5/14/2016 16:00,385,189,196,9,20,Regen
5/14/2016 17:00,391,171,220,10,20,Regen
5/14/2016 18:00,427,175,252,9,20,Regen
5/14/2016 19:00,350,170,180,9,20,Regen
5/14/2016 20:00,363,178,185,8,15,teilweise bewölkt
5/14/2016 21:00,225,109,116,7,19,teilweise bewölkt
5/14/2016 22:00,211,85,126,7,17,Regen
5/14/2016 23:00,185,80,105,5,15,teilweise bewölkt
5/15/2016 0:00,166,77,89,5,19,Klarer Himmel
5/15/2016 1:00,159,76,83,5,15,teilweise bewölkt
5/15/2016 2:00,103,40,63,5,13,teilweise bewölkt
5/15/2016 3:00,88,20,68,5,15,teilweise bewölkt
5/15/2016 4:00,54,8,46,4,15,teilweise bewölkt
5/15/2016 5:00,46,13,33,4,15,teilweise bewölkt
5/15/2016 6:00,27,16,11,6,19,teilweise bewölkt
5/15/2016 7:00,53,31,22,7,20,teilweise bewölkt
5/15/2016 8:00,44,28,16,8,22,wolkig
5/15/2016 9:00,154,101,53,9,22,teilweise bewölkt
5/15/2016 10:00,235,145,90,10,26,wolkig
5/15/2016 11:00,228,122,106,8,13,teilweise bewölkt
5/15/2016 12:00,219,118,101,8,15,teilweise bewölkt
5/15/2016 13:00,184,99,85,12,24,teilweise bewölkt
5/15/2016 14:00,210,122,88,10,22,Regen
5/15/2016 15:00,222,120,102,12,28,teilweise bewölkt
5/15/2016 16:00,217,111,106,10,20,Regen
5/15/2016 17:00,260,143,117,9,9,wolkig
5/15/2016 18:00,289,150,139,10,11,wolkig
5/15/2016 19:00,234,101,133,9,22,wolkig
5/15/2016 20:00,216,106,110,8,15,teilweise bewölkt
5/15/2016 21:00,176,93,83,7,11,teilweise bewölkt
5/15/2016 22:00,154,76,78,6,9,Klarer Himmel
5/15/2016 23:00,137,52,85,5,7,Klarer Himmel
5/16/2016 0:00,123,61,62,4,6,Klarer Himmel
5/16/2016 1:00,88,37,51,3,6,Klarer Himmel
5/16/2016 2:00,45,11,34,3,7,Klarer Himmel
5/16/2016 3:00,21,3,18,2,7,Klarer Himmel
5/16/2016 4:00,34,10,24,3,6,Nebel
5/16/2016 5:00,17,8,9,3,6,Nebel
5/16/2016 6:00,16,7,9,3,2,Nebel
5/16/2016 7:00,47,30,17,6,9,teilweise bewölkt
5/16/2016 8:00,74,51,23,8,9,wolkig
5/16/2016 9:00,154,95,59,9,13,wolkig
5/16/2016 10:00,227,107,120,10,15,teilweise bewölkt
5/16/2016 11:00,257,163,94,11,9,teilweise bewölkt
5/16/2016 12:00,268,141,127,11,11,teilweise bewölkt
5/16/2016 13:00,320,166,154,12,13,wolkig
5/16/2016 14:00,351,184,167,12,19,wolkig
5/16/2016 15:00,328,199,129,13,20,wolkig
5/16/2016 16:00,317,155,162,12,22,wolkig
5/16/2016 17:00,324,139,185,12,26,wolkig
5/16/2016 18:00,356,187,169,12,13,teilweise bewölkt
5/16/2016 19:00,283,146,137,11,17,wolkig
5/16/2016 20:00,270,136,134,11,13,wolkig
5/16/2016 21:00,164,61,103,10,17,wolkig
5/16/2016 22:00,160,59,101,9,15,Klarer Himmel
5/16/2016 23:00,154,64,90,9,11,Klarer Himmel
5/17/2016 0:00,59,16,43,9,11,wolkig
5/17/2016 1:00,34,9,25,9,11,wolkig
5/17/2016 2:00,20,6,14,8,11,wolkig
5/17/2016 3:00,5,2,3,8,11,wolkig
5/17/2016 4:00,15,8,7,9,13,wolkig
5/17/2016 5:00,54,35,19,9,11,wolkig
5/17/2016 6:00,172,125,47,9,11,wolkig
5/17/2016 7:00,458,295,163,9,11,wolkig
5/17/2016 8:00,802,486,316,10,11,wolkig
5/17/2016 9:00,577,335,242,11,11,wolkig
5/17/2016 10:00,507,315,192,12,11,teilweise bewölkt
5/17/2016 11:00,536,301,235,14,20,teilweise bewölkt
5/17/2016 12:00,577,310,267,15,19,wolkig
5/17/2016 13:00,605,300,305,15,19,wolkig
5/17/2016 14:00,634,325,309,15,17,teilweise bewölkt
5/17/2016 15:00,701,383,318,17,17,teilweise bewölkt
5/17/2016 16:00,823,402,421,16,17,wolkig
5/17/2016 17:00,1032,477,555,17,26,wolkig
5/17/2016 18:00,930,431,499,16,17,wolkig
5/17/2016 19:00,728,368,360,16,9,teilweise bewölkt
5/17/2016 20:00,521,250,271,15,6,Klarer Himmel
5/17/2016 21:00,365,199,166,12,9,teilweise bewölkt
5/17/2016 22:00,320,166,154,13,6,teilweise bewölkt
5/17/2016 23:00,164,64,100,12,11,Klarer Himmel
5/18/2016 0:00,103,26,77,11,7,Klarer Himmel
5/18/2016 1:00,53,11,42,9,2,Klarer Himmel
5/18/2016 2:00,22,6,16,8,4,teilweise bewölkt
5/18/2016 3:00,21,7,14,10,7,wolkig
5/18/2016 4:00,22,11,11,10,7,teilweise bewölkt
5/18/2016 5:00,63,44,19,10,4,Klarer Himmel
5/18/2016 6:00,176,126,50,10,6,Klarer Himmel
5/18/2016 7:00,686,483,203,11,7,wolkig
5/18/2016 8:00,923,557,366,12,7,wolkig
5/18/2016 9:00,744,450,294,15,15,wolkig
5/18/2016 10:00,623,364,259,16,15,teilweise bewölkt
5/18/2016 11:00,656,363,293,17,17,wolkig
5/18/2016 12:00,609,286,323,18,15,wolkig
5/18/2016 13:00,695,338,357,18,17,wolkig
5/18/2016 14:00,731,345,386,18,13,Regen
5/18/2016 15:00,716,348,368,18,6,wolkig
5/18/2016 16:00,834,415,419,18,9,wolkig
5/18/2016 17:00,1066,522,544,19,15,wolkig
5/18/2016 18:00,941,448,493,16,17,Regen
5/18/2016 19:00,767,397,370,15,9,wolkig
5/18/2016 20:00,591,265,326,15,4,
5/18/2016 21:00,331,153,178,14,6,wolkig
5/18/2016 22:00,324,141,183,14,6,wolkig
5/18/2016 23:00,296,134,162,14,4,wolkig
5/19/2016 0:00,208,79,129,12,4,Regen
5/19/2016 1:00,106,31,75,13,6,wolkig
5/19/2016 2:00,43,11,32,12,6,Klarer Himmel
5/19/2016 3:00,57,15,42,11,2,Klarer Himmel
5/19/2016 4:00,63,13,50,10,2,Klarer Himmel
5/19/2016 5:00,81,44,37,8,2,Nebel
5/19/2016 6:00,191,136,55,9,0,Nebel
5/19/2016 7:00,736,514,222,12,2,Regen
5/19/2016 8:00,886,548,338,13,15,Klarer Himmel
5/19/2016 9:00,593,347,246,13,13,wolkig
5/19/2016 10:00,551,286,265,15,11,wolkig
5/19/2016 11:00,572,310,262,16,11,wolkig
5/19/2016 12:00,677,357,320,17,13,wolkig
5/19/2016 13:00,737,390,347,17,15,wolkig
5/19/2016 14:00,748,374,374,18,20,wolkig
5/19/2016 15:00,833,404,429,18,19,wolkig
5/19/2016 16:00,980,477,503,18,17,teilweise bewölkt
5/19/2016 17:00,1084,552,532,19,19,teilweise bewölkt
5/19/2016 18:00,1031,516,515,18,17,teilweise bewölkt
5/19/2016 19:00,771,344,427,18,15,teilweise bewölkt
5/19/2016 20:00,621,282,339,17,11,Klarer Himmel
5/19/2016 21:00,380,161,219,14,7,Klarer Himmel
5/19/2016 22:00,376,138,238,10,6,Klarer Himmel
5/19/2016 23:00,319,117,202,10,4,Klarer Himmel
5/20/2016 0:00,138,32,106,10,7,Klarer Himmel
5/20/2016 1:00,58,23,35,10,11,Klarer Himmel
5/20/2016 2:00,36,13,23,10,11,Klarer Himmel
5/20/2016 3:00,17,3,14,10,9,Klarer Himmel
5/20/2016 4:00,31,14,17,11,11,Klarer Himmel
5/20/2016 5:00,57,37,20,10,11,Klarer Himmel
5/20/2016 6:00,170,127,43,11,13,Klarer Himmel
5/20/2016 7:00,710,511,199,12,15,wolkig
5/20/2016 8:00,750,474,276,12,15,Regen
5/20/2016 9:00,618,380,238,12,15,wolkig
5/20/2016 10:00,544,295,249,14,13,Regen
5/20/2016 11:00,555,327,228,14,22,wolkig
5/20/2016 12:00,668,336,332,15,24,wolkig
5/20/2016 13:00,757,367,390,16,20,wolkig
5/20/2016 14:00,751,347,404,14,15,Regen
5/20/2016 15:00,754,392,362,15,20,Regen
5/20/2016 16:00,717,369,348,15,9,wolkig
5/20/2016 17:00,778,422,356,15,13,wolkig
5/20/2016 18:00,724,394,330,15,11,wolkig
5/20/2016 19:00,650,360,290,15,9,wolkig
5/20/2016 20:00,544,284,260,15,9,Klarer Himmel
5/20/2016 21:00,391,191,200,14,9,Klarer Himmel
5/20/2016 22:00,361,149,212,14,9,wolkig
5/20/2016 23:00,264,115,149,14,9,wolkig
5/21/2016 0:00,292,106,186,14,9,Klarer Himmel
5/21/2016 1:00,211,66,145,14,13,wolkig
5/21/2016 2:00,148,54,94,14,13,wolkig
5/21/2016 3:00,79,29,50,12,7,Klarer Himmel
5/21/2016 4:00,85,25,60,12,7,Klarer Himmel
5/21/2016 5:00,65,34,31,11,6,Nebel
5/21/2016 6:00,114,74,40,12,7,
5/21/2016 7:00,185,153,32,14,9,Klarer Himmel
5/21/2016 8:00,394,311,83,15,15,Klarer Himmel
5/21/2016 9:00,515,396,119,17,15,wolkig
5/21/2016 10:00,750,504,246,18,15,wolkig
5/21/2016 11:00,775,514,261,19,17,wolkig
5/21/2016 12:00,884,518,366,20,19,wolkig
5/21/2016 13:00,855,453,402,22,19,wolkig
5/21/2016 14:00,874,421,453,23,19,Klarer Himmel
5/21/2016 15:00,850,407,443,23,22,wolkig
5/21/2016 16:00,847,394,453,22,20,Klarer Himmel
5/21/2016 17:00,790,357,433,23,19,Klarer Himmel
5/21/2016 18:00,939,424,515,23,15,Klarer Himmel
5/21/2016 19:00,830,404,426,22,13,Klarer Himmel
5/21/2016 20:00,528,243,285,20,6,Klarer Himmel
5/21/2016 21:00,377,184,193,19,6,Klarer Himmel
5/21/2016 22:00,358,158,200,17,4,Klarer Himmel
5/21/2016 23:00,543,239,304,18,9,Klarer Himmel
5/22/2016 0:00,359,149,210,18,7,Klarer Himmel
5/22/2016 1:00,266,107,159,17,7,Klarer Himmel
5/22/2016 2:00,240,69,171,16,9,Klarer Himmel
5/22/2016 3:00,183,55,128,15,7,Klarer Himmel
5/22/2016 4:00,113,22,91,14,7,Klarer Himmel
5/22/2016 5:00,64,18,46,14,7,Klarer Himmel
5/22/2016 6:00,57,21,36,15,9,Klarer Himmel
5/22/2016 7:00,36,24,12,17,11,Klarer Himmel
5/22/2016 8:00,93,62,31,19,13,Klarer Himmel
5/22/2016 9:00,223,155,68,21,13,Klarer Himmel
5/22/2016 10:00,346,240,106,23,13,Klarer Himmel
5/22/2016 11:00,343,222,121,24,20,Klarer Himmel
5/22/2016 12:00,398,236,162,23,22,wolkig
5/22/2016 13:00,455,236,219,22,32,wolkig
5/22/2016 14:00,430,233,197,23,24,wolkig
5/22/2016 15:00,503,214,289,22,20,Regen
5/22/2016 16:00,383,190,193,20,22,Klarer Himmel
5/22/2016 17:00,448,191,257,19,17,Regen
5/22/2016 18:00,288,101,187,17,20,Regen
5/22/2016 19:00,259,105,154,16,6,Regen
5/22/2016 20:00,270,110,160,15,4,wolkig
5/22/2016 21:00,184,66,118,15,7,Klarer Himmel
5/22/2016 22:00,170,47,123,15,7,Regen
5/22/2016 23:00,115,30,85,15,7,wolkig
5/23/2016 0:00,47,21,26,15,7,wolkig
5/23/2016 1:00,25,7,18,15,7,wolkig
5/23/2016 2:00,14,4,10,15,4,Regen
5/23/2016 3:00,9,3,6,15,6,Klarer Himmel
5/23/2016 4:00,9,4,5,15,4,Nebel
5/23/2016 5:00,39,28,11,15,6,wolkig
5/23/2016 6:00,159,111,48,15,4,wolkig
5/23/2016 7:00,708,479,229,15,6,wolkig
5/23/2016 8:00,1016,582,434,15,11,Regen
5/23/2016 9:00,734,367,367,15,11,Regen
5/23/2016 10:00,776,385,391,16,13,Regen
5/23/2016 11:00,753,390,363,15,17,wolkig
5/23/2016 12:00,876,437,439,15,15,wolkig
5/23/2016 13:00,933,465,468,15,15,wolkig
5/23/2016 14:00,930,447,483,15,13,wolkig
5/23/2016 15:00,1058,527,531,15,13,wolkig
5/23/2016 16:00,1166,586,580,15,11,wolkig
5/23/2016 17:00,1520,695,825,15,7,wolkig
5/23/2016 18:00,1217,557,660,13,20,Regen
5/23/2016 19:00,912,416,496,12,17,Regen
5/23/2016 20:00,682,321,361,12,17,Regen
5/23/2016 21:00,415,191,224,11,20,wolkig
5/23/2016 22:00,289,106,183,11,17,wolkig
5/23/2016 23:00,197,68,129,11,20,wolkig
5/24/2016 0:00,121,38,83,11,15,wolkig
5/24/2016 1:00,58,24,34,11,17,wolkig
5/24/2016 2:00,26,7,19,10,19,wolkig
5/24/2016 3:00,11,3,8,10,17,wolkig
5/24/2016 4:00,10,6,4,10,15,wolkig
5/24/2016 5:00,36,26,10,10,17,wolkig
5/24/2016 6:00,168,126,42,10,13,wolkig
5/24/2016 7:00,782,524,258,10,17,wolkig
5/24/2016 8:00,1419,874,545,10,15,wolkig
5/24/2016 9:00,1015,503,512,11,17,wolkig
5/24/2016 10:00,1072,548,524,11,19,wolkig
5/24/2016 11:00,858,468,390,11,15,wolkig
5/24/2016 12:00,1161,611,550,12,15,wolkig
5/24/2016 13:00,1129,627,502,11,19,Regen
5/24/2016 14:00,1106,541,565,11,15,wolkig
5/24/2016 15:00,1222,614,608,12,17,wolkig
5/24/2016 16:00,1289,650,639,12,15,Regen
5/24/2016 17:00,1531,819,712,11,17,Regen
5/24/2016 18:00,1375,733,642,11,7,wolkig
5/24/2016 19:00,1125,626,499,11,9,wolkig
5/24/2016 20:00,757,358,399,10,9,wolkig
5/24/2016 21:00,569,254,315,10,11,wolkig
5/24/2016 22:00,461,168,293,10,6,wolkig
5/24/2016 23:00,272,85,187,10,7,wolkig
5/25/2016 0:00,145,33,112,10,9,wolkig
5/25/2016 1:00,79,18,61,10,6,wolkig
5/25/2016 2:00,20,4,16,10,6,Regen
5/25/2016 3:00,7,4,3,10,6,wolkig
5/25/2016 4:00,12,9,3,10,9,wolkig
5/25/2016 5:00,51,36,15,10,7,wolkig
5/25/2016 6:00,177,142,35,10,7,wolkig
5/25/2016 7:00,904,668,236,10,7,wolkig
5/25/2016 8:00,1302,762,540,11,7,wolkig
5/25/2016 9:00,1061,585,476,11,7,wolkig
5/25/2016 10:00,1204,624,580,12,7,wolkig
5/25/2016 11:00,984,572,412,13,9,wolkig
5/25/2016 12:00,1093,544,549,13,9,wolkig
5/25/2016 13:00,1129,606,523,14,9,wolkig
5/25/2016 14:00,1118,554,564,15,11,wolkig
5/25/2016 15:00,1239,650,589,15,11,wolkig
5/25/2016 16:00,1279,651,628,16,9,wolkig
5/25/2016 17:00,1411,726,685,16,6,wolkig
5/25/2016 18:00,1277,678,599,15,4,wolkig
5/25/2016 19:00,1178,631,547,15,4,wolkig
5/25/2016 20:00,896,465,431,14,2,wolkig
5/25/2016 21:00,668,360,308,13,4,wolkig
5/25/2016 22:00,553,249,304,13,2,wolkig
5/25/2016 23:00,536,272,264,13,4,wolkig
5/26/2016 0:00,544,318,226,13,4,wolkig
5/26/2016 1:00,413,179,234,12,6,wolkig
5/26/2016 2:00,345,100,245,11,2,wolkig
5/26/2016 3:00,310,65,245,12,4,wolkig
5/26/2016 4:00,196,31,165,12,4,wolkig
5/26/2016 5:00,120,30,90,12,2,wolkig
5/26/2016 6:00,71,35,36,12,4,wolkig
5/26/2016 7:00,105,73,32,13,4,wolkig
5/26/2016 8:00,146,95,51,15,2,Klarer Himmel
5/26/2016 9:00,235,172,63,17,4,teilweise bewölkt
5/26/2016 10:00,397,253,144,17,4,teilweise bewölkt
5/26/2016 11:00,353,200,153,18,9,teilweise bewölkt
5/26/2016 12:00,464,274,190,19,6,teilweise bewölkt
5/26/2016 13:00,476,241,235,19,6,Klarer Himmel
5/26/2016 14:00,577,311,266,18,9,wolkig
5/26/2016 15:00,629,361,268,18,11,wolkig
5/26/2016 16:00,629,333,296,19,7,wolkig
5/26/2016 17:00,687,332,355,20,6,teilweise bewölkt
5/26/2016 18:00,695,357,338,20,6,teilweise bewölkt
5/26/2016 19:00,681,343,338,19,11,wolkig
5/26/2016 20:00,477,210,267,17,13,Klarer Himmel
5/26/2016 21:00,420,191,229,16,7,Klarer Himmel
5/26/2016 22:00,372,142,230,15,9,Klarer Himmel
5/26/2016 23:00,299,97,202,14,9,
5/27/2016 0:00,181,47,134,14,9,
5/27/2016 1:00,110,25,85,13,11,
5/27/2016 2:00,62,22,40,12,9,
5/27/2016 3:00,23,10,13,12,7,
5/27/2016 4:00,21,13,8,12,9,
5/27/2016 5:00,48,35,13,11,7,
5/27/2016 6:00,124,95,29,13,7,
5/27/2016 7:00,389,273,116,13,11,
5/27/2016 8:00,751,503,248,14,13,
5/27/2016 9:00,645,405,240,15,11,wolkig
5/27/2016 10:00,855,478,377,16,13,wolkig
5/27/2016 11:00,712,455,257,16,15,wolkig
5/27/2016 12:00,809,466,343,16,19,wolkig
5/27/2016 13:00,748,412,336,18,15,wolkig
5/27/2016 14:00,866,435,431,18,13,wolkig
5/27/2016 15:00,832,413,419,19,15,wolkig
5/27/2016 16:00,754,377,377,19,11,wolkig
5/27/2016 17:00,834,420,414,20,13,wolkig
5/27/2016 18:00,830,404,426,21,11,teilweise bewölkt
5/27/2016 19:00,830,451,379,19,11,wolkig
5/27/2016 20:00,591,333,258,19,6,wolkig
5/27/2016 21:00,399,189,210,17,6,teilweise bewölkt
5/27/2016 22:00,393,151,242,15,4,Klarer Himmel
5/27/2016 23:00,370,116,254,14,4,Klarer Himmel
5/28/2016 0:00,340,104,236,14,2,Klarer Himmel
5/28/2016 1:00,244,65,179,14,6,Klarer Himmel
5/28/2016 2:00,165,37,128,14,6,Klarer Himmel
5/28/2016 3:00,88,17,71,14,6,
5/28/2016 4:00,58,16,42,14,2,
5/28/2016 5:00,46,26,20,14,4,
5/28/2016 6:00,63,45,18,15,6,
5/28/2016 7:00,133,111,22,16,4,
5/28/2016 8:00,269,190,79,18,7,teilweise bewölkt
5/28/2016 9:00,405,286,119,20,6,teilweise bewölkt
5/28/2016 10:00,600,411,189,20,13,teilweise bewölkt
5/28/2016 11:00,625,390,235,22,9,teilweise bewölkt
5/28/2016 12:00,730,460,270,22,11,teilweise bewölkt
5/28/2016 13:00,727,429,298,23,7,teilweise bewölkt
5/28/2016 14:00,796,426,370,23,7,teilweise bewölkt
5/28/2016 15:00,698,362,336,22,15,teilweise bewölkt
5/28/2016 16:00,637,318,319,21,20,wolkig
5/28/2016 17:00,728,311,417,21,15,teilweise bewölkt
5/28/2016 18:00,510,266,244,21,9,Regen
5/28/2016 19:00,451,233,218,21,6,wolkig
5/28/2016 20:00,534,264,270,20,6,Klarer Himmel
5/28/2016 21:00,340,141,199,18,6,Klarer Himmel
5/28/2016 22:00,277,99,178,17,7,Klarer Himmel
5/28/2016 23:00,349,83,266,17,6,Klarer Himmel
5/29/2016 0:00,325,119,206,16,7,Klarer Himmel
5/29/2016 1:00,234,50,184,16,6,Klarer Himmel
5/29/2016 2:00,208,45,163,16,7,teilweise bewölkt
5/29/2016 3:00,167,31,136,16,4,Regen
5/29/2016 4:00,101,25,76,16,9,Regen
5/29/2016 5:00,68,12,56,15,7,wolkig
5/29/2016 6:00,47,20,27,16,9,Regen
5/29/2016 7:00,37,21,16,16,13,wolkig
5/29/2016 8:00,74,45,29,16,11,wolkig
5/29/2016 9:00,177,117,60,16,13,Regen
5/29/2016 10:00,228,135,93,17,9,Regen
5/29/2016 11:00,218,131,87,18,20,wolkig
5/29/2016 12:00,281,170,111,17,15,wolkig
5/29/2016 13:00,391,219,172,17,13,wolkig
5/29/2016 14:00,330,189,141,17,13,wolkig
5/29/2016 15:00,355,199,156,17,22,wolkig
5/29/2016 16:00,375,203,172,17,20,wolkig
5/29/2016 17:00,455,209,246,16,17,wolkig
5/29/2016 18:00,397,183,214,16,13,wolkig
5/29/2016 19:00,381,165,216,16,13,wolkig
5/29/2016 20:00,304,107,197,16,9,wolkig
5/29/2016 21:00,222,79,143,16,9,wolkig
5/29/2016 22:00,223,78,145,16,9,wolkig
5/29/2016 23:00,126,41,85,16,7,wolkig
5/30/2016 0:00,57,18,39,16,9,wolkig
5/30/2016 1:00,24,6,18,16,9,wolkig
5/30/2016 2:00,16,3,13,16,17,wolkig
5/30/2016 3:00,12,5,7,16,13,wolkig
5/30/2016 4:00,13,11,2,16,22,wolkig
5/30/2016 5:00,37,27,10,15,7,wolkig
5/30/2016 6:00,163,121,42,15,15,wolkig
5/30/2016 7:00,681,482,199,16,19,wolkig
5/30/2016 8:00,1048,590,458,16,11,wolkig
5/30/2016 9:00,767,420,347,17,13,wolkig
5/30/2016 10:00,908,462,446,19,20,wolkig
5/30/2016 11:00,766,391,375,20,11,wolkig
5/30/2016 12:00,998,471,527,22,20,wolkig
5/30/2016 13:00,940,465,475,23,22,wolkig
5/30/2016 14:00,894,479,415,24,22,wolkig
5/30/2016 15:00,1141,639,502,24,13,teilweise bewölkt
5/30/2016 16:00,1230,586,644,25,13,wolkig
5/30/2016 17:00,1394,685,709,21,13,Regen
5/30/2016 18:00,1324,674,650,21,7,Regen
5/30/2016 19:00,851,399,452,19,11,Gewitter
5/30/2016 20:00,602,248,354,19,6,wolkig
5/30/2016 21:00,404,175,229,18,7,teilweise bewölkt
5/30/2016 22:00,457,121,336,18,7,teilweise bewölkt
5/30/2016 23:00,196,75,121,17,6,Klarer Himmel
5/31/2016 0:00,89,27,62,16,4,Klarer Himmel
5/31/2016 1:00,57,12,45,16,6,Klarer Himmel
5/31/2016 2:00,22,6,16,15,6,Klarer Himmel
5/31/2016 3:00,17,4,13,15,4,Klarer Himmel
5/31/2016 4:00,13,6,7,14,6,teilweise bewölkt
5/31/2016 5:00,46,33,13,14,4,Nebel
5/31/2016 6:00,193,144,49,15,6,teilweise bewölkt
5/31/2016 7:00,795,520,275,17,7,teilweise bewölkt
5/31/2016 8:00,1328,762,566,18,7,teilweise bewölkt
5/31/2016 9:00,1078,587,491,20,9,teilweise bewölkt
5/31/2016 10:00,1221,637,584,20,11,teilweise bewölkt
5/31/2016 11:00,1038,563,475,19,13,wolkig
5/31/2016 12:00,1132,523,609,20,11,wolkig
5/31/2016 13:00,1239,635,604,21,13,wolkig
5/31/2016 14:00,1187,570,617,22,7,wolkig
5/31/2016 15:00,1283,684,599,23,7,wolkig
5/31/2016 16:00,1530,747,783,23,7,Klarer Himmel
5/31/2016 17:00,1676,811,865,23,7,Klarer Himmel
5/31/2016 18:00,1607,752,855,24,7,Klarer Himmel
5/31/2016 19:00,1388,783,605,23,4,Klarer Himmel
5/31/2016 20:00,890,467,423,23,2,Klarer Himmel
5/31/2016 21:00,612,274,338,21,6,Klarer Himmel
5/31/2016 22:00,607,207,400,21,6,Klarer Himmel
5/31/2016 23:00,387,119,268,19,7,Klarer Himmel
6/1/2016 0:00,179,40,139,18,6,wolkig
6/1/2016 1:00,127,25,102,17,4,Gewitter
6/1/2016 2:00,40,18,22,16,9,wolkig
6/1/2016 3:00,13,7,6,16,6,Klarer Himmel
6/1/2016 4:00,8,4,4,15,0,Nebel
6/1/2016 5:00,47,33,14,16,4,wolkig
6/1/2016 6:00,174,135,39,16,6,wolkig
6/1/2016 7:00,800,596,204,17,6,wolkig
6/1/2016 8:00,1246,682,564,18,6,wolkig
6/1/2016 9:00,957,533,424,19,7,wolkig
6/1/2016 10:00,1122,604,518,19,13,wolkig
6/1/2016 11:00,955,522,433,19,11,Regen
6/1/2016 12:00,1013,488,525,20,9,wolkig
6/1/2016 13:00,1013,539,474,21,9,wolkig
6/1/2016 14:00,1046,454,592,22,17,wolkig
6/1/2016 15:00,1048,528,520,23,11,wolkig
6/1/2016 16:00,1282,591,691,21,6,wolkig
6/1/2016 17:00,1346,635,711,20,11,Regen
6/1/2016 18:00,1160,548,612,19,7,Gewitter
6/1/2016 19:00,829,451,378,19,6,Regen
6/1/2016 20:00,665,293,372,19,7,wolkig
6/1/2016 21:00,507,218,289,18,2,Regen
6/1/2016 22:00,427,193,234,18,9,Regen
6/1/2016 23:00,314,144,170,18,9,wolkig
6/2/2016 0:00,255,128,127,18,4,wolkig
6/2/2016 1:00,181,49,132,19,11,wolkig
6/2/2016 2:00,93,32,61,18,11,wolkig
6/2/2016 3:00,130,23,107,18,7,wolkig
6/2/2016 4:00,86,21,65,17,6,teilweise bewölkt
6/2/2016 5:00,79,50,29,16,7,teilweise bewölkt
6/2/2016 6:00,191,134,57,17,6,teilweise bewölkt
6/2/2016 7:00,751,508,243,18,7,
6/2/2016 8:00,1103,572,531,19,6,teilweise bewölkt
6/2/2016 9:00,978,571,407,19,7,teilweise bewölkt
6/2/2016 10:00,1102,646,456,20,9,wolkig
6/2/2016 11:00,932,518,414,21,11,wolkig
6/2/2016 12:00,1125,508,617,22,7,teilweise bewölkt
6/2/2016 13:00,1116,551,565,22,6,teilweise bewölkt
6/2/2016 14:00,1207,590,617,24,7,teilweise bewölkt
6/2/2016 15:00,1327,674,653,18,22,Gewitter
6/2/2016 16:00,788,359,429,16,7,Regen
6/2/2016 17:00,1087,530,557,16,6,wolkig
6/2/2016 18:00,1239,663,576,17,7,wolkig
6/2/2016 19:00,990,474,516,17,9,teilweise bewölkt
6/2/2016 20:00,739,374,365,18,7,Klarer Himmel
6/2/2016 21:00,537,270,267,16,6,Nebel
6/2/2016 22:00,552,236,316,16,4,Nebel
6/2/2016 23:00,394,129,265,16,2,Nebel
6/3/2016 0:00,191,73,118,15,4,Nebel
6/3/2016 1:00,111,23,88,16,4,Nebel
6/3/2016 2:00,46,14,32,17,6,Nebel
6/3/2016 3:00,48,16,32,16,6,Nebel
6/3/2016 4:00,42,11,31,16,4,wolkig
6/3/2016 5:00,64,43,21,16,2,Nebel
6/3/2016 6:00,161,117,44,16,2,Nebel
6/3/2016 7:00,664,475,189,15,6,wolkig
6/3/2016 8:00,1062,569,493,15,6,Nebel
6/3/2016 9:00,809,488,321,16,4,wolkig
6/3/2016 10:00,810,417,393,17,2,wolkig
6/3/2016 11:00,692,412,280,20,4,wolkig
6/3/2016 12:00,979,493,486,22,7,wolkig
6/3/2016 13:00,1010,515,495,23,7,wolkig
6/3/2016 14:00,966,425,541,24,13,teilweise bewölkt
6/3/2016 15:00,824,393,431,25,13,teilweise bewölkt
6/3/2016 16:00,961,516,445,25,17,Klarer Himmel
6/3/2016 17:00,1006,554,452,25,13,Klarer Himmel
6/3/2016 18:00,990,590,400,26,11,Klarer Himmel
6/3/2016 19:00,1002,619,383,25,13,Klarer Himmel
6/3/2016 20:00,847,486,361,22,6,teilweise bewölkt
6/3/2016 21:00,604,293,311,20,7,Klarer Himmel
6/3/2016 22:00,632,234,398,18,6,Klarer Himmel
6/3/2016 23:00,507,180,327,18,7,Klarer Himmel
6/4/2016 0:00,504,140,364,17,4,Klarer Himmel
6/4/2016 1:00,401,129,272,17,4,Klarer Himmel
6/4/2016 2:00,220,86,134,17,6,Klarer Himmel
6/4/2016 3:00,167,61,106,15,4,Nebel
6/4/2016 4:00,101,34,67,15,7,Nebel
6/4/2016 5:00,71,26,45,15,4,Nebel
6/4/2016 6:00,65,38,27,16,0,Nebel
6/4/2016 7:00,148,116,32,19,4,Klarer Himmel
6/4/2016 8:00,299,203,96,21,7,Klarer Himmel
6/4/2016 9:00,501,377,124,24,11,Klarer Himmel
6/4/2016 10:00,565,374,191,25,15,Klarer Himmel
6/4/2016 11:00,651,400,251,25,19,teilweise bewölkt
6/4/2016 12:00,737,429,308,25,15,wolkig
6/4/2016 13:00,707,388,319,26,17,wolkig
6/4/2016 14:00,809,429,380,27,17,wolkig
6/4/2016 15:00,836,498,338,26,20,teilweise bewölkt
6/4/2016 16:00,888,509,379,26,22,teilweise bewölkt
6/4/2016 17:00,786,364,422,26,13,wolkig
6/4/2016 18:00,886,415,471,25,17,wolkig
6/4/2016 19:00,813,441,372,24,9,wolkig
6/4/2016 20:00,715,398,317,22,6,teilweise bewölkt
6/4/2016 21:00,577,293,284,20,7,teilweise bewölkt
6/4/2016 22:00,496,177,319,19,9,Klarer Himmel
6/4/2016 23:00,511,202,309,18,7,Klarer Himmel
6/5/2016 0:00,430,165,265,18,6,Klarer Himmel
6/5/2016 1:00,370,142,228,18,2,Klarer Himmel
6/5/2016 2:00,219,76,143,16,4,Klarer Himmel
6/5/2016 3:00,217,72,145,15,4,Klarer Himmel
6/5/2016 4:00,103,36,67,15,2,Nebel
6/5/2016 5:00,71,25,46,15,4,Nebel
6/5/2016 6:00,47,16,31,17,2,Klarer Himmel
6/5/2016 7:00,41,21,20,19,4,Klarer Himmel
6/5/2016 8:00,108,61,47,21,7,Klarer Himmel
6/5/2016 9:00,296,216,80,23,6,Klarer Himmel
6/5/2016 10:00,332,206,126,24,13,Klarer Himmel
6/5/2016 11:00,442,262,180,25,13,Klarer Himmel
6/5/2016 12:00,522,292,230,26,13,teilweise bewölkt
6/5/2016 13:00,564,310,254,27,15,Klarer Himmel
6/5/2016 14:00,721,395,326,27,17,Klarer Himmel
6/5/2016 15:00,662,378,284,27,13,teilweise bewölkt
6/5/2016 16:00,645,331,314,27,15,teilweise bewölkt
6/5/2016 17:00,657,339,318,28,15,teilweise bewölkt
6/5/2016 18:00,657,330,327,27,15,teilweise bewölkt
6/5/2016 19:00,646,299,347,26,13,Klarer Himmel
6/5/2016 20:00,486,223,263,24,13,Klarer Himmel
6/5/2016 21:00,365,111,254,22,15,Klarer Himmel
6/5/2016 22:00,336,113,223,21,13,Klarer Himmel
6/5/2016 23:00,190,71,119,19,9,Klarer Himmel
6/6/2016 0:00,99,25,74,18,7,Klarer Himmel
6/6/2016 1:00,44,12,32,17,6,Klarer Himmel
6/6/2016 2:00,9,5,4,15,6,Klarer Himmel
6/6/2016 3:00,6,4,2,14,7,Klarer Himmel
6/6/2016 4:00,10,7,3,14,9,
6/6/2016 5:00,59,44,15,14,11,wolkig
6/6/2016 6:00,195,138,57,14,11,wolkig
6/6/2016 7:00,754,541,213,14,11,wolkig
6/6/2016 8:00,1176,676,500,15,9,wolkig
6/6/2016 9:00,903,465,438,16,11,wolkig
6/6/2016 10:00,933,487,446,17,7,wolkig
6/6/2016 11:00,914,485,429,19,9,teilweise bewölkt
6/6/2016 12:00,1011,531,480,20,9,teilweise bewölkt
6/6/2016 13:00,1150,575,575,23,9,teilweise bewölkt
6/6/2016 14:00,1140,566,574,24,13,
6/6/2016 15:00,1303,680,623,25,11,
6/6/2016 16:00,1405,723,682,26,11,teilweise bewölkt
6/6/2016 17:00,1649,836,813,26,9,teilweise bewölkt
6/6/2016 18:00,1580,788,792,26,11,teilweise bewölkt
6/6/2016 19:00,1270,635,635,26,9,wolkig
6/6/2016 20:00,882,460,422,24,7,wolkig
6/6/2016 21:00,655,304,351,22,7,wolkig
6/6/2016 22:00,523,190,333,20,6,Klarer Himmel
6/6/2016 23:00,375,105,270,19,4,Klarer Himmel
6/7/2016 0:00,189,42,147,18,4,
6/7/2016 1:00,69,13,56,17,4,
6/7/2016 2:00,23,8,15,16,4,
6/7/2016 3:00,18,13,5,16,4,Nebel
6/7/2016 4:00,17,12,5,16,0,Nebel
6/7/2016 5:00,62,42,20,15,4,Nebel
6/7/2016 6:00,221,160,61,16,2,
6/7/2016 7:00,835,574,261,18,4,
6/7/2016 8:00,1497,885,612,21,4,Klarer Himmel
6/7/2016 9:00,1155,607,548,23,2,Klarer Himmel
6/7/2016 10:00,1225,638,587,25,4,Klarer Himmel
6/7/2016 11:00,989,544,445,26,6,Klarer Himmel
6/7/2016 12:00,1330,636,694,27,6,wolkig
6/7/2016 13:00,1199,614,585,27,9,wolkig
6/7/2016 14:00,1268,624,644,28,11,teilweise bewölkt
6/7/2016 15:00,1463,723,740,22,9,wolkig
6/7/2016 16:00,994,521,473,18,15,Gewitter
6/7/2016 17:00,1359,575,784,20,9,wolkig
6/7/2016 18:00,1149,536,613,20,15,wolkig
6/7/2016 19:00,977,525,452,20,4,wolkig
6/7/2016 20:00,717,388,329,19,4,teilweise bewölkt
6/7/2016 21:00,479,199,280,18,6,Nebel
6/7/2016 22:00,472,142,330,16,6,Nebel
6/7/2016 23:00,288,68,220,16,2,Nebel
6/8/2016 0:00,196,50,146,15,4,Nebel
6/8/2016 1:00,68,15,53,15,4,Nebel
6/8/2016 2:00,40,21,19,14,2,Nebel
6/8/2016 3:00,17,6,11,13,4,Nebel
6/8/2016 4:00,19,14,5,13,6,Klarer Himmel
6/8/2016 5:00,51,36,15,13,7,Klarer Himmel
6/8/2016 6:00,198,154,44,13,7,Klarer Himmel
6/8/2016 7:00,976,710,266,14,9,Klarer Himmel
6/8/2016 8:00,1406,795,611,15,13,wolkig
6/8/2016 9:00,1044,583,461,16,11,wolkig
6/8/2016 10:00,1263,635,628,17,9,wolkig
6/8/2016 11:00,1107,604,503,18,13,wolkig
6/8/2016 12:00,1362,705,657,18,13,wolkig
6/8/2016 13:00,1121,597,524,19,17,wolkig
6/8/2016 14:00,1230,617,613,20,13,wolkig
6/8/2016 15:00,1311,657,654,21,15,wolkig
6/8/2016 16:00,1529,766,763,21,20,wolkig
6/8/2016 17:00,1625,861,764,19,24,wolkig
6/8/2016 18:00,1569,756,813,17,20,wolkig
6/8/2016 19:00,1392,684,708,17,15,wolkig
6/8/2016 20:00,1031,469,562,17,15,Klarer Himmel
6/8/2016 21:00,727,314,413,15,7,Klarer Himmel
6/8/2016 22:00,671,303,368,14,11,Klarer Himmel
6/8/2016 23:00,448,180,268,13,11,Klarer Himmel
6/9/2016 0:00,368,154,214,12,13,teilweise bewölkt
6/9/2016 1:00,254,116,138,12,11,wolkig
6/9/2016 2:00,131,32,99,12,11,wolkig
6/9/2016 3:00,116,26,90,12,11,wolkig
6/9/2016 4:00,121,23,98,12,9,wolkig
6/9/2016 5:00,100,56,44,12,7,wolkig
6/9/2016 6:00,194,132,62,12,13,wolkig
6/9/2016 7:00,776,521,255,12,9,wolkig
6/9/2016 8:00,1146,613,533,12,13,wolkig
6/9/2016 9:00,888,495,393,13,13,Regen
6/9/2016 10:00,1022,550,472,13,13,wolkig
6/9/2016 11:00,909,503,406,13,13,wolkig
6/9/2016 12:00,1013,506,507,14,13,wolkig
6/9/2016 13:00,1048,531,517,15,11,wolkig
6/9/2016 14:00,1134,580,554,16,11,wolkig
6/9/2016 15:00,1192,577,615,17,13,wolkig
6/9/2016 16:00,1359,706,653,18,15,wolkig
6/9/2016 17:00,1404,710,694,19,13,wolkig
6/9/2016 18:00,1428,714,714,19,11,teilweise bewölkt
6/9/2016 19:00,1149,562,587,18,7,teilweise bewölkt
6/9/2016 20:00,847,370,477,18,6,teilweise bewölkt
6/9/2016 21:00,639,317,322,14,0,Klarer Himmel
6/9/2016 22:00,528,211,317,13,6,Klarer Himmel
6/9/2016 23:00,384,145,239,12,11,Klarer Himmel
6/10/2016 0:00,236,93,143,11,11,Klarer Himmel
6/10/2016 1:00,130,30,100,10,6,Klarer Himmel
6/10/2016 2:00,48,16,32,9,6,Klarer Himmel
6/10/2016 3:00,67,17,50,9,4,Klarer Himmel
6/10/2016 4:00,43,12,31,9,6,Klarer Himmel
6/10/2016 5:00,73,37,36,9,4,Nebel
6/10/2016 6:00,163,121,42,9,6,
6/10/2016 7:00,791,564,227,11,7,teilweise bewölkt
6/10/2016 8:00,1070,636,434,13,7,teilweise bewölkt
6/10/2016 9:00,851,511,340,14,6,teilweise bewölkt
6/10/2016 10:00,883,430,453,16,7,teilweise bewölkt
6/10/2016 11:00,792,505,287,17,7,teilweise bewölkt
6/10/2016 12:00,1005,499,506,18,9,Klarer Himmel
6/10/2016 13:00,1065,526,539,19,11,Klarer Himmel
6/10/2016 14:00,1078,499,579,20,11,Klarer Himmel
6/10/2016 15:00,976,533,443,20,11,wolkig
6/10/2016 16:00,961,525,436,21,17,wolkig
6/10/2016 17:00,1007,558,449,21,13,wolkig
6/10/2016 18:00,993,501,492,21,11,wolkig
6/10/2016 19:00,918,473,445,20,11,wolkig
6/10/2016 20:00,742,390,352,18,13,wolkig
6/10/2016 21:00,453,188,265,17,9,Klarer Himmel
6/10/2016 22:00,387,136,251,16,11,Klarer Himmel
6/10/2016 23:00,522,196,326,15,7,Klarer Himmel
6/11/2016 0:00,344,127,217,14,9,Klarer Himmel
6/11/2016 1:00,300,104,196,12,4,Klarer Himmel
6/11/2016 2:00,166,31,135,12,6,Klarer Himmel
6/11/2016 3:00,154,29,125,12,6,Klarer Himmel
6/11/2016 4:00,93,24,69,12,6,Klarer Himmel
6/11/2016 5:00,56,27,29,12,6,Klarer Himmel
6/11/2016 6:00,62,31,31,12,4,Klarer Himmel
6/11/2016 7:00,128,91,37,13,7,Klarer Himmel
6/11/2016 8:00,259,181,78,14,6,Regen
6/11/2016 9:00,441,302,139,15,4,Regen
6/11/2016 10:00,545,337,208,16,6,Regen
6/11/2016 11:00,524,319,205,17,6,Regen
6/11/2016 12:00,626,384,242,18,4,wolkig
6/11/2016 13:00,682,376,306,20,4,wolkig
6/11/2016 14:00,597,285,312,20,6,wolkig
6/11/2016 15:00,637,308,329,21,7,wolkig
6/11/2016 16:00,614,284,330,21,11,wolkig
6/11/2016 17:00,607,273,334,21,9,wolkig
6/11/2016 18:00,667,303,364,21,7,Klarer Himmel
6/11/2016 19:00,604,316,288,20,11,Klarer Himmel
6/11/2016 20:00,547,257,290,19,6,Klarer Himmel
6/11/2016 21:00,406,207,199,18,4,Klarer Himmel
6/11/2016 22:00,313,164,149,17,4,Klarer Himmel
6/11/2016 23:00,294,132,162,14,2,Klarer Himmel
6/12/2016 0:00,318,152,166,14,0,Klarer Himmel
6/12/2016 1:00,249,69,180,13,2,Klarer Himmel
6/12/2016 2:00,157,39,118,12,0,Klarer Himmel
6/12/2016 3:00,159,52,107,12,0,Klarer Himmel
6/12/2016 4:00,92,20,72,12,0,Klarer Himmel
6/12/2016 5:00,52,14,38,12,0,Klarer Himmel
6/12/2016 6:00,47,15,32,13,0,Klarer Himmel
6/12/2016 7:00,39,20,19,16,0,Klarer Himmel
6/12/2016 8:00,96,66,30,17,0,wolkig
6/12/2016 9:00,247,179,68,18,0,wolkig
6/12/2016 10:00,398,235,163,20,4,wolkig
6/12/2016 11:00,352,210,142,19,9,wolkig
6/12/2016 12:00,415,252,163,19,9,wolkig
6/12/2016 13:00,400,214,186,20,9,wolkig
6/12/2016 14:00,552,309,243,22,6,wolkig
6/12/2016 15:00,437,204,233,20,9,Regen
6/12/2016 16:00,280,142,138,19,6,wolkig
6/12/2016 17:00,383,164,219,18,15,Regen
6/12/2016 18:00,423,192,231,17,13,Regen
6/12/2016 19:00,541,309,232,15,6,Regen
6/12/2016 20:00,838,479,359,15,6,wolkig
6/12/2016 21:00,194,90,104,15,6,wolkig
6/12/2016 22:00,88,38,50,15,4,wolkig
6/12/2016 23:00,1068,285,783,14,4,wolkig
6/13/2016 0:00,145,54,91,14,0,wolkig
6/13/2016 1:00,48,11,37,14,2,Regen
6/13/2016 2:00,14,1,13,14,4,wolkig
6/13/2016 3:00,6,4,2,15,6,Regen
6/13/2016 4:00,9,5,4,14,6,Regen
6/13/2016 5:00,50,36,14,14,4,Regen
6/13/2016 6:00,109,71,38,14,6,Regen
6/13/2016 7:00,540,383,157,15,6,Regen
6/13/2016 8:00,970,569,401,15,9,wolkig
6/13/2016 9:00,793,401,392,16,11,wolkig
6/13/2016 10:00,739,351,388,16,11,wolkig
6/13/2016 11:00,627,325,302,17,9,Regen
6/13/2016 12:00,798,407,391,18,11,wolkig
6/13/2016 13:00,891,480,411,19,7,wolkig
6/13/2016 14:00,858,425,433,15,11,Gewitter
6/13/2016 15:00,894,445,449,17,2,wolkig
6/13/2016 16:00,994,520,474,18,11,wolkig
6/13/2016 17:00,1242,593,649,19,13,Regen
6/13/2016 18:00,1179,566,613,19,11,wolkig
6/13/2016 19:00,917,436,481,19,19,teilweise bewölkt
6/13/2016 20:00,714,288,426,17,13,wolkig
6/13/2016 21:00,430,156,274,16,13,wolkig
6/13/2016 22:00,321,107,214,15,11,wolkig
6/13/2016 23:00,280,75,205,15,9,wolkig
6/14/2016 0:00,101,28,73,15,11,wolkig
6/14/2016 1:00,39,16,23,15,13,wolkig
6/14/2016 2:00,22,12,10,14,9,wolkig
6/14/2016 3:00,11,6,5,14,6,wolkig
6/14/2016 4:00,18,10,8,14,6,wolkig
6/14/2016 5:00,54,34,20,14,6,wolkig
6/14/2016 6:00,88,66,22,14,7,wolkig
6/14/2016 7:00,530,356,174,14,9,Regen
6/14/2016 8:00,1117,618,499,14,9,wolkig
6/14/2016 9:00,869,455,414,16,13,wolkig
6/14/2016 10:00,1042,507,535,15,13,wolkig
6/14/2016 11:00,725,410,315,16,15,wolkig
6/14/2016 12:00,1047,534,513,17,15,wolkig
6/14/2016 13:00,979,527,452,17,17,Regen
6/14/2016 14:00,990,511,479,18,17,wolkig
6/14/2016 15:00,1024,565,459,18,17,teilweise bewölkt
6/14/2016 16:00,1193,556,637,19,9,teilweise bewölkt
6/14/2016 17:00,1278,657,621,19,11,wolkig
6/14/2016 18:00,1271,596,675,20,17,wolkig
6/14/2016 19:00,1148,559,589,19,9,wolkig
6/14/2016 20:00,884,378,506,17,7,wolkig
6/14/2016 21:00,547,227,320,15,6,wolkig
6/14/2016 22:00,433,197,236,15,11,wolkig
6/14/2016 23:00,306,112,194,14,4,teilweise bewölkt
6/15/2016 0:00,141,37,104,13,6,teilweise bewölkt
6/15/2016 1:00,91,22,69,13,6,Nebel
6/15/2016 2:00,31,17,14,13,2,Nebel
6/15/2016 3:00,29,21,8,13,4,Nebel
6/15/2016 4:00,15,8,7,13,4,
6/15/2016 5:00,57,42,15,13,6,
6/15/2016 6:00,166,126,40,13,7,Klarer Himmel
6/15/2016 7:00,785,561,224,14,4,wolkig
6/15/2016 8:00,1226,690,536,14,4,wolkig
6/15/2016 9:00,967,547,420,15,7,wolkig
6/15/2016 10:00,1096,606,490,16,9,wolkig
6/15/2016 11:00,852,431,421,17,6,Regen
6/15/2016 12:00,850,418,432,13,9,Regen
6/15/2016 13:00,919,477,442,15,6,Regen
6/15/2016 14:00,910,408,502,17,4,Regen
6/15/2016 15:00,944,504,440,18,7,wolkig
6/15/2016 16:00,1148,552,596,18,11,wolkig
6/15/2016 17:00,1222,640,582,18,11,Regen
6/15/2016 18:00,1226,581,645,17,13,wolkig
6/15/2016 19:00,1038,501,537,17,7,wolkig
6/15/2016 20:00,793,389,404,16,11,wolkig
6/15/2016 21:00,545,286,259,15,9,wolkig
6/15/2016 22:00,420,172,248,14,4,wolkig
6/15/2016 23:00,399,157,242,14,6,Klarer Himmel
6/16/2016 0:00,256,96,160,13,6,Klarer Himmel
6/16/2016 1:00,197,68,129,13,6,Klarer Himmel
6/16/2016 2:00,99,23,76,13,7,Klarer Himmel
6/16/2016 3:00,65,20,45,12,4,Klarer Himmel
6/16/2016 4:00,67,19,48,10,4,Nebel
6/16/2016 5:00,79,41,38,10,6,Nebel
6/16/2016 6:00,165,119,46,12,7,Nebel
6/16/2016 7:00,772,512,260,12,9,wolkig
6/16/2016 8:00,1133,583,550,15,4,wolkig
6/16/2016 9:00,941,519,422,17,4,teilweise bewölkt
6/16/2016 10:00,1044,578,466,18,4,wolkig
6/16/2016 11:00,897,485,412,19,6,wolkig
6/16/2016 12:00,1087,551,536,19,7,wolkig
6/16/2016 13:00,1057,524,533,20,7,wolkig
6/16/2016 14:00,1217,597,620,20,4,wolkig
6/16/2016 15:00,1160,589,571,20,4,wolkig
6/16/2016 16:00,1314,691,623,20,6,Regen
6/16/2016 17:00,1245,599,646,20,7,Gewitter
6/16/2016 18:00,1221,604,617,17,13,Regen
6/16/2016 19:00,1053,639,414,17,11,Regen
6/16/2016 20:00,1244,678,566,16,7,wolkig
6/16/2016 21:00,307,134,173,15,6,wolkig
6/16/2016 22:00,186,82,104,14,4,Klarer Himmel
6/16/2016 23:00,1403,464,939,13,2,Klarer Himmel
6/17/2016 0:00,283,76,207,13,2,wolkig
6/17/2016 1:00,131,32,99,14,2,wolkig
6/17/2016 2:00,60,7,53,14,0,wolkig
6/17/2016 3:00,38,13,25,14,2,wolkig
6/17/2016 4:00,38,11,27,14,4,Regen
6/17/2016 5:00,55,31,24,13,4,Nebel
6/17/2016 6:00,165,115,50,14,4,wolkig
6/17/2016 7:00,633,422,211,15,7,teilweise bewölkt
6/17/2016 8:00,924,551,373,15,11,wolkig
6/17/2016 9:00,703,390,313,16,9,teilweise bewölkt
6/17/2016 10:00,642,294,348,15,13,Regen
6/17/2016 11:00,648,374,274,15,11,Regen
6/17/2016 12:00,790,453,337,15,13,Regen
6/17/2016 13:00,882,439,443,16,9,Regen
6/17/2016 14:00,777,364,413,16,11,wolkig
6/17/2016 15:00,779,424,355,16,15,wolkig
6/17/2016 16:00,632,307,325,17,15,wolkig
6/17/2016 17:00,805,429,376,18,17,teilweise bewölkt
6/17/2016 18:00,737,378,359,17,11,Regen
6/17/2016 19:00,692,332,360,17,13,Klarer Himmel
6/17/2016 20:00,540,277,263,17,7,Klarer Himmel
6/17/2016 21:00,351,179,172,16,7,wolkig
6/17/2016 22:00,340,150,190,15,7,Klarer Himmel
6/17/2016 23:00,344,131,213,14,6,Klarer Himmel
6/18/2016 0:00,269,101,168,15,7,Klarer Himmel
6/18/2016 1:00,215,70,145,13,6,wolkig
6/18/2016 2:00,146,50,96,14,7,teilweise bewölkt
6/18/2016 3:00,125,27,98,14,7,wolkig
6/18/2016 4:00,91,35,56,14,6,wolkig
6/18/2016 5:00,82,29,53,13,7,wolkig
6/18/2016 6:00,81,53,28,13,4,Regen
6/18/2016 7:00,154,125,29,14,7,Regen
6/18/2016 8:00,228,165,63,15,6,wolkig
6/18/2016 9:00,371,278,93,15,4,wolkig
6/18/2016 10:00,527,362,165,16,6,wolkig
6/18/2016 11:00,505,341,164,16,9,Regen
6/18/2016 12:00,535,295,240,15,9,wolkig
6/18/2016 13:00,521,287,234,16,15,Regen
6/18/2016 14:00,541,270,271,16,13,Regen
6/18/2016 15:00,540,274,266,18,9,wolkig
6/18/2016 16:00,567,280,287,18,9,Regen
6/18/2016 17:00,388,146,242,15,9,wolkig
6/18/2016 18:00,440,168,272,15,9,wolkig
6/18/2016 19:00,446,210,236,16,11,wolkig
6/18/2016 20:00,285,139,146,15,13,Regen
6/18/2016 21:00,293,157,136,14,9,wolkig
6/18/2016 22:00,259,116,143,14,15,wolkig
6/18/2016 23:00,236,111,125,14,11,wolkig
6/19/2016 0:00,189,84,105,14,11,Regen
6/19/2016 1:00,229,68,161,13,7,Regen
6/19/2016 2:00,138,29,109,13,11,wolkig
6/19/2016 3:00,104,27,77,12,15,Regen
6/19/2016 4:00,90,29,61,12,9,wolkig
6/19/2016 5:00,51,15,36,12,11,wolkig
6/19/2016 6:00,40,19,21,12,9,wolkig
6/19/2016 7:00,47,25,22,12,13,wolkig
6/19/2016 8:00,99,59,40,13,11,wolkig
6/19/2016 9:00,218,151,67,14,9,teilweise bewölkt
6/19/2016 10:00,299,187,112,14,13,wolkig
6/19/2016 11:00,340,177,163,14,13,wolkig
6/19/2016 12:00,346,176,170,14,13,Regen
6/19/2016 13:00,418,236,182,17,7,teilweise bewölkt
6/19/2016 14:00,546,306,240,16,15,wolkig
6/19/2016 15:00,531,274,257,18,9,teilweise bewölkt
6/19/2016 16:00,520,284,236,18,13,teilweise bewölkt
6/19/2016 17:00,636,351,285,18,7,teilweise bewölkt
6/19/2016 18:00,537,257,280,18,7,teilweise bewölkt
6/19/2016 19:00,458,197,261,17,6,teilweise bewölkt
6/19/2016 20:00,431,167,264,16,6,teilweise bewölkt
6/19/2016 21:00,269,104,165,14,9,teilweise bewölkt
6/19/2016 22:00,210,65,145,11,4,Klarer Himmel
6/19/2016 23:00,169,48,121,11,4,Klarer Himmel
6/20/2016 0:00,86,40,46,10,4,Klarer Himmel
6/20/2016 1:00,48,21,27,9,2,Nebel
6/20/2016 2:00,13,5,8,9,4,Nebel
6/20/2016 3:00,10,3,7,9,4,Nebel
6/20/2016 4:00,8,5,3,9,7,teilweise bewölkt
6/20/2016 5:00,58,37,21,9,6,teilweise bewölkt
6/20/2016 6:00,168,130,38,10,11,Klarer Himmel
6/20/2016 7:00,718,514,204,13,11,Klarer Himmel
6/20/2016 8:00,1094,636,458,16,19,wolkig
6/20/2016 9:00,857,459,398,18,22,wolkig
6/20/2016 10:00,988,500,488,19,22,wolkig
6/20/2016 11:00,826,423,403,19,26,wolkig
6/20/2016 12:00,1078,516,562,20,26,wolkig
6/20/2016 13:00,957,471,486,19,22,Regen
6/20/2016 14:00,1077,531,546,20,15,Regen
6/20/2016 15:00,1108,575,533,20,19,Regen
6/20/2016 16:00,1116,540,576,19,13,Regen
6/20/2016 17:00,1363,687,676,18,11,Regen
6/20/2016 18:00,1015,407,608,17,15,Regen
6/20/2016 19:00,707,327,380,16,13,Regen
6/20/2016 20:00,502,212,290,16,20,Regen
6/20/2016 21:00,355,140,215,15,17,Regen
6/20/2016 22:00,291,105,186,15,17,Regen
6/20/2016 23:00,180,59,121,15,15,Regen
6/21/2016 0:00,82,39,43,16,17,wolkig
6/21/2016 1:00,45,20,25,16,19,wolkig
6/21/2016 2:00,17,12,5,15,11,wolkig
6/21/2016 3:00,9,4,5,15,13,wolkig
6/21/2016 4:00,13,8,5,15,9,wolkig
6/21/2016 5:00,46,34,12,15,9,wolkig
6/21/2016 6:00,134,101,33,16,9,Regen
6/21/2016 7:00,645,425,220,16,13,wolkig
6/21/2016 8:00,1098,643,455,17,17,wolkig
6/21/2016 9:00,895,468,427,17,13,wolkig
6/21/2016 10:00,1005,539,466,17,15,wolkig
6/21/2016 11:00,853,454,399,18,13,wolkig
6/21/2016 12:00,1060,525,535,19,15,wolkig
6/21/2016 13:00,973,492,481,19,13,wolkig
6/21/2016 14:00,1110,568,542,19,13,wolkig
6/21/2016 15:00,1114,544,570,20,9,wolkig
6/21/2016 16:00,1473,784,689,21,7,wolkig
6/21/2016 17:00,2248,1283,965,21,11,Regen
6/21/2016 18:00,731,322,409,20,11,Regen
6/21/2016 19:00,466,222,244,20,7,wolkig
6/21/2016 20:00,1441,544,897,19,4,wolkig
6/21/2016 21:00,647,289,358,19,2,wolkig
6/21/2016 22:00,558,192,366,18,7,wolkig
6/21/2016 23:00,413,134,279,18,9,wolkig
6/22/2016 0:00,156,49,107,18,7,wolkig
6/22/2016 1:00,108,36,72,18,9,wolkig
6/22/2016 2:00,29,9,20,18,9,Regen
6/22/2016 3:00,27,14,13,18,7,wolkig
6/22/2016 4:00,23,10,13,17,9,wolkig
6/22/2016 5:00,58,40,18,17,7,teilweise bewölkt
6/22/2016 6:00,190,146,44,17,6,wolkig
6/22/2016 7:00,883,651,232,18,7,wolkig
6/22/2016 8:00,1331,754,577,18,11,wolkig
6/22/2016 9:00,1007,583,424,19,13,teilweise bewölkt
6/22/2016 10:00,1160,606,554,21,17,teilweise bewölkt
6/22/2016 11:00,989,551,438,21,13,teilweise bewölkt
6/22/2016 12:00,1132,558,574,22,17,wolkig
6/22/2016 13:00,1182,639,543,24,17,wolkig
6/22/2016 14:00,1394,685,709,24,17,teilweise bewölkt
6/22/2016 15:00,1276,625,651,24,13,wolkig
6/22/2016 16:00,1642,757,885,24,15,wolkig
6/22/2016 17:00,1612,801,811,24,7,wolkig
6/22/2016 18:00,1681,803,878,24,7,teilweise bewölkt
6/22/2016 19:00,1278,668,610,24,6,teilweise bewölkt
6/22/2016 20:00,1016,551,465,23,4,Klarer Himmel
6/22/2016 21:00,757,416,341,21,4,Klarer Himmel
6/22/2016 22:00,613,244,369,19,2,Klarer Himmel
6/22/2016 23:00,475,174,301,19,6,teilweise bewölkt
6/23/2016 0:00,360,193,167,19,4,teilweise bewölkt
6/23/2016 1:00,199,75,124,17,4,Klarer Himmel
6/23/2016 2:00,113,18,95,16,4,Klarer Himmel
6/23/2016 3:00,115,31,84,18,4,wolkig
6/23/2016 4:00,107,22,85,18,6,wolkig
6/23/2016 5:00,140,54,86,18,6,Klarer Himmel
6/23/2016 6:00,192,141,51,19,4,teilweise bewölkt
6/23/2016 7:00,773,511,262,21,9,Klarer Himmel
6/23/2016 8:00,1117,603,514,23,9,Klarer Himmel
6/23/2016 9:00,1001,594,407,25,13,Klarer Himmel
6/23/2016 10:00,993,546,447,27,13,Klarer Himmel
6/23/2016 11:00,945,510,435,28,15,Klarer Himmel
6/23/2016 12:00,1170,583,587,29,19,teilweise bewölkt
6/23/2016 13:00,1204,614,590,31,19,teilweise bewölkt
6/23/2016 14:00,1242,640,602,31,15,Klarer Himmel
6/23/2016 15:00,1369,733,636,32,17,Klarer Himmel
6/23/2016 16:00,1478,809,669,32,15,Klarer Himmel
6/23/2016 17:00,1582,927,655,33,7,Klarer Himmel
6/23/2016 18:00,1200,579,621,28,4,Gewitter
6/23/2016 19:00,1069,630,439,20,15,Gewitter
6/23/2016 20:00,825,506,319,21,15,Gewitter
6/23/2016 21:00,475,250,225,21,11,wolkig
6/23/2016 22:00,470,143,327,21,6,wolkig
6/23/2016 23:00,760,110,650,21,28,Regen
6/24/2016 0:00,241,36,205,20,13,Gewitter
6/24/2016 1:00,188,30,158,20,11,teilweise bewölkt
6/24/2016 2:00,71,13,58,19,9,teilweise bewölkt
6/24/2016 3:00,30,10,20,19,6,Gewitter
6/24/2016 4:00,30,9,21,19,4,Gewitter
6/24/2016 5:00,31,15,16,19,15,Gewitter
6/24/2016 6:00,138,97,41,19,6,Gewitter
6/24/2016 7:00,490,351,139,20,6,Regen
6/24/2016 8:00,581,299,282,19,9,Regen
6/24/2016 9:00,642,362,280,22,4,teilweise bewölkt
6/24/2016 10:00,701,376,325,22,6,Klarer Himmel
6/24/2016 11:00,714,435,279,25,6,Klarer Himmel
6/24/2016 12:00,810,443,367,27,4,teilweise bewölkt
6/24/2016 13:00,857,421,436,27,6,wolkig
6/24/2016 14:00,806,399,407,25,11,wolkig
6/24/2016 15:00,767,428,339,25,20,wolkig
6/24/2016 16:00,740,389,351,24,19,wolkig
6/24/2016 17:00,850,483,367,23,15,wolkig
6/24/2016 18:00,826,391,435,23,13,wolkig
6/24/2016 19:00,745,411,334,22,9,wolkig
6/24/2016 20:00,624,354,270,22,6,wolkig
6/24/2016 21:00,470,273,197,21,6,wolkig
6/24/2016 22:00,492,224,268,20,7,wolkig
6/24/2016 23:00,568,184,384,19,2,teilweise bewölkt
6/25/2016 0:00,339,101,238,18,4,wolkig
6/25/2016 1:00,207,92,115,18,0,teilweise bewölkt
6/25/2016 2:00,169,50,119,18,7,teilweise bewölkt
6/25/2016 3:00,139,39,100,18,7,wolkig
6/25/2016 4:00,95,32,63,18,7,wolkig
6/25/2016 5:00,63,27,36,18,6,wolkig
6/25/2016 6:00,62,40,22,18,4,wolkig
6/25/2016 7:00,106,80,26,18,9,wolkig
6/25/2016 8:00,173,125,48,18,6,Regen
6/25/2016 9:00,191,132,59,17,28,Regen
6/25/2016 10:00,148,100,48,17,4,Regen
6/25/2016 11:00,215,110,105,17,9,Regen
6/25/2016 12:00,210,116,94,17,15,Regen
6/25/2016 13:00,215,98,117,16,11,Regen
6/25/2016 14:00,265,125,140,16,11,Regen
6/25/2016 15:00,217,106,111,16,15,Regen
6/25/2016 16:00,273,127,146,15,15,Regen
6/25/2016 17:00,283,157,126,15,17,Regen
6/25/2016 18:00,335,173,162,15,9,Regen
6/25/2016 19:00,367,205,162,15,6,Regen
6/25/2016 20:00,349,199,150,15,4,Regen
6/25/2016 21:00,266,156,110,15,13,wolkig
6/25/2016 22:00,245,133,112,14,11,wolkig
6/25/2016 23:00,259,103,156,15,9,wolkig
6/26/2016 0:00,251,93,158,14,7,teilweise bewölkt
6/26/2016 1:00,174,76,98,14,13,wolkig
6/26/2016 2:00,131,28,103,14,7,teilweise bewölkt
6/26/2016 3:00,115,40,75,13,9,teilweise bewölkt
6/26/2016 4:00,68,16,52,12,7,Nebel
6/26/2016 5:00,51,15,36,12,7,teilweise bewölkt
6/26/2016 6:00,31,16,15,12,11,teilweise bewölkt
6/26/2016 7:00,49,32,17,13,9,teilweise bewölkt
6/26/2016 8:00,104,67,37,15,17,wolkig
6/26/2016 9:00,235,177,58,15,17,wolkig
6/26/2016 10:00,308,199,109,16,22,wolkig
6/26/2016 11:00,359,240,119,17,24,teilweise bewölkt
6/26/2016 12:00,467,246,221,17,20,wolkig
6/26/2016 13:00,429,249,180,18,19,teilweise bewölkt
6/26/2016 14:00,565,300,265,18,15,wolkig
6/26/2016 15:00,635,343,292,20,17,wolkig
6/26/2016 16:00,701,358,343,13,7,Regen
6/26/2016 17:00,1128,645,483,17,9,teilweise bewölkt
6/26/2016 18:00,320,170,150,17,9,teilweise bewölkt
6/26/2016 19:00,259,117,142,18,13,teilweise bewölkt
6/26/2016 20:00,897,360,537,17,13,teilweise bewölkt
6/26/2016 21:00,493,171,322,16,9,teilweise bewölkt
6/26/2016 22:00,260,75,185,15,9,teilweise bewölkt
6/26/2016 23:00,254,82,172,15,7,Klarer Himmel
6/27/2016 0:00,106,33,73,14,9,Klarer Himmel
6/27/2016 1:00,34,9,25,13,9,teilweise bewölkt
6/27/2016 2:00,25,8,17,13,7,teilweise bewölkt
6/27/2016 3:00,11,7,4,13,9,teilweise bewölkt
6/27/2016 4:00,20,10,10,12,9,Klarer Himmel
6/27/2016 5:00,61,40,21,12,9,
6/27/2016 6:00,151,116,35,13,13,
6/27/2016 7:00,657,451,206,14,20,teilweise bewölkt
6/27/2016 8:00,1013,593,420,15,22,teilweise bewölkt
6/27/2016 9:00,801,459,342,16,22,teilweise bewölkt
6/27/2016 10:00,849,423,426,17,20,wolkig
6/27/2016 11:00,786,410,376,19,19,wolkig
6/27/2016 12:00,964,488,476,18,26,wolkig
6/27/2016 13:00,1047,537,510,19,24,wolkig
6/27/2016 14:00,983,470,513,18,22,wolkig
6/27/2016 15:00,1170,623,547,18,20,wolkig
6/27/2016 16:00,1183,568,615,16,15,Regen
6/27/2016 17:00,1422,718,704,17,15,wolkig
6/27/2016 18:00,1135,508,627,17,9,Regen
6/27/2016 19:00,773,360,413,17,9,Regen
6/27/2016 20:00,570,266,304,15,6,wolkig
6/27/2016 21:00,397,175,222,15,9,teilweise bewölkt
6/27/2016 22:00,365,129,236,14,11,teilweise bewölkt
6/27/2016 23:00,209,73,136,13,7,Klarer Himmel
6/28/2016 0:00,130,41,89,12,7,Nebel
6/28/2016 1:00,52,9,43,11,4,Nebel
6/28/2016 2:00,17,6,11,11,0,Nebel
6/28/2016 3:00,21,13,8,10,2,Nebel
6/28/2016 4:00,15,12,3,10,2,Nebel
6/28/2016 5:00,57,35,22,10,2,Nebel
6/28/2016 6:00,171,131,40,11,4,Nebel
6/28/2016 7:00,690,470,220,13,4,teilweise bewölkt
6/28/2016 8:00,1241,742,499,15,6,teilweise bewölkt
6/28/2016 9:00,1062,568,494,16,7,teilweise bewölkt
6/28/2016 10:00,1108,588,520,17,6,teilweise bewölkt
6/28/2016 11:00,865,451,414,19,4,teilweise bewölkt
6/28/2016 12:00,1201,569,632,20,9,teilweise bewölkt
6/28/2016 13:00,1149,595,554,20,9,teilweise bewölkt
6/28/2016 14:00,1155,588,567,21,7,wolkig
6/28/2016 15:00,1133,617,516,21,11,wolkig
6/28/2016 16:00,1377,701,676,21,7,wolkig
6/28/2016 17:00,1480,742,738,21,7,wolkig
6/28/2016 18:00,1454,704,750,21,7,wolkig
6/28/2016 19:00,1247,612,635,21,7,teilweise bewölkt
6/28/2016 20:00,796,376,420,20,6,Klarer Himmel
6/28/2016 21:00,619,253,366,19,4,Klarer Himmel
6/28/2016 22:00,534,176,358,18,6,Klarer Himmel
6/28/2016 23:00,369,121,248,18,7,Klarer Himmel
6/29/2016 0:00,220,60,160,17,7,Klarer Himmel
6/29/2016 1:00,103,30,73,17,7,wolkig
6/29/2016 2:00,37,15,22,15,9,Regen
6/29/2016 3:00,18,8,10,15,9,Regen
6/29/2016 4:00,12,7,5,15,13,Regen
6/29/2016 5:00,67,45,22,14,9,
6/29/2016 6:00,186,140,46,15,13,teilweise bewölkt
6/29/2016 7:00,865,623,242,15,19,teilweise bewölkt
6/29/2016 8:00,1273,721,552,16,24,wolkig
6/29/2016 9:00,965,584,381,16,24,wolkig
6/29/2016 10:00,1105,585,520,16,26,wolkig
6/29/2016 11:00,865,476,389,17,24,teilweise bewölkt
6/29/2016 12:00,1010,514,496,17,20,wolkig
6/29/2016 13:00,1047,577,470,18,19,wolkig
6/29/2016 14:00,1035,510,525,19,26,teilweise bewölkt
6/29/2016 15:00,1047,524,523,20,26,teilweise bewölkt
6/29/2016 16:00,1273,637,636,21,22,wolkig
6/29/2016 17:00,1330,684,646,20,20,wolkig
6/29/2016 18:00,1286,595,691,20,19,wolkig
6/29/2016 19:00,1098,567,531,20,11,Klarer Himmel
6/29/2016 20:00,862,388,474,19,9,Klarer Himmel
6/29/2016 21:00,551,259,292,18,6,Klarer Himmel
6/29/2016 22:00,511,230,281,17,7,Klarer Himmel
6/29/2016 23:00,400,143,257,16,6,Klarer Himmel
6/30/2016 0:00,317,105,212,15,6,Klarer Himmel
6/30/2016 1:00,202,55,147,16,9,Klarer Himmel
6/30/2016 2:00,127,42,85,16,7,Klarer Himmel
6/30/2016 3:00,54,22,32,16,9,Klarer Himmel
6/30/2016 4:00,41,15,26,17,13,Klarer Himmel
6/30/2016 5:00,84,49,35,17,11,Klarer Himmel
6/30/2016 6:00,153,118,35,16,9,wolkig
6/30/2016 7:00,611,403,208,16,11,wolkig
6/30/2016 8:00,1052,600,452,16,15,wolkig
6/30/2016 9:00,854,492,362,17,19,wolkig
6/30/2016 10:00,1011,580,431,17,19,wolkig
6/30/2016 11:00,826,457,369,17,17,wolkig
6/30/2016 12:00,990,495,495,18,20,Regen
6/30/2016 13:00,1000,513,487,19,20,wolkig
6/30/2016 14:00,1042,528,514,19,20,wolkig
6/30/2016 15:00,1167,622,545,19,15,Regen
6/30/2016 16:00,1133,556,577,19,20,Regen
6/30/2016 17:00,1121,576,545,19,13,wolkig
6/30/2016 18:00,1212,598,614,20,17,wolkig
6/30/2016 19:00,946,478,468,20,13,wolkig
6/30/2016 20:00,764,311,453,20,15,wolkig
6/30/2016 21:00,440,204,236,19,15,wolkig
6/30/2016 22:00,386,162,224,18,15,wolkig
6/30/2016 23:00,293,134,159,17,13,Klarer Himmel
7/1/2016 0:00,277,73,204,17,9,wolkig
7/1/2016 1:00,81,23,58,17,13,wolkig
7/1/2016 2:00,52,17,35,16,9,wolkig
7/1/2016 3:00,44,21,23,16,11,wolkig
7/1/2016 4:00,22,13,9,16,11,Klarer Himmel
7/1/2016 5:00,57,31,26,16,11,wolkig
7/1/2016 6:00,149,110,39,17,13,wolkig
7/1/2016 7:00,642,440,202,18,15,wolkig
7/1/2016 8:00,971,582,389,19,19,wolkig
7/1/2016 9:00,786,454,332,20,17,wolkig
7/1/2016 10:00,714,373,341,17,20,Regen
7/1/2016 11:00,737,443,294,17,17,wolkig
7/1/2016 12:00,864,480,384,20,22,wolkig
7/1/2016 13:00,916,449,467,20,19,wolkig
7/1/2016 14:00,940,446,494,20,17,wolkig
7/1/2016 15:00,813,398,415,20,20,Regen
7/1/2016 16:00,802,408,394,21,19,wolkig
7/1/2016 17:00,851,448,403,21,19,wolkig
7/1/2016 18:00,830,448,382,22,22,wolkig
7/1/2016 19:00,800,472,328,21,17,wolkig
7/1/2016 20:00,639,336,303,20,13,Klarer Himmel
7/1/2016 21:00,433,211,222,19,15,wolkig
7/1/2016 22:00,391,137,254,19,13,Klarer Himmel
7/1/2016 23:00,426,158,268,19,15,wolkig
7/2/2016 0:00,296,106,190,17,20,Regen
7/2/2016 1:00,202,56,146,16,11,Regen
7/2/2016 2:00,150,35,115,16,11,Regen
7/2/2016 3:00,78,19,59,15,11,Regen
7/2/2016 4:00,55,13,42,14,32,Regen
7/2/2016 5:00,51,27,24,14,15,Regen
7/2/2016 6:00,49,30,19,14,17,wolkig
7/2/2016 7:00,106,79,27,14,20,wolkig
7/2/2016 8:00,211,132,79,14,19,wolkig
7/2/2016 9:00,430,294,136,15,22,wolkig
7/2/2016 10:00,495,360,135,15,19,wolkig
7/2/2016 11:00,566,375,191,14,20,Regen
7/2/2016 12:00,616,391,225,17,22,teilweise bewölkt
7/2/2016 13:00,636,369,267,15,22,Regen
7/2/2016 14:00,575,270,305,19,22,teilweise bewölkt
7/2/2016 15:00,632,306,326,14,6,Regen
7/2/2016 16:00,604,286,318,16,15,teilweise bewölkt
7/2/2016 17:00,495,216,279,15,26,Regen
7/2/2016 18:00,694,305,389,16,17,teilweise bewölkt
7/2/2016 19:00,775,487,288,16,19,teilweise bewölkt
7/2/2016 20:00,939,613,326,15,13,teilweise bewölkt
7/2/2016 21:00,185,81,104,14,11,teilweise bewölkt
7/2/2016 22:00,130,39,91,13,11,teilweise bewölkt
7/2/2016 23:00,155,36,119,13,9,Klarer Himmel
7/3/2016 0:00,915,297,618,12,9,Klarer Himmel
7/3/2016 1:00,356,83,273,12,9,teilweise bewölkt
7/3/2016 2:00,196,52,144,11,9,teilweise bewölkt
7/3/2016 3:00,158,28,130,11,11,Klarer Himmel
7/3/2016 4:00,87,28,59,11,11,teilweise bewölkt
7/3/2016 5:00,62,25,37,11,9,teilweise bewölkt
7/3/2016 6:00,43,19,24,11,11,teilweise bewölkt
7/3/2016 7:00,51,24,27,13,17,wolkig
7/3/2016 8:00,64,37,27,13,19,Regen
7/3/2016 9:00,185,127,58,13,15,wolkig
7/3/2016 10:00,309,218,91,15,13,wolkig
7/3/2016 11:00,297,183,114,17,15,teilweise bewölkt
7/3/2016 12:00,402,254,148,15,7,Gewitter
7/3/2016 13:00,468,297,171,19,19,teilweise bewölkt
7/3/2016 14:00,475,256,219,17,28,teilweise bewölkt
7/3/2016 15:00,483,243,240,18,19,wolkig
7/3/2016 16:00,596,299,297,19,19,teilweise bewölkt
7/3/2016 17:00,681,363,318,19,17,teilweise bewölkt
7/3/2016 18:00,598,277,321,19,15,teilweise bewölkt
7/3/2016 19:00,473,206,267,16,11,teilweise bewölkt
7/3/2016 20:00,420,156,264,16,9,wolkig
7/3/2016 21:00,268,90,178,14,6,teilweise bewölkt
7/3/2016 22:00,209,76,133,13,6,teilweise bewölkt
7/3/2016 23:00,227,69,158,12,2,Klarer Himmel
7/4/2016 0:00,70,28,42,11,2,Nebel
7/4/2016 1:00,40,17,23,10,2,Nebel
7/4/2016 2:00,20,9,11,11,2,Nebel
7/4/2016 3:00,11,6,5,11,2,Nebel
7/4/2016 4:00,10,9,1,10,2,Nebel
7/4/2016 5:00,49,32,17,11,2,Klarer Himmel
7/4/2016 6:00,150,116,34,12,2,Klarer Himmel
7/4/2016 7:00,675,478,197,13,4,Klarer Himmel
7/4/2016 8:00,1030,586,444,15,6,Klarer Himmel
7/4/2016 9:00,804,466,338,18,6,wolkig
7/4/2016 10:00,924,507,417,19,7,teilweise bewölkt
7/4/2016 11:00,814,483,331,20,9,teilweise bewölkt
7/4/2016 12:00,1037,493,544,20,11,teilweise bewölkt
7/4/2016 13:00,993,505,488,21,9,teilweise bewölkt
7/4/2016 14:00,1041,568,473,22,9,teilweise bewölkt
7/4/2016 15:00,1067,574,493,22,9,teilweise bewölkt
7/4/2016 16:00,1323,615,708,22,11,teilweise bewölkt
7/4/2016 17:00,1503,720,783,22,11,teilweise bewölkt
7/4/2016 18:00,1353,632,721,22,11,teilweise bewölkt
7/4/2016 19:00,1038,481,557,21,6,wolkig
7/4/2016 20:00,813,341,472,20,9,teilweise bewölkt
7/4/2016 21:00,468,216,252,18,6,Klarer Himmel
7/4/2016 22:00,462,161,301,17,2,Klarer Himmel
7/4/2016 23:00,310,112,198,15,2,Klarer Himmel
7/5/2016 0:00,139,48,91,15,4,wolkig
7/5/2016 1:00,91,29,62,14,2,Klarer Himmel
7/5/2016 2:00,42,19,23,13,2,Nebel
7/5/2016 3:00,17,9,8,13,6,Nebel
7/5/2016 4:00,12,11,1,13,2,Nebel
7/5/2016 5:00,51,30,21,14,6,wolkig
7/5/2016 6:00,158,119,39,15,6,Klarer Himmel
7/5/2016 7:00,707,464,243,17,15,Klarer Himmel
7/5/2016 8:00,1211,757,454,18,20,
7/5/2016 9:00,1218,595,623,19,26,teilweise bewölkt
7/5/2016 10:00,1059,576,483,19,20,wolkig
7/5/2016 11:00,833,428,405,19,26,wolkig
7/5/2016 12:00,1026,515,511,18,28,wolkig
7/5/2016 13:00,961,477,484,17,26,Regen
7/5/2016 14:00,986,490,496,19,22,wolkig
7/5/2016 15:00,993,491,502,19,26,wolkig
7/5/2016 16:00,1288,617,671,19,28,wolkig
7/5/2016 17:00,1377,699,678,19,35,teilweise bewölkt
7/5/2016 18:00,1253,595,658,18,41,teilweise bewölkt
7/5/2016 19:00,1128,610,518,16,35,wolkig
7/5/2016 20:00,764,303,461,15,26,wolkig
7/5/2016 21:00,636,266,370,14,24,wolkig
7/5/2016 22:00,469,141,328,14,19,wolkig
7/5/2016 23:00,263,93,170,14,20,wolkig
7/6/2016 0:00,181,37,144,13,17,wolkig
7/6/2016 1:00,104,24,80,13,17,wolkig
7/6/2016 2:00,33,26,7,13,17,wolkig
7/6/2016 3:00,28,19,9,12,15,wolkig
7/6/2016 4:00,17,11,6,12,15,wolkig
7/6/2016 5:00,52,27,25,12,13,teilweise bewölkt
7/6/2016 6:00,192,144,48,12,17,teilweise bewölkt
7/6/2016 7:00,749,511,238,13,19,teilweise bewölkt
7/6/2016 8:00,1266,806,460,15,20,teilweise bewölkt
7/6/2016 9:00,996,606,390,15,22,teilweise bewölkt
7/6/2016 10:00,1052,551,501,16,20,teilweise bewölkt
7/6/2016 11:00,983,559,424,16,17,wolkig
7/6/2016 12:00,1153,559,594,17,17,wolkig
7/6/2016 13:00,1072,491,581,19,22,teilweise bewölkt
7/6/2016 14:00,1092,502,590,19,19,teilweise bewölkt
7/6/2016 15:00,1131,576,555,20,22,teilweise bewölkt
7/6/2016 16:00,1393,651,742,19,22,teilweise bewölkt
7/6/2016 17:00,1420,711,709,19,20,teilweise bewölkt
7/6/2016 18:00,1295,645,650,19,19,teilweise bewölkt
7/6/2016 19:00,1109,551,558,19,17,teilweise bewölkt
7/6/2016 20:00,902,443,459,17,13,teilweise bewölkt
7/6/2016 21:00,562,248,314,15,9,wolkig
7/6/2016 22:00,423,166,257,14,9,Klarer Himmel
7/6/2016 23:00,449,122,327,13,9,Klarer Himmel
7/7/2016 0:00,215,76,139,13,6,Klarer Himmel
7/7/2016 1:00,131,34,97,11,6,Klarer Himmel
7/7/2016 2:00,70,14,56,10,2,Klarer Himmel
7/7/2016 3:00,52,4,48,9,2,Klarer Himmel
7/7/2016 4:00,32,11,21,9,4,Nebel
7/7/2016 5:00,73,38,35,8,0,Nebel
7/7/2016 6:00,165,124,41,10,6,Klarer Himmel
7/7/2016 7:00,658,428,230,13,6,Klarer Himmel
7/7/2016 8:00,1188,698,490,15,7,Klarer Himmel
7/7/2016 9:00,984,565,419,16,7,teilweise bewölkt
7/7/2016 10:00,958,560,398,17,9,teilweise bewölkt
7/7/2016 11:00,856,493,363,18,11,teilweise bewölkt
7/7/2016 12:00,1149,556,593,19,11,wolkig
7/7/2016 13:00,1191,597,594,20,13,Klarer Himmel
7/7/2016 14:00,1226,611,615,21,9,Klarer Himmel
7/7/2016 15:00,1270,642,628,22,15,Klarer Himmel
7/7/2016 16:00,1291,660,631,22,15,Klarer Himmel
7/7/2016 17:00,1394,685,709,22,17,Klarer Himmel
7/7/2016 18:00,1458,720,738,22,15,Klarer Himmel
7/7/2016 19:00,1702,1116,586,22,11,Klarer Himmel
7/7/2016 20:00,1641,997,644,20,6,Klarer Himmel
7/7/2016 21:00,320,145,175,17,2,Klarer Himmel
7/7/2016 22:00,250,92,158,16,4,Klarer Himmel
7/7/2016 23:00,2142,500,1642,15,4,Klarer Himmel
7/8/2016 0:00,392,122,270,15,4,Klarer Himmel
7/8/2016 1:00,170,42,128,15,7,Klarer Himmel
7/8/2016 2:00,99,23,76,15,4,Klarer Himmel
7/8/2016 3:00,56,17,39,15,6,Klarer Himmel
7/8/2016 4:00,47,16,31,15,2,Klarer Himmel
7/8/2016 5:00,55,26,29,15,2,Klarer Himmel
7/8/2016 6:00,145,108,37,16,6,Klarer Himmel
7/8/2016 7:00,647,441,206,17,4,Klarer Himmel
7/8/2016 8:00,1027,645,382,18,6,Klarer Himmel
7/8/2016 9:00,819,473,346,19,7,Klarer Himmel
7/8/2016 10:00,900,492,408,21,11,Klarer Himmel
7/8/2016 11:00,826,481,345,22,17,Klarer Himmel
7/8/2016 12:00,927,474,453,22,24,wolkig
7/8/2016 13:00,938,498,440,20,20,wolkig
7/8/2016 14:00,962,456,506,21,33,wolkig
7/8/2016 15:00,896,459,437,20,26,Regen
7/8/2016 16:00,900,416,484,20,22,wolkig
7/8/2016 17:00,993,472,521,21,30,wolkig
7/8/2016 18:00,996,492,504,20,24,wolkig
7/8/2016 19:00,821,447,374,19,24,teilweise bewölkt
7/8/2016 20:00,709,373,336,19,17,teilweise bewölkt
7/8/2016 21:00,543,246,297,18,15,teilweise bewölkt
7/8/2016 22:00,388,144,244,16,20,Regen
7/8/2016 23:00,428,112,316,16,9,teilweise bewölkt
7/9/2016 0:00,362,103,259,15,7,wolkig
7/9/2016 1:00,243,86,157,15,9,Klarer Himmel
7/9/2016 2:00,170,53,117,15,7,wolkig
7/9/2016 3:00,90,18,72,14,6,teilweise bewölkt
7/9/2016 4:00,61,11,50,15,7,wolkig
7/9/2016 5:00,77,32,45,14,6,Nebel
7/9/2016 6:00,68,37,31,15,9,
7/9/2016 7:00,108,86,22,17,13,teilweise bewölkt
7/9/2016 8:00,199,122,77,17,13,teilweise bewölkt
7/9/2016 9:00,484,361,123,19,15,wolkig
7/9/2016 10:00,626,440,186,20,20,wolkig
7/9/2016 11:00,628,426,202,20,17,wolkig
7/9/2016 12:00,695,421,274,21,15,wolkig
7/9/2016 13:00,743,381,362,21,17,teilweise bewölkt
7/9/2016 14:00,760,347,413,23,19,teilweise bewölkt
7/9/2016 15:00,698,308,390,23,17,teilweise bewölkt
7/9/2016 16:00,765,396,369,23,20,wolkig
7/9/2016 17:00,876,433,443,22,20,Regen
7/9/2016 18:00,867,411,456,22,11,wolkig
7/9/2016 19:00,742,436,306,22,9,Klarer Himmel
7/9/2016 20:00,717,376,341,22,7,wolkig
7/9/2016 21:00,471,267,204,20,7,Klarer Himmel
7/9/2016 22:00,431,153,278,20,9,Klarer Himmel
7/9/2016 23:00,422,148,274,20,11,wolkig
7/10/2016 0:00,535,112,423,20,7,wolkig
7/10/2016 1:00,340,100,240,18,6,Klarer Himmel
7/10/2016 2:00,211,51,160,18,9,Klarer Himmel
7/10/2016 3:00,179,62,117,19,11,Klarer Himmel
7/10/2016 4:00,100,24,76,17,9,Klarer Himmel
7/10/2016 5:00,52,24,28,17,4,Klarer Himmel
7/10/2016 6:00,58,27,31,18,7,Klarer Himmel
7/10/2016 7:00,56,35,21,19,9,Klarer Himmel
7/10/2016 8:00,66,33,33,22,11,Klarer Himmel
7/10/2016 9:00,319,229,90,24,15,Klarer Himmel
7/10/2016 10:00,479,334,145,25,17,Klarer Himmel
7/10/2016 11:00,510,323,187,26,19,teilweise bewölkt
7/10/2016 12:00,530,317,213,27,20,wolkig
7/10/2016 13:00,548,268,280,28,22,teilweise bewölkt
7/10/2016 14:00,635,343,292,28,24,Klarer Himmel
7/10/2016 15:00,637,354,283,29,20,Klarer Himmel
7/10/2016 16:00,682,345,337,29,17,Klarer Himmel
7/10/2016 17:00,643,333,310,29,20,Klarer Himmel
7/10/2016 18:00,644,333,311,29,13,Klarer Himmel
7/10/2016 19:00,605,268,337,28,7,Klarer Himmel
7/10/2016 20:00,725,326,399,26,7,Klarer Himmel
7/10/2016 21:00,372,136,236,25,6,Klarer Himmel
7/10/2016 22:00,241,80,161,24,15,Klarer Himmel
7/10/2016 23:00,319,116,203,21,15,Klarer Himmel
7/11/2016 0:00,272,78,194,20,7,Klarer Himmel
7/11/2016 1:00,55,19,36,20,6,Klarer Himmel
7/11/2016 2:00,20,6,14,20,15,Klarer Himmel
7/11/2016 3:00,11,6,5,19,15,Klarer Himmel
7/11/2016 4:00,18,10,8,19,13,Klarer Himmel
7/11/2016 5:00,56,40,16,19,13,
7/11/2016 6:00,162,118,44,19,15,wolkig
7/11/2016 7:00,489,322,167,19,19,wolkig
7/11/2016 8:00,976,600,376,19,26,wolkig
7/11/2016 9:00,803,472,331,19,22,wolkig
7/11/2016 10:00,887,461,426,20,24,wolkig
7/11/2016 11:00,754,436,318,21,28,wolkig
7/11/2016 12:00,893,460,433,22,28,teilweise bewölkt
7/11/2016 13:00,897,492,405,22,30,wolkig
7/11/2016 14:00,982,491,491,22,28,wolkig
7/11/2016 15:00,1015,527,488,23,32,wolkig
7/11/2016 16:00,1178,580,598,23,28,teilweise bewölkt
7/11/2016 17:00,1328,657,671,23,26,teilweise bewölkt
7/11/2016 18:00,1207,569,638,23,28,Klarer Himmel
7/11/2016 19:00,983,439,544,22,24,Klarer Himmel
7/11/2016 20:00,705,290,415,22,20,Klarer Himmel
7/11/2016 21:00,519,234,285,21,17,wolkig
7/11/2016 22:00,410,152,258,19,11,teilweise bewölkt
7/11/2016 23:00,281,80,201,19,13,teilweise bewölkt
7/12/2016 0:00,139,45,94,18,11,Klarer Himmel
7/12/2016 1:00,68,29,39,17,11,Klarer Himmel
7/12/2016 2:00,32,14,18,16,11,Klarer Himmel
7/12/2016 3:00,16,3,13,16,11,Klarer Himmel
7/12/2016 4:00,14,8,6,16,9,Klarer Himmel
7/12/2016 5:00,59,42,17,15,11,Klarer Himmel
7/12/2016 6:00,188,136,52,15,15,teilweise bewölkt
7/12/2016 7:00,576,371,205,16,19,teilweise bewölkt
7/12/2016 8:00,1124,689,435,17,19,teilweise bewölkt
7/12/2016 9:00,979,580,399,19,19,teilweise bewölkt
7/12/2016 10:00,1077,575,502,19,20,wolkig
7/12/2016 11:00,934,514,420,19,22,wolkig
7/12/2016 12:00,1063,532,531,21,17,wolkig
7/12/2016 13:00,1062,573,489,22,19,wolkig
7/12/2016 14:00,1091,551,540,21,15,teilweise bewölkt
7/12/2016 15:00,1075,564,511,23,22,teilweise bewölkt
7/12/2016 16:00,1337,647,690,21,19,teilweise bewölkt
7/12/2016 17:00,1353,684,669,20,7,wolkig
7/12/2016 18:00,1398,648,750,20,6,wolkig
7/12/2016 19:00,996,461,535,17,4,wolkig
7/12/2016 20:00,769,349,420,16,0,teilweise bewölkt
7/12/2016 21:00,452,178,274,17,7,Regen
7/12/2016 22:00,492,157,335,16,4,wolkig
7/12/2016 23:00,251,63,188,16,6,wolkig
7/13/2016 0:00,138,25,113,15,4,Klarer Himmel
7/13/2016 1:00,89,25,64,14,0,Nebel
7/13/2016 2:00,34,10,24,13,0,Nebel
7/13/2016 3:00,27,8,19,13,6,
7/13/2016 4:00,14,8,6,12,2,Nebel
7/13/2016 5:00,64,51,13,12,2,Nebel
7/13/2016 6:00,172,133,39,13,0,wolkig
7/13/2016 7:00,572,353,219,14,4,teilweise bewölkt
7/13/2016 8:00,1161,793,368,15,2,wolkig
7/13/2016 9:00,979,584,395,17,6,teilweise bewölkt
7/13/2016 10:00,1078,586,492,18,9,wolkig
7/13/2016 11:00,873,518,355,19,15,wolkig
7/13/2016 12:00,1046,522,524,19,9,wolkig
7/13/2016 13:00,988,521,467,20,15,teilweise bewölkt
7/13/2016 14:00,1004,454,550,21,13,
7/13/2016 15:00,1023,532,491,21,19,wolkig
7/13/2016 16:00,1196,576,620,17,19,wolkig
7/13/2016 17:00,1396,680,716,15,11,Regen
7/13/2016 18:00,1081,500,581,15,6,wolkig
7/13/2016 19:00,1010,482,528,15,7,wolkig
7/13/2016 20:00,703,335,368,15,9,wolkig
7/13/2016 21:00,447,196,251,15,9,wolkig
7/13/2016 22:00,435,165,270,14,11,wolkig
7/13/2016 23:00,299,122,177,13,6,wolkig
7/14/2016 0:00,201,68,133,13,6,Klarer Himmel
7/14/2016 1:00,127,31,96,12,9,wolkig
7/14/2016 2:00,123,18,105,11,7,Klarer Himmel
7/14/2016 3:00,69,17,52,10,7,Klarer Himmel
7/14/2016 4:00,59,29,30,10,4,Nebel
7/14/2016 5:00,77,42,35,10,6,Nebel
7/14/2016 6:00,166,109,57,11,4,teilweise bewölkt
7/14/2016 7:00,514,319,195,12,7,teilweise bewölkt
7/14/2016 8:00,1056,657,399,14,13,teilweise bewölkt
7/14/2016 9:00,879,527,352,16,13,
7/14/2016 10:00,894,555,339,16,11,teilweise bewölkt
7/14/2016 11:00,788,409,379,16,13,teilweise bewölkt
7/14/2016 12:00,953,478,475,18,19,teilweise bewölkt
7/14/2016 13:00,930,494,436,17,15,teilweise bewölkt
7/14/2016 14:00,1049,523,526,16,2,wolkig
7/14/2016 15:00,1030,497,533,16,15,teilweise bewölkt
7/14/2016 16:00,1226,612,614,15,15,teilweise bewölkt
7/14/2016 17:00,1182,582,600,17,19,wolkig
7/14/2016 18:00,1179,523,656,16,19,wolkig
7/14/2016 19:00,941,444,497,14,20,wolkig
7/14/2016 20:00,605,257,348,13,19,wolkig
7/14/2016 21:00,417,183,234,14,15,wolkig
7/14/2016 22:00,410,149,261,13,11,teilweise bewölkt
7/14/2016 23:00,285,73,212,12,11,Klarer Himmel
7/15/2016 0:00,195,57,138,11,9,Klarer Himmel
7/15/2016 1:00,95,28,67,12,11,Klarer Himmel
7/15/2016 2:00,48,14,34,12,13,wolkig
7/15/2016 3:00,32,7,25,12,11,Klarer Himmel
7/15/2016 4:00,19,10,9,12,13,wolkig
7/15/2016 5:00,36,26,10,12,9,wolkig
7/15/2016 6:00,137,102,35,13,13,wolkig
7/15/2016 7:00,469,310,159,13,17,wolkig
7/15/2016 8:00,889,559,330,15,17,wolkig
7/15/2016 9:00,710,433,277,15,17,teilweise bewölkt
7/15/2016 10:00,772,414,358,15,19,teilweise bewölkt
7/15/2016 11:00,763,450,313,16,19,
7/15/2016 12:00,859,447,412,18,19,wolkig
7/15/2016 13:00,946,485,461,19,19,wolkig
7/15/2016 14:00,883,445,438,19,17,teilweise bewölkt
7/15/2016 15:00,903,463,440,19,15,wolkig
7/15/2016 16:00,817,398,419,19,6,wolkig
7/15/2016 17:00,1067,644,423,20,20,wolkig
7/15/2016 18:00,1302,823,479,19,11,wolkig
7/15/2016 19:00,1214,817,397,19,7,wolkig
7/15/2016 20:00,1205,823,382,18,7,teilweise bewölkt
7/15/2016 21:00,876,503,373,16,6,teilweise bewölkt
7/15/2016 22:00,933,543,390,13,0,Nebel
7/15/2016 23:00,667,357,310,12,2,Nebel
7/16/2016 0:00,654,338,316,11,4,Nebel
7/16/2016 1:00,423,231,192,11,0,Nebel
7/16/2016 2:00,207,70,137,12,6,Nebel
7/16/2016 3:00,151,54,97,13,7,Klarer Himmel
7/16/2016 4:00,120,25,95,14,7,Klarer Himmel
7/16/2016 5:00,91,35,56,15,6,Regen
7/16/2016 6:00,71,40,31,15,9,wolkig
7/16/2016 7:00,121,94,27,16,9,wolkig
7/16/2016 8:00,218,158,60,16,11,wolkig
7/16/2016 9:00,424,334,90,17,11,wolkig
7/16/2016 10:00,628,486,142,18,17,wolkig
7/16/2016 11:00,665,440,225,18,15,wolkig
7/16/2016 12:00,735,468,267,19,15,wolkig
7/16/2016 13:00,819,502,317,20,13,wolkig
7/16/2016 14:00,1023,608,415,21,15,wolkig
7/16/2016 15:00,807,482,325,21,17,wolkig
7/16/2016 16:00,597,250,347,21,20,wolkig
7/16/2016 17:00,628,295,333,21,15,wolkig
7/16/2016 18:00,588,218,370,21,13,wolkig
7/16/2016 19:00,666,346,320,22,15,wolkig
7/16/2016 20:00,570,270,300,21,13,wolkig
7/16/2016 21:00,350,190,160,20,6,wolkig
7/16/2016 22:00,363,167,196,19,4,teilweise bewölkt
7/16/2016 23:00,319,99,220,19,4,wolkig
7/17/2016 0:00,275,101,174,19,7,Klarer Himmel
7/17/2016 1:00,203,98,105,19,7,wolkig
7/17/2016 2:00,159,48,111,19,7,wolkig
7/17/2016 3:00,106,29,77,19,9,wolkig
7/17/2016 4:00,72,13,59,19,9,wolkig
7/17/2016 5:00,35,11,24,19,9,wolkig
7/17/2016 6:00,39,22,17,19,11,teilweise bewölkt
7/17/2016 7:00,46,26,20,19,15,wolkig
7/17/2016 8:00,76,39,37,19,13,wolkig
7/17/2016 9:00,323,268,55,20,17,wolkig
7/17/2016 10:00,386,251,135,21,19,wolkig
7/17/2016 11:00,331,180,151,22,19,wolkig
7/17/2016 12:00,376,211,165,22,24,wolkig
7/17/2016 13:00,504,238,266,24,24,wolkig
7/17/2016 14:00,524,286,238,24,20,teilweise bewölkt
7/17/2016 15:00,552,304,248,25,28,wolkig
7/17/2016 16:00,544,256,288,24,20,wolkig
7/17/2016 17:00,614,304,310,24,22,Klarer Himmel
7/17/2016 18:00,600,287,313,23,20,wolkig
7/17/2016 19:00,566,269,297,22,15,Klarer Himmel
7/17/2016 20:00,490,215,275,21,9,Klarer Himmel
7/17/2016 21:00,346,134,212,19,7,Klarer Himmel
7/17/2016 22:00,275,91,184,17,6,Klarer Himmel
7/17/2016 23:00,192,72,120,16,6,Klarer Himmel
7/18/2016 0:00,83,30,53,15,6,Klarer Himmel
7/18/2016 1:00,48,11,37,14,7,Klarer Himmel
7/18/2016 2:00,26,9,17,16,6,Klarer Himmel
7/18/2016 3:00,11,7,4,13,2,wolkig
7/18/2016 4:00,12,5,7,12,0,Nebel
7/18/2016 5:00,56,41,15,13,4,Nebel
7/18/2016 6:00,167,115,52,15,4,wolkig
7/18/2016 7:00,505,332,173,16,6,Regen
7/18/2016 8:00,812,516,296,18,7,teilweise bewölkt
7/18/2016 9:00,728,436,292,20,7,teilweise bewölkt
7/18/2016 10:00,710,386,324,22,17,teilweise bewölkt
7/18/2016 11:00,691,386,305,23,15,teilweise bewölkt
7/18/2016 12:00,831,448,383,25,22,teilweise bewölkt
7/18/2016 13:00,873,479,394,25,17,teilweise bewölkt
7/18/2016 14:00,846,421,425,26,17,teilweise bewölkt
7/18/2016 15:00,1045,534,511,27,19,Klarer Himmel
7/18/2016 16:00,1058,550,508,27,15,Klarer Himmel
7/18/2016 17:00,1208,635,573,26,15,Klarer Himmel
7/18/2016 18:00,1122,563,559,26,17,Klarer Himmel
7/18/2016 19:00,851,390,461,25,9,Klarer Himmel
7/18/2016 20:00,610,288,322,24,7,Klarer Himmel
7/18/2016 21:00,616,202,414,20,2,Klarer Himmel
7/18/2016 22:00,397,127,270,17,0,Klarer Himmel
7/18/2016 23:00,253,79,174,16,0,Klarer Himmel
7/19/2016 0:00,140,45,95,15,0,Klarer Himmel
7/19/2016 1:00,71,19,52,14,0,Klarer Himmel
7/19/2016 2:00,24,13,11,13,2,Klarer Himmel
7/19/2016 3:00,16,8,8,13,2,Klarer Himmel
7/19/2016 4:00,19,14,5,12,0,Nebel
7/19/2016 5:00,61,43,18,12,4,Nebel
7/19/2016 6:00,176,133,43,13,0,Klarer Himmel
7/19/2016 7:00,675,488,187,18,2,Klarer Himmel
7/19/2016 8:00,977,608,369,20,6,Klarer Himmel
7/19/2016 9:00,1033,562,471,23,4,Klarer Himmel
7/19/2016 10:00,773,413,360,24,6,Klarer Himmel
7/19/2016 11:00,794,445,349,25,6,Klarer Himmel
7/19/2016 12:00,879,475,404,27,4,Klarer Himmel
7/19/2016 13:00,899,464,435,28,4,Klarer Himmel
7/19/2016 14:00,972,468,504,28,6,Klarer Himmel
7/19/2016 15:00,992,547,445,29,6,Klarer Himmel
7/19/2016 16:00,1167,630,537,30,6,Klarer Himmel
7/19/2016 17:00,1335,697,638,29,4,Klarer Himmel
7/19/2016 18:00,1227,638,589,30,2,Klarer Himmel
7/19/2016 19:00,982,527,455,29,7,Klarer Himmel
7/19/2016 20:00,780,390,390,26,7,Klarer Himmel
7/19/2016 21:00,606,267,339,24,6,Klarer Himmel
7/19/2016 22:00,536,196,340,23,6,Klarer Himmel
7/19/2016 23:00,421,97,324,21,6,Klarer Himmel
7/20/2016 0:00,268,61,207,20,6,Klarer Himmel
7/20/2016 1:00,154,35,119,21,7,Klarer Himmel
7/20/2016 2:00,55,17,38,20,6,Klarer Himmel
7/20/2016 3:00,27,8,19,20,7,Klarer Himmel
7/20/2016 4:00,22,11,11,20,7,Klarer Himmel
7/20/2016 5:00,70,40,30,20,9,Klarer Himmel
7/20/2016 6:00,175,121,54,21,9,Klarer Himmel
7/20/2016 7:00,559,379,180,22,9,Klarer Himmel
7/20/2016 8:00,1013,646,367,24,7,Klarer Himmel
7/20/2016 9:00,916,559,357,25,11,Klarer Himmel
7/20/2016 10:00,882,502,380,28,13,Klarer Himmel
7/20/2016 11:00,881,439,442,29,13,Klarer Himmel
7/20/2016 12:00,902,467,435,31,13,Klarer Himmel
7/20/2016 13:00,948,498,450,32,19,Klarer Himmel
7/20/2016 14:00,874,428,446,33,17,Klarer Himmel
7/20/2016 15:00,989,525,464,34,15,Klarer Himmel
7/20/2016 16:00,1112,652,460,34,17,Klarer Himmel
7/20/2016 17:00,1085,625,460,33,11,Klarer Himmel
7/20/2016 18:00,1126,613,513,31,6,Klarer Himmel
7/20/2016 19:00,1026,519,507,30,4,wolkig
7/20/2016 20:00,606,205,401,23,22,Gewitter
7/20/2016 21:00,564,243,321,21,7,wolkig
7/20/2016 22:00,395,138,257,21,6,Klarer Himmel
7/20/2016 23:00,291,122,169,20,4,Klarer Himmel
7/21/2016 0:00,313,124,189,20,4,wolkig
7/21/2016 1:00,170,39,131,20,2,Klarer Himmel
7/21/2016 2:00,149,30,119,19,0,Nebel
7/21/2016 3:00,130,26,104,18,0,Nebel
7/21/2016 4:00,80,29,51,18,0,Nebel
7/21/2016 5:00,91,45,46,17,4,Nebel
7/21/2016 6:00,166,113,53,18,4,Nebel
7/21/2016 7:00,513,340,173,20,6,
7/21/2016 8:00,843,520,323,22,9,
7/21/2016 9:00,836,536,300,23,7,Klarer Himmel
7/21/2016 10:00,710,420,290,25,7,Klarer Himmel
7/21/2016 11:00,761,409,352,25,11,teilweise bewölkt
7/21/2016 12:00,855,439,416,26,9,teilweise bewölkt
7/21/2016 13:00,900,415,485,27,7,teilweise bewölkt
7/21/2016 14:00,952,467,485,29,7,teilweise bewölkt
7/21/2016 15:00,918,506,412,29,6,teilweise bewölkt
7/21/2016 16:00,974,427,547,30,4,teilweise bewölkt
7/21/2016 17:00,1033,497,536,28,2,wolkig
7/21/2016 18:00,1089,485,604,18,24,Gewitter
7/21/2016 19:00,659,309,350,21,4,Regen
7/21/2016 20:00,660,346,314,21,4,Nebel
7/21/2016 21:00,412,201,211,20,0,Nebel
7/21/2016 22:00,348,134,214,19,2,Nebel
7/21/2016 23:00,290,100,190,19,6,teilweise bewölkt
7/22/2016 0:00,233,57,176,18,2,Klarer Himmel
7/22/2016 1:00,116,38,78,18,2,
7/22/2016 2:00,55,13,42,18,2,
7/22/2016 3:00,22,3,19,19,2,
7/22/2016 4:00,41,17,24,18,0,Nebel
7/22/2016 5:00,61,33,28,18,0,Nebel
7/22/2016 6:00,155,113,42,19,0,Nebel
7/22/2016 7:00,474,306,168,20,6,Nebel
7/22/2016 8:00,699,441,258,20,7,wolkig
7/22/2016 9:00,695,440,255,21,13,Regen
7/22/2016 10:00,573,332,241,21,19,Regen
7/22/2016 11:00,663,373,290,22,13,wolkig
7/22/2016 12:00,640,314,326,18,15,Gewitter
7/22/2016 13:00,703,347,356,21,19,wolkig
7/22/2016 14:00,711,374,337,23,13,Klarer Himmel
7/22/2016 15:00,750,427,323,24,7,wolkig
7/22/2016 16:00,777,360,417,24,6,wolkig
7/22/2016 17:00,707,362,345,25,7,Klarer Himmel
7/22/2016 18:00,779,378,401,25,7,Klarer Himmel
7/22/2016 19:00,755,402,353,25,7,Klarer Himmel
7/22/2016 20:00,647,340,307,23,9,Klarer Himmel
7/22/2016 21:00,443,227,216,21,11,Klarer Himmel
7/22/2016 22:00,387,164,223,20,4,Klarer Himmel
7/22/2016 23:00,352,126,226,20,13,Klarer Himmel
7/23/2016 0:00,374,134,240,19,7,Klarer Himmel
7/23/2016 1:00,220,86,134,19,7,Klarer Himmel
7/23/2016 2:00,138,24,114,19,6,Klarer Himmel
7/23/2016 3:00,143,27,116,18,4,
7/23/2016 4:00,83,18,65,18,6,
7/23/2016 5:00,71,28,43,18,7,Nebel
7/23/2016 6:00,66,29,37,18,2,Nebel
7/23/2016 7:00,103,78,25,19,7,Nebel
7/23/2016 8:00,273,208,65,19,11,wolkig
7/23/2016 9:00,440,317,123,20,15,wolkig
7/23/2016 10:00,570,388,182,21,11,wolkig
7/23/2016 11:00,594,379,215,21,13,wolkig
7/23/2016 12:00,604,384,220,22,9,wolkig
7/23/2016 13:00,623,302,321,22,9,wolkig
7/23/2016 14:00,587,292,295,24,6,wolkig
7/23/2016 15:00,551,256,295,24,7,wolkig
7/23/2016 16:00,557,258,299,24,4,wolkig
7/23/2016 17:00,503,251,252,25,4,teilweise bewölkt
7/23/2016 18:00,598,250,348,25,4,wolkig
7/23/2016 19:00,641,318,323,24,6,wolkig
7/23/2016 20:00,547,269,278,22,4,Klarer Himmel
7/23/2016 21:00,370,188,182,20,0,Klarer Himmel
7/23/2016 22:00,369,180,189,19,2,Klarer Himmel
7/23/2016 23:00,317,123,194,18,0,Klarer Himmel
7/24/2016 0:00,313,92,221,17,0,Klarer Himmel
7/24/2016 1:00,206,63,143,16,0,Nebel
7/24/2016 2:00,123,30,93,16,0,Nebel
7/24/2016 3:00,104,32,72,15,0,Nebel
7/24/2016 4:00,82,16,66,15,0,Nebel
7/24/2016 5:00,56,8,48,15,0,Nebel
7/24/2016 6:00,52,14,38,16,0,Nebel
7/24/2016 7:00,48,30,18,18,0,
7/24/2016 8:00,97,65,32,19,6,Klarer Himmel
7/24/2016 9:00,272,217,55,22,4,Klarer Himmel
7/24/2016 10:00,353,250,103,23,7,teilweise bewölkt
7/24/2016 11:00,398,214,184,25,7,teilweise bewölkt
7/24/2016 12:00,428,234,194,26,7,teilweise bewölkt
7/24/2016 13:00,485,276,209,26,7,teilweise bewölkt
7/24/2016 14:00,531,311,220,27,6,teilweise bewölkt
7/24/2016 15:00,513,285,228,27,7,teilweise bewölkt
7/24/2016 16:00,564,289,275,27,11,teilweise bewölkt
7/24/2016 17:00,520,272,248,26,7,wolkig
7/24/2016 18:00,543,267,276,27,7,wolkig
7/24/2016 19:00,512,231,281,26,6,Klarer Himmel
7/24/2016 20:00,473,176,297,25,4,Klarer Himmel
7/24/2016 21:00,387,137,250,22,0,Klarer Himmel
7/24/2016 22:00,275,90,185,21,0,Klarer Himmel
7/24/2016 23:00,218,73,145,22,4,Klarer Himmel
7/25/2016 0:00,150,38,112,22,6,Klarer Himmel
7/25/2016 1:00,46,17,29,21,2,Klarer Himmel
7/25/2016 2:00,16,8,8,20,0,Klarer Himmel
7/25/2016 3:00,19,8,11,20,4,Klarer Himmel
7/25/2016 4:00,17,11,6,20,0,wolkig
7/25/2016 5:00,69,46,23,19,4,wolkig
7/25/2016 6:00,146,106,40,20,9,wolkig
7/25/2016 7:00,515,363,152,20,6,wolkig
7/25/2016 8:00,729,456,273,21,4,wolkig
7/25/2016 9:00,632,352,280,23,11,wolkig
7/25/2016 10:00,619,340,279,24,15,wolkig
7/25/2016 11:00,647,378,269,25,19,wolkig
7/25/2016 12:00,702,400,302,25,17,wolkig
7/25/2016 13:00,703,392,311,26,19,teilweise bewölkt
7/25/2016 14:00,724,411,313,25,13,wolkig
7/25/2016 15:00,717,364,353,24,17,wolkig
7/25/2016 16:00,928,408,520,24,17,wolkig
7/25/2016 17:00,1013,472,541,25,17,wolkig
7/25/2016 18:00,924,420,504,25,17,teilweise bewölkt
7/25/2016 19:00,807,405,402,23,13,teilweise bewölkt
7/25/2016 20:00,664,333,331,22,7,teilweise bewölkt
7/25/2016 21:00,441,209,232,21,13,teilweise bewölkt
7/25/2016 22:00,336,119,217,19,13,wolkig
7/25/2016 23:00,248,67,181,18,6,Klarer Himmel
7/26/2016 0:00,307,79,228,17,0,Klarer Himmel
7/26/2016 1:00,95,25,70,18,4,wolkig
7/26/2016 2:00,26,10,16,18,7,wolkig
7/26/2016 3:00,36,15,21,16,4,teilweise bewölkt
7/26/2016 4:00,12,6,6,16,4,teilweise bewölkt
7/26/2016 5:00,65,42,23,15,0,Nebel
7/26/2016 6:00,179,132,47,15,2,Nebel
7/26/2016 7:00,599,410,189,16,0,Klarer Himmel
7/26/2016 8:00,765,464,301,18,4,wolkig
7/26/2016 9:00,698,438,260,19,4,wolkig
7/26/2016 10:00,607,385,222,20,6,wolkig
7/26/2016 11:00,667,376,291,22,6,wolkig
7/26/2016 12:00,769,391,378,23,7,wolkig
7/26/2016 13:00,758,390,368,23,9,wolkig
7/26/2016 14:00,895,496,399,24,9,wolkig
7/26/2016 15:00,804,432,372,24,7,Klarer Himmel
7/26/2016 16:00,996,511,485,24,4,Klarer Himmel
7/26/2016 17:00,1174,491,683,24,6,Klarer Himmel
7/26/2016 18:00,1019,419,600,24,4,Klarer Himmel
7/26/2016 19:00,871,399,472,23,7,Klarer Himmel
7/26/2016 20:00,620,273,347,22,4,Klarer Himmel
7/26/2016 21:00,429,198,231,20,2,Klarer Himmel
7/26/2016 22:00,401,139,262,20,4,Klarer Himmel
7/26/2016 23:00,246,73,173,19,9,Klarer Himmel
7/27/2016 0:00,303,108,195,18,4,Klarer Himmel
7/27/2016 1:00,127,39,88,18,4,Klarer Himmel
7/27/2016 2:00,49,11,38,18,6,Klarer Himmel
7/27/2016 3:00,53,15,38,17,0,Klarer Himmel
7/27/2016 4:00,40,15,25,17,6,Klarer Himmel
7/27/2016 5:00,78,46,32,17,6,Klarer Himmel
7/27/2016 6:00,154,126,28,17,7,Klarer Himmel
7/27/2016 7:00,522,353,169,17,6,Klarer Himmel
7/27/2016 8:00,770,509,261,19,7,Klarer Himmel
7/27/2016 9:00,703,422,281,20,11,wolkig
7/27/2016 10:00,693,422,271,22,13,wolkig
7/27/2016 11:00,756,435,321,22,19,wolkig
7/27/2016 12:00,815,441,374,22,22,teilweise bewölkt
7/27/2016 13:00,774,387,387,22,22,wolkig
7/27/2016 14:00,768,394,374,23,24,wolkig
7/27/2016 15:00,774,349,425,23,24,wolkig
7/27/2016 16:00,885,422,463,23,24,wolkig
7/27/2016 17:00,938,467,471,23,26,wolkig
7/27/2016 18:00,1013,486,527,22,22,wolkig
7/27/2016 19:00,814,399,415,21,13,Klarer Himmel
7/27/2016 20:00,631,284,347,21,11,wolkig
7/27/2016 21:00,470,216,254,20,17,Regen
7/27/2016 22:00,373,161,212,18,15,Regen
7/27/2016 23:00,294,114,180,17,9,wolkig
7/28/2016 0:00,300,84,216,18,11,wolkig
7/28/2016 1:00,117,39,78,18,11,wolkig
7/28/2016 2:00,83,13,70,18,15,wolkig
7/28/2016 3:00,80,11,69,16,7,Klarer Himmel
7/28/2016 4:00,55,16,39,17,4,Klarer Himmel
7/28/2016 5:00,86,43,43,15,0,Nebel
7/28/2016 6:00,145,116,29,16,2,wolkig
7/28/2016 7:00,426,274,152,17,4,wolkig
7/28/2016 8:00,480,284,196,18,4,wolkig
7/28/2016 9:00,498,299,199,17,7,Regen
7/28/2016 10:00,464,286,178,17,6,wolkig
7/28/2016 11:00,441,269,172,18,4,Regen
7/28/2016 12:00,563,316,247,19,6,Regen
7/28/2016 13:00,556,269,287,20,11,Regen
7/28/2016 14:00,520,260,260,19,17,Regen
7/28/2016 15:00,639,323,316,20,17,wolkig
7/28/2016 16:00,768,384,384,21,13,teilweise bewölkt
7/28/2016 17:00,777,354,423,22,11,wolkig
7/28/2016 18:00,779,338,441,22,6,wolkig
7/28/2016 19:00,635,311,324,22,6,wolkig
7/28/2016 20:00,528,251,277,20,11,wolkig
7/28/2016 21:00,356,152,204,19,0,wolkig
7/28/2016 22:00,292,95,197,19,11,wolkig
7/28/2016 23:00,310,105,205,18,0,wolkig
7/29/2016 0:00,230,76,154,19,4,wolkig
7/29/2016 1:00,97,34,63,18,4,wolkig
7/29/2016 2:00,62,18,44,18,7,Klarer Himmel
7/29/2016 3:00,34,3,31,17,13,wolkig
7/29/2016 4:00,30,15,15,17,6,wolkig
7/29/2016 5:00,64,35,29,17,7,wolkig
7/29/2016 6:00,148,108,40,17,7,Regen
7/29/2016 7:00,340,203,137,17,13,wolkig
7/29/2016 8:00,561,352,209,17,13,wolkig
7/29/2016 9:00,516,314,202,17,9,wolkig
7/29/2016 10:00,461,286,175,19,15,wolkig
7/29/2016 11:00,554,333,221,20,17,wolkig
7/29/2016 12:00,617,346,271,21,17,wolkig
7/29/2016 13:00,546,239,307,17,11,Regen
7/29/2016 14:00,611,353,258,21,9,wolkig
7/29/2016 15:00,667,369,298,22,13,teilweise bewölkt
7/29/2016 16:00,664,358,306,23,26,wolkig
7/29/2016 17:00,700,328,372,23,24,teilweise bewölkt
7/29/2016 18:00,602,255,347,23,22,teilweise bewölkt
7/29/2016 19:00,669,352,317,22,24,teilweise bewölkt
7/29/2016 20:00,517,276,241,21,13,wolkig
7/29/2016 21:00,374,192,182,19,17,wolkig
7/29/2016 22:00,300,114,186,19,13,Klarer Himmel
7/29/2016 23:00,265,94,171,18,9,Klarer Himmel
7/30/2016 0:00,312,121,191,18,9,Klarer Himmel
7/30/2016 1:00,223,69,154,17,9,wolkig
7/30/2016 2:00,158,54,104,17,7,Klarer Himmel
7/30/2016 3:00,107,18,89,16,9,Klarer Himmel
7/30/2016 4:00,68,16,52,16,11,wolkig
7/30/2016 5:00,72,31,41,15,7,teilweise bewölkt
7/30/2016 6:00,56,31,25,16,11,Klarer Himmel
7/30/2016 7:00,85,57,28,16,13,Klarer Himmel
7/30/2016 8:00,225,169,56,17,17,teilweise bewölkt
7/30/2016 9:00,383,282,101,18,22,teilweise bewölkt
7/30/2016 10:00,466,333,133,19,19,teilweise bewölkt
7/30/2016 11:00,571,329,242,18,24,wolkig
7/30/2016 12:00,461,296,165,18,19,wolkig
7/30/2016 13:00,552,313,239,21,20,wolkig
7/30/2016 14:00,566,290,276,20,17,wolkig
7/30/2016 15:00,512,266,246,21,15,wolkig
7/30/2016 16:00,501,212,289,20,9,Regen
7/30/2016 17:00,447,200,247,18,11,Regen
7/30/2016 18:00,474,197,277,18,9,Regen
7/30/2016 19:00,445,205,240,17,4,wolkig
7/30/2016 20:00,367,178,189,17,0,wolkig
7/30/2016 21:00,255,146,109,17,4,wolkig
7/30/2016 22:00,264,125,139,17,6,wolkig
7/30/2016 23:00,223,102,121,17,7,wolkig
7/31/2016 0:00,239,81,158,16,0,wolkig
7/31/2016 1:00,214,99,115,16,4,Nebel
7/31/2016 2:00,114,37,77,15,2,Nebel
7/31/2016 3:00,121,20,101,15,0,Nebel
7/31/2016 4:00,81,11,70,15,2,wolkig
7/31/2016 5:00,52,19,33,15,6,Nebel
7/31/2016 6:00,47,17,30,16,4,Nebel
7/31/2016 7:00,38,23,15,16,9,Nebel
7/31/2016 8:00,63,37,26,17,11,wolkig
7/31/2016 9:00,176,126,50,17,11,wolkig
7/31/2016 10:00,255,179,76,18,17,wolkig
7/31/2016 11:00,285,169,116,19,15,wolkig
7/31/2016 12:00,372,253,119,19,11,Regen
7/31/2016 13:00,356,183,173,19,17,wolkig
7/31/2016 14:00,342,179,163,20,11,wolkig
7/31/2016 15:00,339,186,153,20,9,Regen
7/31/2016 16:00,458,206,252,20,13,wolkig
7/31/2016 17:00,381,186,195,18,19,wolkig
7/31/2016 18:00,388,166,222,19,15,wolkig
7/31/2016 19:00,380,164,216,19,19,teilweise bewölkt
7/31/2016 20:00,356,145,211,17,7,teilweise bewölkt
7/31/2016 21:00,257,94,163,16,13,teilweise bewölkt
7/31/2016 22:00,180,68,112,15,9,Klarer Himmel
7/31/2016 23:00,129,45,84,14,7,Klarer Himmel
8/1/2016 0:00,73,29,44,13,7,Klarer Himmel
8/1/2016 1:00,37,15,22,12,7,Klarer Himmel
8/1/2016 2:00,27,12,15,12,6,Klarer Himmel
8/1/2016 3:00,14,8,6,13,9,Klarer Himmel
8/1/2016 4:00,16,9,7,11,7,Klarer Himmel
8/1/2016 5:00,51,36,15,12,6,Nebel
8/1/2016 6:00,149,107,42,12,6,Klarer Himmel
8/1/2016 7:00,407,264,143,13,7,Klarer Himmel
8/1/2016 8:00,699,458,241,14,7,Klarer Himmel
8/1/2016 9:00,488,312,176,17,9,Regen
8/1/2016 10:00,427,245,182,14,9,Regen
8/1/2016 11:00,462,269,193,15,4,Regen
8/1/2016 12:00,490,276,214,17,9,wolkig
8/1/2016 13:00,537,300,237,19,15,teilweise bewölkt
8/1/2016 14:00,600,296,304,19,11,teilweise bewölkt
8/1/2016 15:00,544,229,315,15,17,Regen
8/1/2016 16:00,525,249,276,17,9,teilweise bewölkt
8/1/2016 17:00,872,382,490,19,11,teilweise bewölkt
8/1/2016 18:00,795,344,451,19,9,teilweise bewölkt
8/1/2016 19:00,591,296,295,19,9,teilweise bewölkt
8/1/2016 20:00,503,251,252,17,4,Nebel
8/1/2016 21:00,356,127,229,15,2,Nebel
8/1/2016 22:00,234,66,168,13,2,Nebel
8/1/2016 23:00,167,60,107,14,4,Nebel
8/2/2016 0:00,172,49,123,14,2,Nebel
8/2/2016 1:00,62,14,48,14,0,Regen
8/2/2016 2:00,28,5,23,14,7,Regen
8/2/2016 3:00,20,1,19,15,7,Regen
8/2/2016 4:00,11,8,3,15,9,Regen
8/2/2016 5:00,41,28,13,14,6,Regen
8/2/2016 6:00,99,74,25,14,7,Regen
8/2/2016 7:00,254,166,88,14,4,Regen
8/2/2016 8:00,500,332,168,14,6,Regen
8/2/2016 9:00,484,295,189,15,7,wolkig
8/2/2016 10:00,442,277,165,15,6,Regen
8/2/2016 11:00,424,256,168,16,9,wolkig
8/2/2016 12:00,476,270,206,17,11,wolkig
8/2/2016 13:00,470,245,225,18,9,wolkig
8/2/2016 14:00,529,280,249,17,9,wolkig
8/2/2016 15:00,552,265,287,18,11,Regen
8/2/2016 16:00,631,270,361,17,15,wolkig
8/2/2016 17:00,686,307,379,18,9,wolkig
8/2/2016 18:00,674,298,376,18,13,wolkig
8/2/2016 19:00,512,225,287,17,9,Regen
8/2/2016 20:00,369,150,219,17,7,Regen
8/2/2016 21:00,253,90,163,17,9,Regen
8/2/2016 22:00,204,59,145,17,11,Regen
8/2/2016 23:00,195,71,124,18,11,wolkig
8/3/2016 0:00,93,25,68,18,13,Regen
8/3/2016 1:00,64,25,39,18,13,wolkig
8/3/2016 2:00,22,9,13,18,11,Regen
8/3/2016 3:00,17,10,7,18,13,Regen
8/3/2016 4:00,10,8,2,18,13,wolkig
8/3/2016 5:00,49,28,21,18,15,wolkig
8/3/2016 6:00,90,68,22,18,15,Regen
8/3/2016 7:00,258,172,86,18,15,Regen
8/3/2016 8:00,553,361,192,18,19,Regen
8/3/2016 9:00,419,271,148,19,19,Regen
8/3/2016 10:00,394,254,140,19,19,Regen
8/3/2016 11:00,379,222,157,19,17,Regen
8/3/2016 12:00,477,257,220,19,22,Regen
8/3/2016 13:00,448,218,230,19,20,Regen
8/3/2016 14:00,428,202,226,19,22,Regen
8/3/2016 15:00,417,179,238,19,19,Regen
8/3/2016 16:00,495,231,264,19,20,wolkig
8/3/2016 17:00,562,259,303,19,19,wolkig
8/3/2016 18:00,547,227,320,19,13,Regen
8/3/2016 19:00,491,244,247,19,15,Regen
8/3/2016 20:00,415,209,206,19,15,Regen
8/3/2016 21:00,263,129,134,19,15,Regen
8/3/2016 22:00,248,108,140,19,17,Regen
8/3/2016 23:00,176,96,80,15,19,Regen
8/4/2016 0:00,200,89,111,16,6,Klarer Himmel
8/4/2016 1:00,121,42,79,17,15,teilweise bewölkt
8/4/2016 2:00,67,12,55,17,17,teilweise bewölkt
8/4/2016 3:00,57,7,50,17,19,teilweise bewölkt
8/4/2016 4:00,56,14,42,16,11,teilweise bewölkt
8/4/2016 5:00,63,33,30,16,17,wolkig
8/4/2016 6:00,143,101,42,16,19,wolkig
8/4/2016 7:00,377,247,130,16,19,wolkig
8/4/2016 8:00,609,349,260,16,20,wolkig
8/4/2016 9:00,491,334,157,17,19,wolkig
8/4/2016 10:00,442,285,157,18,20,wolkig
8/4/2016 11:00,451,281,170,19,24,wolkig
8/4/2016 12:00,532,293,239,19,22,wolkig
8/4/2016 13:00,553,288,265,20,19,wolkig
8/4/2016 14:00,637,300,337,19,19,wolkig
8/4/2016 15:00,639,331,308,19,22,wolkig
8/4/2016 16:00,776,370,406,19,19,wolkig
8/4/2016 17:00,823,377,446,20,19,wolkig
8/4/2016 18:00,750,323,427,20,17,wolkig
8/4/2016 19:00,653,319,334,19,13,wolkig
8/4/2016 20:00,521,255,266,18,7,wolkig
8/4/2016 21:00,322,117,205,18,15,Regen
8/4/2016 22:00,289,82,207,17,11,wolkig
8/4/2016 23:00,236,79,157,16,7,Klarer Himmel
8/5/2016 0:00,173,45,128,15,6,Klarer Himmel
8/5/2016 1:00,97,26,71,14,4,Klarer Himmel
8/5/2016 2:00,34,3,31,14,6,Klarer Himmel
8/5/2016 3:00,33,10,23,14,6,Klarer Himmel
8/5/2016 4:00,26,9,17,14,7,Klarer Himmel
8/5/2016 5:00,49,27,22,13,7,Nebel
8/5/2016 6:00,137,101,36,14,9,wolkig
8/5/2016 7:00,327,202,125,15,11,wolkig
8/5/2016 8:00,567,357,210,15,13,wolkig
8/5/2016 9:00,509,322,187,16,11,wolkig
8/5/2016 10:00,434,268,166,17,13,wolkig
8/5/2016 11:00,429,242,187,19,15,wolkig
8/5/2016 12:00,542,300,242,20,22,teilweise bewölkt
8/5/2016 13:00,585,288,297,22,20,teilweise bewölkt
8/5/2016 14:00,631,324,307,20,32,Regen
8/5/2016 15:00,562,283,279,19,13,Regen
8/5/2016 16:00,639,325,314,21,13,teilweise bewölkt
8/5/2016 17:00,608,297,311,22,22,teilweise bewölkt
8/5/2016 18:00,630,289,341,21,13,teilweise bewölkt
8/5/2016 19:00,590,307,283,20,15,wolkig
8/5/2016 20:00,500,249,251,19,11,wolkig
8/5/2016 21:00,324,164,160,17,11,Klarer Himmel
8/5/2016 22:00,286,124,162,16,11,Klarer Himmel
8/5/2016 23:00,252,104,148,15,7,Klarer Himmel
8/6/2016 0:00,248,85,163,15,6,Klarer Himmel
8/6/2016 1:00,168,55,113,14,4,Klarer Himmel
8/6/2016 2:00,150,44,106,13,7,teilweise bewölkt
8/6/2016 3:00,124,33,91,14,6,teilweise bewölkt
8/6/2016 4:00,63,7,56,13,7,teilweise bewölkt
8/6/2016 5:00,67,26,41,14,7,Klarer Himmel
8/6/2016 6:00,65,35,30,14,6,Klarer Himmel
8/6/2016 7:00,80,51,29,15,7,wolkig
8/6/2016 8:00,187,133,54,16,9,Klarer Himmel
8/6/2016 9:00,294,226,68,18,15,wolkig
8/6/2016 10:00,462,341,121,18,19,wolkig
8/6/2016 11:00,497,334,163,18,17,Regen
8/6/2016 12:00,534,318,216,18,13,wolkig
8/6/2016 13:00,508,269,239,18,15,Regen
8/6/2016 14:00,385,141,244,19,11,teilweise bewölkt
8/6/2016 15:00,483,230,253,20,20,teilweise bewölkt
8/6/2016 16:00,399,200,199,20,20,teilweise bewölkt
8/6/2016 17:00,443,224,219,20,15,wolkig
8/6/2016 18:00,498,236,262,21,15,teilweise bewölkt
8/6/2016 19:00,474,249,225,21,11,teilweise bewölkt
8/6/2016 20:00,488,280,208,19,11,teilweise bewölkt
8/6/2016 21:00,324,160,164,17,11,teilweise bewölkt
8/6/2016 22:00,257,125,132,14,6,Klarer Himmel
8/6/2016 23:00,282,92,190,14,4,Klarer Himmel
8/7/2016 0:00,260,96,164,12,2,Klarer Himmel
8/7/2016 1:00,177,58,119,12,4,Nebel
8/7/2016 2:00,112,22,90,11,4,Nebel
8/7/2016 3:00,97,14,83,11,2,Nebel
8/7/2016 4:00,48,8,40,11,4,Nebel
8/7/2016 5:00,53,10,43,10,2,Nebel
8/7/2016 6:00,43,17,26,11,7,Klarer Himmel
8/7/2016 7:00,46,26,20,13,7,Klarer Himmel
8/7/2016 8:00,69,35,34,16,13,Klarer Himmel
8/7/2016 9:00,198,136,62,17,13,Klarer Himmel
8/7/2016 10:00,353,215,138,19,15,Klarer Himmel
8/7/2016 11:00,362,221,141,22,20,Klarer Himmel
8/7/2016 12:00,385,239,146,23,20,Klarer Himmel
8/7/2016 13:00,510,315,195,24,22,Klarer Himmel
8/7/2016 14:00,542,331,211,25,24,wolkig
8/7/2016 15:00,564,318,246,24,22,wolkig
8/7/2016 16:00,577,251,326,23,20,wolkig
8/7/2016 17:00,561,219,342,23,22,
8/7/2016 18:00,553,228,325,23,20,wolkig
8/7/2016 19:00,370,144,226,22,13,wolkig
8/7/2016 20:00,345,136,209,22,11,wolkig
8/7/2016 21:00,264,99,165,21,7,wolkig
8/7/2016 22:00,182,70,112,21,13,wolkig
8/7/2016 23:00,105,34,71,22,17,wolkig
8/8/2016 0:00,64,24,40,22,19,wolkig
8/8/2016 1:00,35,7,28,21,19,wolkig
8/8/2016 2:00,18,6,12,20,13,wolkig
8/8/2016 3:00,13,6,7,20,26,wolkig
8/8/2016 4:00,12,7,5,19,24,wolkig
8/8/2016 5:00,55,40,15,18,17,teilweise bewölkt
8/8/2016 6:00,158,111,47,18,19,teilweise bewölkt
8/8/2016 7:00,430,283,147,18,24,teilweise bewölkt
8/8/2016 8:00,628,442,186,18,22,wolkig
8/8/2016 9:00,468,288,180,18,19,wolkig
8/8/2016 10:00,386,218,168,17,24,wolkig
8/8/2016 11:00,480,270,210,18,19,wolkig
8/8/2016 12:00,465,254,211,18,24,wolkig
8/8/2016 13:00,432,172,260,17,20,wolkig
8/8/2016 14:00,464,221,243,20,20,teilweise bewölkt
8/8/2016 15:00,556,313,243,21,24,teilweise bewölkt
8/8/2016 16:00,693,342,351,21,28,teilweise bewölkt
8/8/2016 17:00,847,358,489,21,28,teilweise bewölkt
8/8/2016 18:00,755,365,390,19,26,Klarer Himmel
8/8/2016 19:00,606,272,334,18,15,Klarer Himmel
8/8/2016 20:00,436,202,234,16,9,Klarer Himmel
8/8/2016 21:00,341,134,207,14,6,Klarer Himmel
8/8/2016 22:00,233,75,158,15,11,Klarer Himmel
8/8/2016 23:00,190,67,123,14,7,Klarer Himmel
8/9/2016 0:00,87,12,75,14,7,Klarer Himmel
8/9/2016 1:00,50,10,40,14,6,Klarer Himmel
8/9/2016 2:00,28,14,14,13,6,Klarer Himmel
8/9/2016 3:00,24,4,20,13,6,Klarer Himmel
8/9/2016 4:00,15,9,6,13,6,Klarer Himmel
8/9/2016 5:00,45,27,18,13,6,Klarer Himmel
8/9/2016 6:00,150,107,43,12,6,Klarer Himmel
8/9/2016 7:00,386,261,125,13,6,Klarer Himmel
8/9/2016 8:00,592,388,204,15,11,Klarer Himmel
8/9/2016 9:00,556,331,225,15,17,wolkig
8/9/2016 10:00,503,305,198,15,15,wolkig
8/9/2016 11:00,548,347,201,16,13,wolkig
8/9/2016 12:00,514,264,250,17,15,teilweise bewölkt
8/9/2016 13:00,511,270,241,18,19,teilweise bewölkt
8/9/2016 14:00,596,336,260,16,24,wolkig
8/9/2016 15:00,609,256,353,18,17,wolkig
8/9/2016 16:00,742,320,422,17,17,wolkig
8/9/2016 17:00,783,343,440,16,17,wolkig
8/9/2016 18:00,781,339,442,16,11,wolkig
8/9/2016 19:00,574,267,307,16,15,teilweise bewölkt
8/9/2016 20:00,416,172,244,13,4,wolkig
8/9/2016 21:00,291,125,166,14,7,Klarer Himmel
8/9/2016 22:00,280,106,174,13,7,Klarer Himmel
8/9/2016 23:00,185,64,121,13,9,Regen
8/10/2016 0:00,125,33,92,13,6,wolkig
8/10/2016 1:00,74,22,52,12,9,wolkig
8/10/2016 2:00,39,7,32,12,7,Regen
8/10/2016 3:00,19,6,13,11,7,Regen
8/10/2016 4:00,8,6,2,11,6,Regen
8/10/2016 5:00,42,27,15,10,7,Regen
8/10/2016 6:00,121,96,25,10,7,Klarer Himmel
8/10/2016 7:00,358,263,95,11,7,wolkig
8/10/2016 8:00,595,399,196,12,15,teilweise bewölkt
8/10/2016 9:00,521,347,174,13,13,teilweise bewölkt
8/10/2016 10:00,541,323,218,14,17,teilweise bewölkt
8/10/2016 11:00,543,366,177,16,15,teilweise bewölkt
8/10/2016 12:00,594,326,268,17,22,Regen
8/10/2016 13:00,518,250,268,14,13,Regen
8/10/2016 14:00,566,247,319,15,20,Regen
8/10/2016 15:00,505,221,284,13,19,Regen
8/10/2016 16:00,555,273,282,13,7,Regen
8/10/2016 17:00,865,415,450,14,9,Regen
8/10/2016 18:00,655,306,349,15,9,teilweise bewölkt
8/10/2016 19:00,561,252,309,14,4,teilweise bewölkt
8/10/2016 20:00,452,199,253,12,2,Klarer Himmel
8/10/2016 21:00,377,139,238,10,2,Nebel
8/10/2016 22:00,296,108,188,9,4,Nebel
8/10/2016 23:00,239,93,146,8,2,Klarer Himmel
8/11/2016 0:00,164,72,92,8,2,Klarer Himmel
8/11/2016 1:00,134,54,80,7,0,Nebel
8/11/2016 2:00,80,38,42,7,2,Nebel
8/11/2016 3:00,52,10,42,6,0,Nebel
8/11/2016 4:00,56,21,35,6,4,Nebel
8/11/2016 5:00,66,40,26,6,4,Nebel
8/11/2016 6:00,148,94,54,7,4,Nebel
8/11/2016 7:00,351,230,121,9,6,Klarer Himmel
8/11/2016 8:00,613,427,186,10,11,Klarer Himmel
8/11/2016 9:00,459,287,172,11,13,Klarer Himmel
8/11/2016 10:00,431,237,194,13,15,Regen
8/11/2016 11:00,428,240,188,14,20,Regen
8/11/2016 12:00,439,231,208,14,19,wolkig
8/11/2016 13:00,497,266,231,15,19,Regen
8/11/2016 14:00,537,249,288,14,19,Regen
8/11/2016 15:00,462,219,243,13,28,Regen
8/11/2016 16:00,571,247,324,13,22,Regen
8/11/2016 17:00,597,259,338,13,20,Regen
8/11/2016 18:00,559,254,305,13,19,Regen
8/11/2016 19:00,358,153,205,13,17,Regen
8/11/2016 20:00,324,144,180,13,15,Regen
8/11/2016 21:00,181,59,122,13,17,Regen
8/11/2016 22:00,136,48,88,13,15,Regen
8/11/2016 23:00,147,59,88,14,15,Regen
8/12/2016 0:00,96,40,56,14,15,Regen
8/12/2016 1:00,74,39,35,14,15,Regen
8/12/2016 2:00,24,3,21,14,11,Regen
8/12/2016 3:00,39,10,29,15,15,Regen
8/12/2016 4:00,38,11,27,15,13,Regen
8/12/2016 5:00,56,26,30,16,13,Regen
8/12/2016 6:00,103,67,36,16,13,Regen
8/12/2016 7:00,336,229,107,17,13,Regen
8/12/2016 8:00,449,300,149,17,15,Regen
8/12/2016 9:00,339,209,130,17,15,Regen
8/12/2016 10:00,310,179,131,17,15,Regen
8/12/2016 11:00,400,235,165,18,19,Regen
8/12/2016 12:00,428,215,213,19,24,wolkig
8/12/2016 13:00,423,221,202,20,24,wolkig
8/12/2016 14:00,480,219,261,21,28,wolkig
8/12/2016 15:00,514,265,249,21,26,wolkig
8/12/2016 16:00,512,238,274,20,26,wolkig
8/12/2016 17:00,521,243,278,21,13,wolkig
8/12/2016 18:00,545,269,276,21,13,wolkig
8/12/2016 19:00,452,265,187,21,15,wolkig
8/12/2016 20:00,431,236,195,20,7,wolkig
8/12/2016 21:00,307,159,148,19,6,teilweise bewölkt
8/12/2016 22:00,273,139,134,17,7,teilweise bewölkt
8/12/2016 23:00,200,94,106,17,7,teilweise bewölkt
8/13/2016 0:00,219,93,126,17,9,teilweise bewölkt
8/13/2016 1:00,206,63,143,17,11,wolkig
8/13/2016 2:00,126,33,93,16,11,teilweise bewölkt
8/13/2016 3:00,97,23,74,16,11,teilweise bewölkt
8/13/2016 4:00,64,17,47,16,11,teilweise bewölkt
8/13/2016 5:00,62,31,31,16,11,Klarer Himmel
8/13/2016 6:00,76,41,35,16,11,Klarer Himmel
8/13/2016 7:00,77,62,15,16,15,wolkig
8/13/2016 8:00,136,94,42,17,17,wolkig
8/13/2016 9:00,289,212,77,17,15,wolkig
8/13/2016 10:00,405,289,116,18,20,wolkig
8/13/2016 11:00,439,293,146,18,26,wolkig
8/13/2016 12:00,483,283,200,19,22,wolkig
8/13/2016 13:00,500,286,214,20,24,wolkig
8/13/2016 14:00,514,261,253,21,24,wolkig
8/13/2016 15:00,466,234,232,20,24,wolkig
8/13/2016 16:00,548,275,273,22,20,wolkig
8/13/2016 17:00,495,205,290,21,13,wolkig
8/13/2016 18:00,522,213,309,21,19,wolkig
8/13/2016 19:00,426,218,208,20,13,wolkig
8/13/2016 20:00,371,180,191,20,17,wolkig
8/13/2016 21:00,282,146,136,19,11,Regen
8/13/2016 22:00,247,128,119,17,6,wolkig
8/13/2016 23:00,265,136,129,16,0,wolkig
8/14/2016 0:00,192,91,101,16,2,teilweise bewölkt
8/14/2016 1:00,233,83,150,15,0,wolkig
8/14/2016 2:00,122,41,81,15,0,Nebel
8/14/2016 3:00,69,19,50,15,2,Nebel
8/14/2016 4:00,58,12,46,15,4,Nebel
8/14/2016 5:00,40,10,30,15,2,Nebel
8/14/2016 6:00,41,21,20,15,4,Nebel
8/14/2016 7:00,41,25,16,15,0,Nebel
8/14/2016 8:00,58,35,23,17,4,wolkig
8/14/2016 9:00,157,89,68,18,4,wolkig
8/14/2016 10:00,240,131,109,19,7,wolkig
8/14/2016 11:00,259,138,121,19,9,teilweise bewölkt
8/14/2016 12:00,374,206,168,20,11,teilweise bewölkt
8/14/2016 13:00,392,231,161,21,15,wolkig
8/14/2016 14:00,399,245,154,22,6,teilweise bewölkt
8/14/2016 15:00,413,238,175,22,11,teilweise bewölkt
8/14/2016 16:00,475,277,198,22,7,teilweise bewölkt
8/14/2016 17:00,517,234,283,21,11,wolkig
8/14/2016 18:00,476,206,270,21,17,teilweise bewölkt
8/14/2016 19:00,395,167,228,19,11,teilweise bewölkt
8/14/2016 20:00,320,129,191,17,9,Klarer Himmel
8/14/2016 21:00,211,91,120,16,7,Klarer Himmel
8/14/2016 22:00,153,57,96,14,6,Klarer Himmel
8/14/2016 23:00,105,36,69,13,4,Klarer Himmel
8/15/2016 0:00,57,24,33,13,0,Nebel
8/15/2016 1:00,38,22,16,11,2,teilweise bewölkt
8/15/2016 2:00,16,6,10,12,2,wolkig
8/15/2016 3:00,7,4,3,13,2,Klarer Himmel
8/15/2016 4:00,15,11,4,13,4,Klarer Himmel
8/15/2016 5:00,53,36,17,13,4,Klarer Himmel
8/15/2016 6:00,166,109,57,13,0,Klarer Himmel
8/15/2016 7:00,418,274,144,14,2,Klarer Himmel
8/15/2016 8:00,627,412,215,16,7,teilweise bewölkt
8/15/2016 9:00,499,300,199,18,9,teilweise bewölkt
8/15/2016 10:00,485,306,179,18,9,wolkig
8/15/2016 11:00,497,277,220,19,7,wolkig
8/15/2016 12:00,539,296,243,20,15,wolkig
8/15/2016 13:00,579,303,276,19,13,wolkig
8/15/2016 14:00,661,340,321,20,17,wolkig
8/15/2016 15:00,640,344,296,20,13,teilweise bewölkt
8/15/2016 16:00,820,402,418,20,13,wolkig
8/15/2016 17:00,989,424,565,19,13,wolkig
8/15/2016 18:00,891,396,495,20,15,teilweise bewölkt
8/15/2016 19:00,610,305,305,19,13,Klarer Himmel
8/15/2016 20:00,500,256,244,16,4,Klarer Himmel
8/15/2016 21:00,265,87,178,14,2,Klarer Himmel
8/15/2016 22:00,225,73,152,13,4,Klarer Himmel
8/15/2016 23:00,148,34,114,12,4,Klarer Himmel
8/16/2016 0:00,110,36,74,13,4,Klarer Himmel
8/16/2016 1:00,55,12,43,12,4,Klarer Himmel
8/16/2016 2:00,33,8,25,11,2,Klarer Himmel
8/16/2016 3:00,15,4,11,10,2,Nebel
8/16/2016 4:00,17,7,10,10,0,Nebel
8/16/2016 5:00,46,33,13,9,0,Nebel
8/16/2016 6:00,162,117,45,9,4,Nebel
8/16/2016 7:00,469,305,164,13,6,Klarer Himmel
8/16/2016 8:00,664,435,229,15,9,wolkig
8/16/2016 9:00,548,343,205,17,13,wolkig
8/16/2016 10:00,504,294,210,18,13,wolkig
8/16/2016 11:00,525,289,236,19,13,wolkig
8/16/2016 12:00,589,327,262,19,11,teilweise bewölkt
8/16/2016 13:00,654,370,284,19,11,teilweise bewölkt
8/16/2016 14:00,675,345,330,21,13,teilweise bewölkt
8/16/2016 15:00,652,296,356,20,19,teilweise bewölkt
8/16/2016 16:00,838,408,430,21,15,teilweise bewölkt
8/16/2016 17:00,1001,451,550,21,13,teilweise bewölkt
8/16/2016 18:00,958,468,490,20,15,teilweise bewölkt
8/16/2016 19:00,734,318,416,19,11,Klarer Himmel
8/16/2016 20:00,552,216,336,16,6,Klarer Himmel
8/16/2016 21:00,404,147,257,15,6,Klarer Himmel
8/16/2016 22:00,294,99,195,13,4,Klarer Himmel
8/16/2016 23:00,213,50,163,13,6,Klarer Himmel
8/17/2016 0:00,132,40,92,13,2,Klarer Himmel
8/17/2016 1:00,69,21,48,13,4,Klarer Himmel
8/17/2016 2:00,39,9,30,14,6,Klarer Himmel
8/17/2016 3:00,23,9,14,13,4,Klarer Himmel
8/17/2016 4:00,15,7,8,11,4,Klarer Himmel
8/17/2016 5:00,49,32,17,9,2,Nebel
8/17/2016 6:00,179,125,54,8,6,Nebel
8/17/2016 7:00,475,318,157,12,2,Nebel
8/17/2016 8:00,690,436,254,15,7,Klarer Himmel
8/17/2016 9:00,584,371,213,17,7,Klarer Himmel
8/17/2016 10:00,518,321,197,19,9,Klarer Himmel
8/17/2016 11:00,587,362,225,20,9,Klarer Himmel
8/17/2016 12:00,690,418,272,21,11,Klarer Himmel
8/17/2016 13:00,667,320,347,21,9,Klarer Himmel
8/17/2016 14:00,630,305,325,22,11,Klarer Himmel
8/17/2016 15:00,816,368,448,22,9,Klarer Himmel
8/17/2016 16:00,887,429,458,22,11,Klarer Himmel
8/17/2016 17:00,969,489,480,22,11,Klarer Himmel
8/17/2016 18:00,1000,468,532,21,7,Klarer Himmel
8/17/2016 19:00,777,409,368,20,6,Klarer Himmel
8/17/2016 20:00,604,287,317,17,6,Klarer Himmel
8/17/2016 21:00,424,196,228,16,6,Klarer Himmel
8/17/2016 22:00,370,97,273,14,4,Klarer Himmel
8/17/2016 23:00,265,96,169,13,6,Klarer Himmel
8/18/2016 0:00,188,74,114,12,4,Klarer Himmel
8/18/2016 1:00,93,31,62,10,4,Nebel
8/18/2016 2:00,72,11,61,10,6,Nebel
8/18/2016 3:00,40,5,35,10,7,Nebel
8/18/2016 4:00,82,16,66,9,4,Klarer Himmel
8/18/2016 5:00,58,31,27,8,2,Nebel
8/18/2016 6:00,178,126,52,8,2,Nebel
8/18/2016 7:00,467,303,164,11,6,Klarer Himmel
8/18/2016 8:00,667,439,228,16,6,Klarer Himmel
8/18/2016 9:00,516,311,205,19,7,Klarer Himmel
8/18/2016 10:00,500,296,204,20,11,Klarer Himmel
8/18/2016 11:00,481,263,218,22,13,Klarer Himmel
8/18/2016 12:00,612,351,261,22,13,Klarer Himmel
8/18/2016 13:00,618,324,294,23,9,Klarer Himmel
8/18/2016 14:00,728,402,326,23,7,Klarer Himmel
8/18/2016 15:00,739,369,370,24,6,Klarer Himmel
8/18/2016 16:00,897,461,436,24,7,Klarer Himmel
8/18/2016 17:00,906,450,456,24,13,Klarer Himmel
8/18/2016 18:00,847,414,433,23,11,Klarer Himmel
8/18/2016 19:00,800,377,423,22,6,Klarer Himmel
8/18/2016 20:00,490,223,267,18,6,Klarer Himmel
8/18/2016 21:00,386,137,249,15,2,Klarer Himmel
8/18/2016 22:00,364,121,243,15,7,Klarer Himmel
8/18/2016 23:00,249,66,183,15,4,Klarer Himmel
8/19/2016 0:00,138,34,104,14,4,Klarer Himmel
8/19/2016 1:00,61,16,45,14,4,Klarer Himmel
8/19/2016 2:00,43,20,23,12,4,Klarer Himmel
8/19/2016 3:00,26,10,16,11,2,Nebel
8/19/2016 4:00,15,8,7,10,0,Nebel
8/19/2016 5:00,39,27,12,9,0,Nebel
8/19/2016 6:00,168,121,47,9,0,Nebel
8/19/2016 7:00,408,269,139,11,2,Klarer Himmel
8/19/2016 8:00,631,404,227,16,4,Klarer Himmel
8/19/2016 9:00,512,329,183,19,6,Klarer Himmel
8/19/2016 10:00,439,261,178,21,4,Klarer Himmel
8/19/2016 11:00,511,301,210,22,6,teilweise bewölkt
8/19/2016 12:00,585,345,240,23,6,teilweise bewölkt
8/19/2016 13:00,648,322,326,25,7,Klarer Himmel
8/19/2016 14:00,690,361,329,26,6,Klarer Himmel
8/19/2016 15:00,754,375,379,25,7,Klarer Himmel
8/19/2016 16:00,683,341,342,26,7,Klarer Himmel
8/19/2016 17:00,770,404,366,25,6,Klarer Himmel
8/19/2016 18:00,783,396,387,23,4,Klarer Himmel
8/19/2016 19:00,618,299,319,22,4,Klarer Himmel
8/19/2016 20:00,397,172,225,19,2,Regen
8/19/2016 21:00,312,144,168,18,4,
8/19/2016 22:00,245,107,138,18,4,Klarer Himmel
8/19/2016 23:00,283,96,187,19,6,Regen
8/20/2016 0:00,181,68,113,19,20,Regen
8/20/2016 1:00,145,50,95,18,9,wolkig
8/20/2016 2:00,88,27,61,17,7,Klarer Himmel
8/20/2016 3:00,80,17,63,17,9,wolkig
8/20/2016 4:00,54,15,39,17,11,wolkig
8/20/2016 5:00,55,22,33,17,13,wolkig
8/20/2016 6:00,85,47,38,17,11,wolkig
8/20/2016 7:00,170,142,28,17,9,wolkig
8/20/2016 8:00,211,163,48,18,15,wolkig
8/20/2016 9:00,300,219,81,18,15,wolkig
8/20/2016 10:00,499,346,153,20,13,wolkig
8/20/2016 11:00,571,388,183,20,11,wolkig
8/20/2016 12:00,689,411,278,20,13,wolkig
8/20/2016 13:00,644,335,309,22,17,wolkig
8/20/2016 14:00,617,297,320,21,13,wolkig
8/20/2016 15:00,591,239,352,22,17,Regen
8/20/2016 16:00,544,247,297,20,9,teilweise bewölkt
8/20/2016 17:00,475,211,264,22,11,teilweise bewölkt
8/20/2016 18:00,468,230,238,22,11,teilweise bewölkt
8/20/2016 19:00,467,232,235,21,7,Klarer Himmel
8/20/2016 20:00,393,209,184,18,7,Klarer Himmel
8/20/2016 21:00,309,143,166,15,4,Nebel
8/20/2016 22:00,293,129,164,15,7,Klarer Himmel
8/20/2016 23:00,212,68,144,18,19,Klarer Himmel
8/21/2016 0:00,174,62,112,17,13,Klarer Himmel
8/21/2016 1:00,187,58,129,17,9,Klarer Himmel
8/21/2016 2:00,115,40,75,15,9,Klarer Himmel
8/21/2016 3:00,115,22,93,15,11,Klarer Himmel
8/21/2016 4:00,60,18,42,15,13,Klarer Himmel
8/21/2016 5:00,70,20,50,14,11,Klarer Himmel
8/21/2016 6:00,56,20,36,15,11,Klarer Himmel
8/21/2016 7:00,59,34,25,16,17,wolkig
8/21/2016 8:00,66,38,28,17,19,wolkig
8/21/2016 9:00,158,107,51,18,22,wolkig
8/21/2016 10:00,259,146,113,17,20,wolkig
8/21/2016 11:00,191,102,89,15,28,Regen
8/21/2016 12:00,234,113,121,17,22,wolkig
8/21/2016 13:00,251,118,133,17,20,wolkig
8/21/2016 14:00,283,150,133,19,20,wolkig
8/21/2016 15:00,288,159,129,18,20,Regen
8/21/2016 16:00,238,120,118,18,17,wolkig
8/21/2016 17:00,268,141,127,18,19,wolkig
8/21/2016 18:00,308,157,151,18,24,wolkig
8/21/2016 19:00,270,134,136,18,22,wolkig
8/21/2016 20:00,199,90,109,17,13,wolkig
8/21/2016 21:00,155,49,106,17,17,wolkig
8/21/2016 22:00,120,49,71,16,9,teilweise bewölkt
8/21/2016 23:00,82,27,55,16,11,teilweise bewölkt
8/22/2016 0:00,45,17,28,16,11,Klarer Himmel
8/22/2016 1:00,25,9,16,16,11,Klarer Himmel
8/22/2016 2:00,17,4,13,15,9,wolkig
8/22/2016 3:00,8,3,5,16,11,wolkig
8/22/2016 4:00,11,7,4,15,13,teilweise bewölkt
8/22/2016 5:00,58,39,19,14,11,wolkig
8/22/2016 6:00,175,121,54,14,9,Regen
8/22/2016 7:00,398,256,142,15,11,Regen
8/22/2016 8:00,513,332,181,15,13,Regen
8/22/2016 9:00,479,294,185,15,13,wolkig
8/22/2016 10:00,378,190,188,16,15,Regen
8/22/2016 11:00,330,146,184,16,17,Regen
8/22/2016 12:00,326,158,168,16,15,Regen
8/22/2016 13:00,359,178,181,16,13,Regen
8/22/2016 14:00,459,235,224,17,13,Regen
8/22/2016 15:00,426,192,234,17,13,Regen
8/22/2016 16:00,587,304,283,18,15,Regen
8/22/2016 17:00,691,313,378,18,11,Regen
8/22/2016 18:00,695,304,391,19,11,wolkig
8/22/2016 19:00,530,232,298,19,9,teilweise bewölkt
8/22/2016 20:00,386,172,214,18,9,Klarer Himmel
8/22/2016 21:00,262,129,133,17,7,Klarer Himmel
8/22/2016 22:00,230,94,136,17,7,teilweise bewölkt
8/22/2016 23:00,167,55,112,15,2,Nebel
8/23/2016 0:00,78,13,65,14,0,Nebel
8/23/2016 1:00,55,14,41,15,0,wolkig
8/23/2016 2:00,24,5,19,15,2,wolkig
8/23/2016 3:00,14,6,8,16,4,wolkig
8/23/2016 4:00,15,10,5,16,2,Klarer Himmel
8/23/2016 5:00,66,44,22,15,6,wolkig
8/23/2016 6:00,201,155,46,15,0,Nebel
8/23/2016 7:00,525,335,190,16,0,Nebel
8/23/2016 8:00,746,462,284,18,6,wolkig
8/23/2016 9:00,657,408,249,19,7,wolkig
8/23/2016 10:00,516,311,205,21,7,Klarer Himmel
8/23/2016 11:00,558,308,250,23,7,Klarer Himmel
8/23/2016 12:00,652,367,285,24,7,Klarer Himmel
8/23/2016 13:00,735,369,366,25,7,Klarer Himmel
8/23/2016 14:00,762,393,369,26,7,wolkig
8/23/2016 15:00,784,380,404,26,2,teilweise bewölkt
8/23/2016 16:00,1015,529,486,26,6,teilweise bewölkt
8/23/2016 17:00,1063,537,526,27,4,teilweise bewölkt
8/23/2016 18:00,1044,502,542,26,6,Klarer Himmel
8/23/2016 19:00,943,454,489,25,4,Klarer Himmel
8/23/2016 20:00,608,257,351,22,6,Klarer Himmel
8/23/2016 21:00,447,162,285,21,6,Klarer Himmel
8/23/2016 22:00,381,117,264,20,6,Klarer Himmel
8/23/2016 23:00,253,80,173,20,4,Klarer Himmel
8/24/2016 0:00,141,35,106,19,4,Klarer Himmel
8/24/2016 1:00,72,16,56,19,6,Klarer Himmel
8/24/2016 2:00,35,11,24,18,4,Klarer Himmel
8/24/2016 3:00,14,6,8,19,6,Klarer Himmel
8/24/2016 4:00,16,11,5,18,6,Klarer Himmel
8/24/2016 5:00,51,28,23,17,4,Klarer Himmel
8/24/2016 6:00,204,151,53,17,4,Klarer Himmel
8/24/2016 7:00,688,482,206,19,7,Klarer Himmel
8/24/2016 8:00,898,581,317,21,7,Klarer Himmel
8/24/2016 9:00,715,467,248,23,6,Klarer Himmel
8/24/2016 10:00,623,359,264,25,7,Klarer Himmel
8/24/2016 11:00,688,377,311,27,7,Klarer Himmel
8/24/2016 12:00,725,379,346,28,9,Klarer Himmel
8/24/2016 13:00,883,410,473,29,11,Klarer Himmel
8/24/2016 14:00,803,391,412,30,13,Klarer Himmel
8/24/2016 15:00,797,402,395,30,11,Klarer Himmel
8/24/2016 16:00,985,533,452,31,6,Klarer Himmel
8/24/2016 17:00,1105,580,525,31,6,Klarer Himmel
8/24/2016 18:00,1050,506,544,30,4,Klarer Himmel
8/24/2016 19:00,882,452,430,28,6,Klarer Himmel
8/24/2016 20:00,703,326,377,25,6,Klarer Himmel
8/24/2016 21:00,478,202,276,24,6,Klarer Himmel
8/24/2016 22:00,429,149,280,25,7,Klarer Himmel
8/24/2016 23:00,319,125,194,23,6,Klarer Himmel
8/25/2016 0:00,157,55,102,21,4,Klarer Himmel
8/25/2016 1:00,147,50,97,21,6,Klarer Himmel
8/25/2016 2:00,74,14,60,21,9,Klarer Himmel
8/25/2016 3:00,63,10,53,21,7,Klarer Himmel
8/25/2016 4:00,50,15,35,19,4,Klarer Himmel
8/25/2016 5:00,67,36,31,20,9,Klarer Himmel
8/25/2016 6:00,197,147,50,19,9,Klarer Himmel
8/25/2016 7:00,791,555,236,20,9,Klarer Himmel
8/25/2016 8:00,788,484,304,22,6,Klarer Himmel
8/25/2016 9:00,695,405,290,24,7,Klarer Himmel
8/25/2016 10:00,551,321,230,27,11,Klarer Himmel
8/25/2016 11:00,598,333,265,28,15,Klarer Himmel
8/25/2016 12:00,670,315,355,29,15,Klarer Himmel
8/25/2016 13:00,806,389,417,30,9,Klarer Himmel
8/25/2016 14:00,726,353,373,31,11,Klarer Himmel
8/25/2016 15:00,781,409,372,31,15,Klarer Himmel
8/25/2016 16:00,954,519,435,32,11,Klarer Himmel
8/25/2016 17:00,998,511,487,32,6,Klarer Himmel
8/25/2016 18:00,1028,536,492,32,4,Klarer Himmel
8/25/2016 19:00,824,448,376,29,4,Klarer Himmel
8/25/2016 20:00,595,279,316,24,0,Klarer Himmel
8/25/2016 21:00,571,229,342,21,4,Klarer Himmel
8/25/2016 22:00,434,148,286,20,2,Klarer Himmel
8/25/2016 23:00,280,94,186,21,6,Klarer Himmel
8/26/2016 0:00,148,40,108,19,2,Klarer Himmel
8/26/2016 1:00,99,33,66,18,2,Klarer Himmel
8/26/2016 2:00,27,10,17,20,6,Klarer Himmel
8/26/2016 3:00,23,7,16,20,6,Klarer Himmel
8/26/2016 4:00,25,10,15,19,6,Klarer Himmel
8/26/2016 5:00,54,33,21,18,4,Klarer Himmel
8/26/2016 6:00,184,130,54,18,2,Klarer Himmel
8/26/2016 7:00,727,530,197,20,6,Klarer Himmel
8/26/2016 8:00,753,460,293,22,9,Klarer Himmel
8/26/2016 9:00,582,371,211,25,7,Klarer Himmel
8/26/2016 10:00,538,274,264,26,7,Klarer Himmel
8/26/2016 11:00,557,273,284,28,7,Klarer Himmel
8/26/2016 12:00,747,354,393,30,11,Klarer Himmel
8/26/2016 13:00,760,336,424,30,7,Klarer Himmel
8/26/2016 14:00,753,385,368,30,15,Klarer Himmel
8/26/2016 15:00,747,417,330,31,9,Klarer Himmel
8/26/2016 16:00,775,392,383,31,9,Klarer Himmel
8/26/2016 17:00,821,422,399,30,15,Klarer Himmel
8/26/2016 18:00,745,364,381,29,11,Klarer Himmel
8/26/2016 19:00,679,350,329,27,13,Klarer Himmel
8/26/2016 20:00,572,316,256,25,15,Klarer Himmel
8/26/2016 21:00,451,243,208,24,17,Klarer Himmel
8/26/2016 22:00,368,137,231,22,13,Klarer Himmel
8/26/2016 23:00,331,111,220,21,13,Klarer Himmel
8/27/2016 0:00,263,117,146,20,9,wolkig
8/27/2016 1:00,178,56,122,20,9,Klarer Himmel
8/27/2016 2:00,165,70,95,19,9,wolkig
8/27/2016 3:00,90,15,75,19,9,wolkig
8/27/2016 4:00,69,19,50,18,11,teilweise bewölkt
8/27/2016 5:00,66,19,47,17,7,wolkig
8/27/2016 6:00,68,34,34,17,9,teilweise bewölkt
8/27/2016 7:00,128,101,27,18,6,Klarer Himmel
8/27/2016 8:00,236,154,82,19,15,Klarer Himmel
8/27/2016 9:00,413,292,121,21,11,Klarer Himmel
8/27/2016 10:00,487,322,165,22,13,Klarer Himmel
8/27/2016 11:00,522,337,185,24,13,Klarer Himmel
8/27/2016 12:00,668,406,262,25,15,Klarer Himmel
8/27/2016 13:00,629,354,275,26,11,Klarer Himmel
8/27/2016 14:00,614,343,271,27,11,Klarer Himmel
8/27/2016 15:00,546,261,285,28,11,Klarer Himmel
8/27/2016 16:00,564,255,309,28,19,teilweise bewölkt
8/27/2016 17:00,676,327,349,29,9,teilweise bewölkt
8/27/2016 18:00,639,307,332,28,7,wolkig
8/27/2016 19:00,530,280,250,27,6,wolkig
8/27/2016 20:00,395,205,190,25,7,Klarer Himmel
8/27/2016 21:00,337,161,176,25,6,wolkig
8/27/2016 22:00,358,139,219,23,7,wolkig
8/27/2016 23:00,256,85,171,23,13,teilweise bewölkt
8/28/2016 0:00,225,90,135,24,7,teilweise bewölkt
8/28/2016 1:00,176,68,108,24,13,wolkig
8/28/2016 2:00,134,39,95,21,4,teilweise bewölkt
8/28/2016 3:00,93,33,60,21,6,wolkig
8/28/2016 4:00,57,16,41,21,6,Klarer Himmel
8/28/2016 5:00,46,7,39,20,7,Klarer Himmel
8/28/2016 6:00,41,24,17,20,4,Klarer Himmel
8/28/2016 7:00,51,40,11,21,9,Klarer Himmel
8/28/2016 8:00,93,70,23,23,9,Klarer Himmel
8/28/2016 9:00,232,156,76,25,11,teilweise bewölkt
8/28/2016 10:00,323,184,139,27,13,wolkig
8/28/2016 11:00,410,212,198,29,13,wolkig
8/28/2016 12:00,484,265,219,31,20,teilweise bewölkt
8/28/2016 13:00,482,252,230,32,22,teilweise bewölkt
8/28/2016 14:00,504,307,197,30,30,teilweise bewölkt
8/28/2016 15:00,418,239,179,27,32,Regen
8/28/2016 16:00,422,209,213,26,32,teilweise bewölkt
8/28/2016 17:00,509,277,232,25,33,teilweise bewölkt
8/28/2016 18:00,551,244,307,23,30,teilweise bewölkt
8/28/2016 19:00,378,173,205,22,26,teilweise bewölkt
8/28/2016 20:00,375,195,180,21,9,Klarer Himmel
8/28/2016 21:00,246,75,171,19,11,Klarer Himmel
8/28/2016 22:00,185,53,132,19,13,teilweise bewölkt
8/28/2016 23:00,125,32,93,18,6,Klarer Himmel
8/29/2016 0:00,54,16,38,17,9,teilweise bewölkt
8/29/2016 1:00,36,10,26,18,7,Klarer Himmel
8/29/2016 2:00,18,5,13,17,13,Klarer Himmel
8/29/2016 3:00,6,4,2,17,17,teilweise bewölkt
8/29/2016 4:00,23,10,13,17,15,wolkig
8/29/2016 5:00,48,34,14,17,13,wolkig
8/29/2016 6:00,174,114,60,17,19,Regen
8/29/2016 7:00,601,444,157,17,17,wolkig
8/29/2016 8:00,643,386,257,17,17,wolkig
8/29/2016 9:00,537,326,211,19,17,wolkig
8/29/2016 10:00,459,267,192,18,13,wolkig
8/29/2016 11:00,497,272,225,20,13,wolkig
8/29/2016 12:00,517,277,240,20,13,wolkig
8/29/2016 13:00,544,276,268,21,17,wolkig
8/29/2016 14:00,664,301,363,21,22,wolkig
8/29/2016 15:00,657,312,345,21,15,wolkig
8/29/2016 16:00,858,405,453,20,15,wolkig
8/29/2016 17:00,936,445,491,21,15,teilweise bewölkt
8/29/2016 18:00,926,408,518,20,11,teilweise bewölkt
8/29/2016 19:00,646,282,364,19,15,wolkig
8/29/2016 20:00,497,200,297,17,9,teilweise bewölkt
8/29/2016 21:00,326,126,200,16,11,Klarer Himmel
8/29/2016 22:00,285,110,175,14,4,Klarer Himmel
8/29/2016 23:00,161,40,121,12,0,Klarer Himmel
8/30/2016 0:00,102,23,79,11,2,Klarer Himmel
8/30/2016 1:00,40,12,28,11,0,Nebel
8/30/2016 2:00,15,4,11,10,0,Nebel
8/30/2016 3:00,10,3,7,9,0,Nebel
8/30/2016 4:00,20,12,8,9,0,Nebel
8/30/2016 5:00,57,39,18,8,2,Nebel
8/30/2016 6:00,182,130,52,9,0,Nebel
8/30/2016 7:00,748,540,208,10,2,Nebel
8/30/2016 8:00,804,483,321,14,0,Klarer Himmel
8/30/2016 9:00,678,376,302,17,0,Klarer Himmel
8/30/2016 10:00,555,334,221,18,2,teilweise bewölkt
8/30/2016 11:00,540,296,244,19,4,teilweise bewölkt
8/30/2016 12:00,728,364,364,20,6,teilweise bewölkt
8/30/2016 13:00,703,337,366,21,9,teilweise bewölkt
8/30/2016 14:00,683,353,330,22,7,Klarer Himmel
8/30/2016 15:00,828,384,444,22,7,Klarer Himmel
8/30/2016 16:00,988,501,487,23,4,Klarer Himmel
8/30/2016 17:00,1056,520,536,22,6,Klarer Himmel
8/30/2016 18:00,1034,459,575,22,4,Klarer Himmel
8/30/2016 19:00,794,379,415,20,4,Klarer Himmel
8/30/2016 20:00,593,255,338,17,2,Klarer Himmel
8/30/2016 21:00,381,143,238,14,4,Klarer Himmel
8/30/2016 22:00,371,130,241,13,2,Klarer Himmel
8/30/2016 23:00,245,78,167,12,0,Klarer Himmel
8/31/2016 0:00,141,28,113,12,0,Klarer Himmel
8/31/2016 1:00,63,16,47,11,0,Klarer Himmel
8/31/2016 2:00,31,6,25,11,2,Klarer Himmel
8/31/2016 3:00,20,6,14,10,2,Klarer Himmel
8/31/2016 4:00,25,15,10,12,6,Klarer Himmel
8/31/2016 5:00,69,42,27,11,2,Klarer Himmel
8/31/2016 6:00,174,128,46,11,2,Klarer Himmel
8/31/2016 7:00,761,560,201,13,4,Klarer Himmel
8/31/2016 8:00,849,508,341,16,4,Klarer Himmel
8/31/2016 9:00,659,418,241,18,7,Klarer Himmel
8/31/2016 10:00,620,381,239,20,9,Klarer Himmel
8/31/2016 11:00,638,380,258,22,4,Klarer Himmel
8/31/2016 12:00,772,409,363,24,4,Klarer Himmel
8/31/2016 13:00,757,383,374,25,9,Klarer Himmel
8/31/2016 14:00,904,416,488,26,11,Klarer Himmel
8/31/2016 15:00,925,414,511,26,13,Klarer Himmel
8/31/2016 16:00,895,438,457,26,13,Klarer Himmel
8/31/2016 17:00,1087,513,574,26,19,Klarer Himmel
8/31/2016 18:00,1018,478,540,25,13,Klarer Himmel
8/31/2016 19:00,853,430,423,23,6,Klarer Himmel
8/31/2016 20:00,618,271,347,18,0,Klarer Himmel
8/31/2016 21:00,502,219,283,18,7,Klarer Himmel
8/31/2016 22:00,401,140,261,16,2,Klarer Himmel
8/31/2016 23:00,260,93,167,15,0,Klarer Himmel
9/1/2016 0:00,160,56,104,14,2,Klarer Himmel
9/1/2016 1:00,108,39,69,13,0,Klarer Himmel
9/1/2016 2:00,97,12,85,13,2,
9/1/2016 3:00,41,12,29,12,2,Nebel
9/1/2016 4:00,48,13,35,12,2,Nebel
9/1/2016 5:00,66,33,33,12,0,Nebel
9/1/2016 6:00,161,128,33,12,2,Nebel
9/1/2016 7:00,795,557,238,13,0,Nebel
9/1/2016 8:00,793,481,312,16,0,
9/1/2016 9:00,639,391,248,18,6,
9/1/2016 10:00,525,301,224,20,6,Klarer Himmel
9/1/2016 11:00,498,286,212,23,13,teilweise bewölkt
9/1/2016 12:00,618,310,308,23,15,teilweise bewölkt
9/1/2016 13:00,705,360,345,24,17,teilweise bewölkt
9/1/2016 14:00,746,390,356,24,19,wolkig
9/1/2016 15:00,853,391,462,19,26,Regen
9/1/2016 16:00,981,458,523,19,6,wolkig
9/1/2016 17:00,971,461,510,20,7,wolkig
9/1/2016 18:00,1017,457,560,21,9,wolkig
9/1/2016 19:00,750,333,417,19,2,wolkig
9/1/2016 20:00,532,243,289,16,0,Nebel
9/1/2016 21:00,390,183,207,16,0,wolkig
9/1/2016 22:00,307,127,180,15,0,Nebel
9/1/2016 23:00,198,56,142,13,4,Nebel
9/2/2016 0:00,113,30,83,13,0,Nebel
9/2/2016 1:00,77,16,61,12,0,Nebel
9/2/2016 2:00,35,6,29,11,0,Nebel
9/2/2016 3:00,14,6,8,11,0,Nebel
9/2/2016 4:00,21,14,7,11,0,Nebel
9/2/2016 5:00,57,29,28,10,0,Nebel
9/2/2016 6:00,159,106,53,11,0,Nebel
9/2/2016 7:00,678,486,192,11,2,Nebel
9/2/2016 8:00,726,444,282,13,6,Nebel
9/2/2016 9:00,531,355,176,15,4,wolkig
9/2/2016 10:00,497,303,194,18,7,wolkig
9/2/2016 11:00,534,314,220,21,17,wolkig
9/2/2016 12:00,631,363,268,23,17,wolkig
9/2/2016 13:00,731,341,390,24,15,wolkig
9/2/2016 14:00,735,350,385,24,17,Klarer Himmel
9/2/2016 15:00,886,390,496,25,19,Klarer Himmel
9/2/2016 16:00,719,359,360,25,19,Klarer Himmel
9/2/2016 17:00,801,423,378,24,19,wolkig
9/2/2016 18:00,810,379,431,22,17,Klarer Himmel
9/2/2016 19:00,764,393,371,21,11,Klarer Himmel
9/2/2016 20:00,504,235,269,18,6,Klarer Himmel
9/2/2016 21:00,381,175,206,18,6,Klarer Himmel
9/2/2016 22:00,331,143,188,18,6,Klarer Himmel
9/2/2016 23:00,296,99,197,18,6,Klarer Himmel
9/3/2016 0:00,275,106,169,18,4,Klarer Himmel
9/3/2016 1:00,182,51,131,17,11,wolkig
9/3/2016 2:00,138,40,98,17,7,wolkig
9/3/2016 3:00,108,26,82,16,7,wolkig
9/3/2016 4:00,81,24,57,16,11,wolkig
9/3/2016 5:00,44,18,26,16,7,Klarer Himmel
9/3/2016 6:00,60,37,23,15,9,teilweise bewölkt
9/3/2016 7:00,112,76,36,16,7,wolkig
9/3/2016 8:00,185,118,67,17,11,wolkig
9/3/2016 9:00,319,246,73,18,11,wolkig
9/3/2016 10:00,486,361,125,18,19,wolkig
9/3/2016 11:00,464,293,171,18,13,wolkig
9/3/2016 12:00,543,321,222,20,17,wolkig
9/3/2016 13:00,633,366,267,20,11,wolkig
9/3/2016 14:00,541,292,249,21,20,wolkig
9/3/2016 15:00,582,282,300,22,17,wolkig
9/3/2016 16:00,612,290,322,22,15,wolkig
9/3/2016 17:00,621,300,321,22,13,wolkig
9/3/2016 18:00,578,307,271,22,6,wolkig
9/3/2016 19:00,569,306,263,19,0,wolkig
9/3/2016 20:00,486,267,219,17,0,wolkig
9/3/2016 21:00,354,180,174,16,6,Klarer Himmel
9/3/2016 22:00,357,161,196,17,7,Klarer Himmel
9/3/2016 23:00,319,108,211,18,9,Klarer Himmel
9/4/2016 0:00,350,105,245,18,9,Klarer Himmel
9/4/2016 1:00,236,69,167,18,13,Klarer Himmel
9/4/2016 2:00,130,19,111,19,11,wolkig
9/4/2016 3:00,130,23,107,19,11,wolkig
9/4/2016 4:00,73,9,64,18,7,Regen
9/4/2016 5:00,67,7,60,17,15,Regen
9/4/2016 6:00,45,24,21,17,15,Klarer Himmel
9/4/2016 7:00,33,19,14,17,13,wolkig
9/4/2016 8:00,61,45,16,18,19,wolkig
9/4/2016 9:00,136,101,35,18,15,wolkig
9/4/2016 10:00,222,137,85,19,15,wolkig
9/4/2016 11:00,235,151,84,19,20,Regen
9/4/2016 12:00,189,106,83,19,20,wolkig
9/4/2016 13:00,267,150,117,21,26,teilweise bewölkt
9/4/2016 14:00,332,209,123,22,26,teilweise bewölkt
9/4/2016 15:00,353,212,141,22,33,teilweise bewölkt
9/4/2016 16:00,389,202,187,20,24,wolkig
9/4/2016 17:00,465,207,258,19,32,wolkig
9/4/2016 18:00,347,142,205,19,32,wolkig
9/4/2016 19:00,364,160,204,18,22,wolkig
9/4/2016 20:00,265,99,166,17,20,wolkig
9/4/2016 21:00,156,54,102,16,20,Regen
9/4/2016 22:00,164,43,121,16,20,teilweise bewölkt
9/4/2016 23:00,108,43,65,17,17,wolkig
9/5/2016 0:00,50,19,31,16,15,wolkig
9/5/2016 1:00,30,7,23,16,22,wolkig
9/5/2016 2:00,18,7,11,16,24,wolkig
9/5/2016 3:00,9,3,6,16,24,Regen
9/5/2016 4:00,8,7,1,15,20,wolkig
9/5/2016 5:00,48,22,26,15,20,Regen
9/5/2016 6:00,166,109,57,15,19,Regen
9/5/2016 7:00,677,484,193,15,13,wolkig
9/5/2016 8:00,744,480,264,16,17,teilweise bewölkt
9/5/2016 9:00,684,379,305,17,13,wolkig
9/5/2016 10:00,497,265,232,18,19,wolkig
9/5/2016 11:00,457,245,212,19,15,wolkig
9/5/2016 12:00,594,327,267,20,11,wolkig
9/5/2016 13:00,689,374,315,22,9,wolkig
9/5/2016 14:00,693,316,377,22,13,wolkig
9/5/2016 15:00,746,337,409,22,11,wolkig
9/5/2016 16:00,871,411,460,22,11,teilweise bewölkt
9/5/2016 17:00,1017,489,528,22,11,teilweise bewölkt
9/5/2016 18:00,983,415,568,21,9,teilweise bewölkt
9/5/2016 19:00,731,344,387,19,6,teilweise bewölkt
9/5/2016 20:00,489,209,280,17,0,wolkig
9/5/2016 21:00,388,171,217,15,0,teilweise bewölkt
9/5/2016 22:00,252,82,170,15,0,Klarer Himmel
9/5/2016 23:00,198,56,142,13,2,Nebel
9/6/2016 0:00,82,17,65,13,0,Nebel
9/6/2016 1:00,61,18,43,12,0,Nebel
9/6/2016 2:00,18,8,10,12,0,Nebel
9/6/2016 3:00,12,4,8,11,0,Nebel
9/6/2016 4:00,16,12,4,12,2,Nebel
9/6/2016 5:00,55,32,23,11,0,Nebel
9/6/2016 6:00,183,128,55,11,0,Nebel
9/6/2016 7:00,792,560,232,13,2,Nebel
9/6/2016 8:00,900,539,361,15,2,teilweise bewölkt
9/6/2016 9:00,710,396,314,17,7,teilweise bewölkt
9/6/2016 10:00,560,296,264,20,6,Klarer Himmel
9/6/2016 11:00,565,316,249,22,9,teilweise bewölkt
9/6/2016 12:00,711,390,321,23,11,teilweise bewölkt
9/6/2016 13:00,825,401,424,23,7,teilweise bewölkt
9/6/2016 14:00,777,422,355,24,9,teilweise bewölkt
9/6/2016 15:00,893,417,476,24,7,teilweise bewölkt
9/6/2016 16:00,1036,543,493,25,6,teilweise bewölkt
9/6/2016 17:00,1118,558,560,25,7,Klarer Himmel
9/6/2016 18:00,1093,514,579,24,2,Klarer Himmel
9/6/2016 19:00,867,460,407,19,4,Klarer Himmel
9/6/2016 20:00,712,274,438,18,0,Klarer Himmel
9/6/2016 21:00,472,161,311,16,2,Klarer Himmel
9/6/2016 22:00,407,128,279,15,2,Klarer Himmel
9/6/2016 23:00,225,72,153,14,0,Klarer Himmel
9/7/2016 0:00,131,40,91,13,0,Klarer Himmel
9/7/2016 1:00,86,26,60,13,4,Klarer Himmel
9/7/2016 2:00,22,8,14,15,4,Klarer Himmel
9/7/2016 3:00,14,5,9,15,6,Klarer Himmel
9/7/2016 4:00,21,10,11,14,4,Klarer Himmel
9/7/2016 5:00,72,41,31,13,6,Klarer Himmel
9/7/2016 6:00,200,144,56,13,2,Klarer Himmel
9/7/2016 7:00,794,574,220,14,4,Klarer Himmel
9/7/2016 8:00,937,535,402,16,6,Klarer Himmel
9/7/2016 9:00,792,451,341,18,7,Klarer Himmel
9/7/2016 10:00,646,350,296,20,7,Klarer Himmel
9/7/2016 11:00,646,375,271,23,4,Klarer Himmel
9/7/2016 12:00,819,450,369,25,4,Klarer Himmel
9/7/2016 13:00,769,390,379,25,7,Klarer Himmel
9/7/2016 14:00,808,364,444,26,7,Klarer Himmel
9/7/2016 15:00,879,382,497,26,9,Klarer Himmel
9/7/2016 16:00,1023,557,466,27,6,Klarer Himmel
9/7/2016 17:00,1190,603,587,26,7,Klarer Himmel
9/7/2016 18:00,1054,517,537,25,7,Klarer Himmel
9/7/2016 19:00,912,457,455,23,4,Klarer Himmel
9/7/2016 20:00,652,281,371,19,6,Klarer Himmel
9/7/2016 21:00,479,220,259,18,6,Klarer Himmel
9/7/2016 22:00,406,137,269,16,6,Klarer Himmel
9/7/2016 23:00,266,77,189,18,4,Klarer Himmel
9/8/2016 0:00,218,85,133,16,4,Klarer Himmel
9/8/2016 1:00,130,41,89,14,0,Klarer Himmel
9/8/2016 2:00,63,8,55,14,4,Klarer Himmel
9/8/2016 3:00,60,12,48,16,6,Klarer Himmel
9/8/2016 4:00,59,15,44,16,4,Klarer Himmel
9/8/2016 5:00,87,39,48,14,2,Klarer Himmel
9/8/2016 6:00,196,130,66,13,2,Nebel
9/8/2016 7:00,781,565,216,16,6,Klarer Himmel
9/8/2016 8:00,848,492,356,18,6,Klarer Himmel
9/8/2016 9:00,746,449,297,21,9,Klarer Himmel
9/8/2016 10:00,543,301,242,23,11,Klarer Himmel
9/8/2016 11:00,590,340,250,25,15,Klarer Himmel
9/8/2016 12:00,737,391,346,27,13,Klarer Himmel
9/8/2016 13:00,760,348,412,27,13,Klarer Himmel
9/8/2016 14:00,897,453,444,28,20,Klarer Himmel
9/8/2016 15:00,913,467,446,28,22,Klarer Himmel
9/8/2016 16:00,1005,497,508,28,17,Klarer Himmel
9/8/2016 17:00,1079,562,517,27,22,Klarer Himmel
9/8/2016 18:00,1015,511,504,26,11,Klarer Himmel
9/8/2016 19:00,896,406,490,22,4,Klarer Himmel
9/8/2016 20:00,638,260,378,20,0,Klarer Himmel
9/8/2016 21:00,460,177,283,19,0,Klarer Himmel
9/8/2016 22:00,376,130,246,17,0,Klarer Himmel
9/8/2016 23:00,287,104,183,19,9,Klarer Himmel
9/9/2016 0:00,149,33,116,19,9,Klarer Himmel
9/9/2016 1:00,66,25,41,18,9,teilweise bewölkt
9/9/2016 2:00,29,10,19,18,11,wolkig
9/9/2016 3:00,26,9,17,18,11,wolkig
9/9/2016 4:00,26,18,8,16,7,wolkig
9/9/2016 5:00,52,35,17,17,7,teilweise bewölkt
9/9/2016 6:00,171,120,51,15,6,Nebel
9/9/2016 7:00,737,532,205,16,9,wolkig
9/9/2016 8:00,727,416,311,16,9,wolkig
9/9/2016 9:00,559,350,209,16,7,wolkig
9/9/2016 10:00,495,289,206,18,7,wolkig
9/9/2016 11:00,545,284,261,18,7,wolkig
9/9/2016 12:00,667,377,290,20,9,teilweise bewölkt
9/9/2016 13:00,845,398,447,21,7,teilweise bewölkt
9/9/2016 14:00,856,414,442,23,9,teilweise bewölkt
9/9/2016 15:00,861,412,449,23,7,teilweise bewölkt
9/9/2016 16:00,772,405,367,24,6,teilweise bewölkt
9/9/2016 17:00,810,429,381,23,4,teilweise bewölkt
9/9/2016 18:00,863,412,451,23,6,Klarer Himmel
9/9/2016 19:00,717,340,377,19,4,Klarer Himmel
9/9/2016 20:00,598,296,302,16,0,Nebel
9/9/2016 21:00,386,170,216,15,0,Nebel
9/9/2016 22:00,311,130,181,14,0,Nebel
9/9/2016 23:00,337,137,200,13,0,Nebel
9/10/2016 0:00,230,79,151,12,0,Nebel
9/10/2016 1:00,176,62,114,12,0,Nebel
9/10/2016 2:00,144,37,107,11,0,Nebel
9/10/2016 3:00,85,14,71,10,0,Nebel
9/10/2016 4:00,82,17,65,10,0,Nebel
9/10/2016 5:00,70,22,48,10,0,Nebel
9/10/2016 6:00,60,32,28,10,0,Nebel
9/10/2016 7:00,120,92,28,11,0,Nebel
9/10/2016 8:00,207,140,67,15,0,Klarer Himmel
9/10/2016 9:00,395,299,96,18,4,Klarer Himmel
9/10/2016 10:00,529,364,165,21,2,Klarer Himmel
9/10/2016 11:00,623,409,214,23,4,Klarer Himmel
9/10/2016 12:00,689,386,303,24,6,Klarer Himmel
9/10/2016 13:00,732,356,376,26,7,Klarer Himmel
9/10/2016 14:00,700,340,360,26,9,Klarer Himmel
9/10/2016 15:00,642,287,355,27,11,Klarer Himmel
9/10/2016 16:00,583,301,282,26,11,Klarer Himmel
9/10/2016 17:00,650,307,343,27,11,Klarer Himmel
9/10/2016 18:00,735,371,364,26,7,Klarer Himmel
9/10/2016 19:00,594,326,268,23,6,Klarer Himmel
9/10/2016 20:00,546,267,279,20,4,Klarer Himmel
9/10/2016 21:00,357,160,197,18,4,Klarer Himmel
9/10/2016 22:00,459,158,301,17,0,Klarer Himmel
9/10/2016 23:00,325,127,198,16,0,Klarer Himmel
9/11/2016 0:00,280,107,173,15,0,Klarer Himmel
9/11/2016 1:00,221,79,142,15,0,Klarer Himmel
9/11/2016 2:00,175,42,133,14,0,Klarer Himmel
9/11/2016 3:00,110,33,77,13,0,Nebel
9/11/2016 4:00,74,28,46,13,0,Nebel
9/11/2016 5:00,72,25,47,12,0,Nebel
9/11/2016 6:00,63,26,37,13,2,Nebel
9/11/2016 7:00,74,57,17,13,0,Nebel
9/11/2016 8:00,440,387,53,15,0,Klarer Himmel
9/11/2016 9:00,538,305,233,18,4,Klarer Himmel
9/11/2016 10:00,596,328,268,21,0,Klarer Himmel
9/11/2016 11:00,586,393,193,22,6,Klarer Himmel
9/11/2016 12:00,843,635,208,23,6,Klarer Himmel
9/11/2016 13:00,778,432,346,24,6,wolkig
9/11/2016 14:00,866,371,495,24,6,wolkig
9/11/2016 15:00,737,338,399,24,6,wolkig
9/11/2016 16:00,598,275,323,25,6,wolkig
9/11/2016 17:00,531,236,295,25,6,wolkig
9/11/2016 18:00,579,287,292,24,4,wolkig
9/11/2016 19:00,499,258,241,21,0,Klarer Himmel
9/11/2016 20:00,338,147,191,18,4,Klarer Himmel
9/11/2016 21:00,237,79,158,17,4,Klarer Himmel
9/11/2016 22:00,344,86,258,17,4,Klarer Himmel
9/11/2016 23:00,118,35,83,16,2,Klarer Himmel
9/12/2016 0:00,68,16,52,16,0,Klarer Himmel
9/12/2016 1:00,17,8,9,15,0,Nebel
9/12/2016 2:00,22,7,15,14,0,Nebel
9/12/2016 3:00,6,1,5,14,4,Nebel
9/12/2016 4:00,18,13,5,14,2,Klarer Himmel
9/12/2016 5:00,58,43,15,13,0,Klarer Himmel
9/12/2016 6:00,171,121,50,13,2,Nebel
9/12/2016 7:00,743,539,204,13,2,Klarer Himmel
9/12/2016 8:00,819,469,350,18,0,Klarer Himmel
9/12/2016 9:00,675,364,311,21,7,Klarer Himmel
9/12/2016 10:00,578,335,243,23,6,teilweise bewölkt
9/12/2016 11:00,510,277,233,25,4,Klarer Himmel
9/12/2016 12:00,727,368,359,28,4,Klarer Himmel
9/12/2016 13:00,667,333,334,29,4,Klarer Himmel
9/12/2016 14:00,793,403,390,30,7,Klarer Himmel
9/12/2016 15:00,847,403,444,30,6,Klarer Himmel
9/12/2016 16:00,938,498,440,30,4,Klarer Himmel
9/12/2016 17:00,1073,546,527,31,2,Klarer Himmel
9/12/2016 18:00,1013,498,515,28,6,Klarer Himmel
9/12/2016 19:00,805,393,412,25,0,Klarer Himmel
9/12/2016 20:00,612,280,332,22,0,Klarer Himmel
9/12/2016 21:00,426,173,253,20,0,Klarer Himmel
9/12/2016 22:00,348,97,251,19,0,Klarer Himmel
9/12/2016 23:00,182,49,133,18,0,Klarer Himmel
9/13/2016 0:00,143,28,115,17,0,Klarer Himmel
9/13/2016 1:00,68,17,51,17,0,Klarer Himmel
9/13/2016 2:00,36,8,28,17,0,Klarer Himmel
9/13/2016 3:00,22,2,20,19,4,Nebel
9/13/2016 4:00,19,14,5,18,0,Klarer Himmel
9/13/2016 5:00,54,32,22,16,0,Klarer Himmel
9/13/2016 6:00,183,127,56,18,2,Klarer Himmel
9/13/2016 7:00,769,548,221,19,2,Klarer Himmel
9/13/2016 8:00,873,507,366,22,2,Klarer Himmel
9/13/2016 9:00,752,455,297,23,7,Klarer Himmel
9/13/2016 10:00,584,318,266,25,9,Klarer Himmel
9/13/2016 11:00,540,297,243,28,7,Klarer Himmel
9/13/2016 12:00,750,350,400,30,7,Klarer Himmel
9/13/2016 13:00,767,387,380,31,9,Klarer Himmel
9/13/2016 14:00,850,457,393,32,9,Klarer Himmel
9/13/2016 15:00,909,479,430,33,9,Klarer Himmel
9/13/2016 16:00,927,492,435,33,11,Klarer Himmel
9/13/2016 17:00,1031,497,534,32,6,Klarer Himmel
9/13/2016 18:00,1071,503,568,31,6,Klarer Himmel
9/13/2016 19:00,956,502,454,26,4,Klarer Himmel
9/13/2016 20:00,650,287,363,24,6,Klarer Himmel
9/13/2016 21:00,464,173,291,24,6,Klarer Himmel
9/13/2016 22:00,401,126,275,24,7,Klarer Himmel
9/13/2016 23:00,287,61,226,21,2,Klarer Himmel
9/14/2016 0:00,118,33,85,19,6,Klarer Himmel
9/14/2016 1:00,77,16,61,22,6,Klarer Himmel
9/14/2016 2:00,31,9,22,22,4,Klarer Himmel
9/14/2016 3:00,17,2,15,22,6,Klarer Himmel
9/14/2016 4:00,21,15,6,22,6,Klarer Himmel
9/14/2016 5:00,55,37,18,21,6,Klarer Himmel
9/14/2016 6:00,167,117,50,19,6,Klarer Himmel
9/14/2016 7:00,784,556,228,20,6,Klarer Himmel
9/14/2016 8:00,874,511,363,21,4,Klarer Himmel
9/14/2016 9:00,699,401,298,23,4,Klarer Himmel
9/14/2016 10:00,684,376,308,26,9,Klarer Himmel
9/14/2016 11:00,600,315,285,29,9,Klarer Himmel
9/14/2016 12:00,775,402,373,30,9,Klarer Himmel
9/14/2016 13:00,791,386,405,31,9,Klarer Himmel
9/14/2016 14:00,850,397,453,31,6,Klarer Himmel
9/14/2016 15:00,822,444,378,32,9,Klarer Himmel
9/14/2016 16:00,966,505,461,32,4,Klarer Himmel
9/14/2016 17:00,1026,531,495,31,6,Klarer Himmel
9/14/2016 18:00,1070,523,547,29,4,Klarer Himmel
9/14/2016 19:00,960,489,471,27,6,Klarer Himmel
9/14/2016 20:00,696,317,379,22,6,Klarer Himmel
9/14/2016 21:00,501,204,297,23,7,Klarer Himmel
9/14/2016 22:00,403,148,255,24,7,Klarer Himmel
9/14/2016 23:00,315,120,195,23,6,Klarer Himmel
9/15/2016 0:00,191,65,126,23,9,Klarer Himmel
9/15/2016 1:00,135,35,100,22,7,Klarer Himmel
9/15/2016 2:00,71,5,66,21,9,Klarer Himmel
9/15/2016 3:00,83,12,71,21,7,Klarer Himmel
9/15/2016 4:00,75,16,59,19,7,Klarer Himmel
9/15/2016 5:00,60,29,31,17,6,Klarer Himmel
9/15/2016 6:00,191,124,67,17,7,Klarer Himmel
9/15/2016 7:00,776,561,215,18,4,Klarer Himmel
9/15/2016 8:00,873,530,343,20,6,Klarer Himmel
9/15/2016 9:00,714,440,274,22,9,Klarer Himmel
9/15/2016 10:00,519,270,249,24,11,Klarer Himmel
9/15/2016 11:00,583,308,275,25,11,Klarer Himmel
9/15/2016 12:00,768,353,415,27,11,Klarer Himmel
9/15/2016 13:00,757,393,364,29,13,Klarer Himmel
9/15/2016 14:00,863,442,421,29,13,Klarer Himmel
9/15/2016 15:00,906,452,454,29,17,Klarer Himmel
9/15/2016 16:00,934,474,460,29,13,Klarer Himmel
9/15/2016 17:00,1122,532,590,28,15,Klarer Himmel
9/15/2016 18:00,1038,529,509,26,9,Klarer Himmel
9/15/2016 19:00,887,405,482,24,7,Klarer Himmel
9/15/2016 20:00,635,236,399,23,7,Klarer Himmel
9/15/2016 21:00,483,213,270,24,11,Klarer Himmel
9/15/2016 22:00,487,174,313,23,7,Klarer Himmel
9/15/2016 23:00,301,109,192,21,11,Klarer Himmel
9/16/2016 0:00,158,45,113,22,13,Klarer Himmel
9/16/2016 1:00,82,25,57,20,15,Klarer Himmel
9/16/2016 2:00,43,13,30,20,11,Klarer Himmel
9/16/2016 3:00,20,11,9,19,15,Regen
9/16/2016 4:00,26,12,14,18,19,Regen
9/16/2016 5:00,38,21,17,16,13,Regen
9/16/2016 6:00,147,99,48,16,7,wolkig
9/16/2016 7:00,648,464,184,15,6,wolkig
9/16/2016 8:00,697,406,291,16,6,
9/16/2016 9:00,567,353,214,18,9,wolkig
9/16/2016 10:00,495,279,216,18,11,wolkig
9/16/2016 11:00,534,299,235,19,15,wolkig
9/16/2016 12:00,630,331,299,20,17,teilweise bewölkt
9/16/2016 13:00,699,347,352,21,15,wolkig
9/16/2016 14:00,806,426,380,22,17,wolkig
9/16/2016 15:00,802,396,406,22,17,wolkig
9/16/2016 16:00,745,373,372,21,13,wolkig
9/16/2016 17:00,790,372,418,21,7,wolkig
9/16/2016 18:00,777,355,422,20,7,wolkig
9/16/2016 19:00,747,403,344,19,6,wolkig
9/16/2016 20:00,496,225,271,17,6,Klarer Himmel
9/16/2016 21:00,406,214,192,17,4,Klarer Himmel
9/16/2016 22:00,353,134,219,16,2,Klarer Himmel
9/16/2016 23:00,295,108,187,16,2,Klarer Himmel
9/17/2016 0:00,233,93,140,16,0,Klarer Himmel
9/17/2016 1:00,212,74,138,15,4,Klarer Himmel
9/17/2016 2:00,180,49,131,15,0,Klarer Himmel
9/17/2016 3:00,139,40,99,15,0,Klarer Himmel
9/17/2016 4:00,86,23,63,14,0,Klarer Himmel
9/17/2016 5:00,83,39,44,14,0,Klarer Himmel
9/17/2016 6:00,88,48,40,14,0,Klarer Himmel
9/17/2016 7:00,139,120,19,14,0,Nebel
9/17/2016 8:00,293,235,58,15,0,wolkig
9/17/2016 9:00,482,371,111,17,2,Klarer Himmel
9/17/2016 10:00,554,367,187,18,7,Klarer Himmel
9/17/2016 11:00,634,430,204,18,7,Regen
9/17/2016 12:00,689,392,297,18,11,Regen
9/17/2016 13:00,680,385,295,19,11,Regen
9/17/2016 14:00,631,323,308,19,9,Regen
9/17/2016 15:00,579,226,353,19,9,Regen
9/17/2016 16:00,619,238,381,19,11,wolkig
9/17/2016 17:00,538,195,343,19,7,wolkig
9/17/2016 18:00,584,287,297,19,6,wolkig
9/17/2016 19:00,457,235,222,19,2,wolkig
9/17/2016 20:00,383,180,203,18,7,Klarer Himmel
9/17/2016 21:00,313,155,158,18,9,wolkig
9/17/2016 22:00,216,94,122,18,13,Klarer Himmel
9/17/2016 23:00,287,114,173,17,7,Klarer Himmel
9/18/2016 0:00,248,109,139,17,15,Klarer Himmel
9/18/2016 1:00,190,60,130,16,11,wolkig
9/18/2016 2:00,164,46,118,16,19,wolkig
9/18/2016 3:00,130,30,100,16,17,wolkig
9/18/2016 4:00,95,18,77,16,17,wolkig
9/18/2016 5:00,41,10,31,16,15,wolkig
9/18/2016 6:00,48,29,19,15,11,wolkig
9/18/2016 7:00,54,33,21,15,11,wolkig
9/18/2016 8:00,73,52,21,14,17,wolkig
9/18/2016 9:00,190,139,51,15,17,
9/18/2016 10:00,314,234,80,16,15,wolkig
9/18/2016 11:00,330,186,144,17,17,teilweise bewölkt
9/18/2016 12:00,388,205,183,19,9,teilweise bewölkt
9/18/2016 13:00,422,218,204,19,13,teilweise bewölkt
9/18/2016 14:00,445,241,204,19,13,teilweise bewölkt
9/18/2016 15:00,451,226,225,19,19,teilweise bewölkt
9/18/2016 16:00,488,214,274,20,15,Klarer Himmel
9/18/2016 17:00,465,209,256,19,11,Klarer Himmel
9/18/2016 18:00,490,240,250,18,11,Klarer Himmel
9/18/2016 19:00,465,215,250,18,13,Klarer Himmel
9/18/2016 20:00,329,125,204,17,11,Klarer Himmel
9/18/2016 21:00,191,64,127,17,13,Klarer Himmel
9/18/2016 22:00,165,53,112,16,11,Klarer Himmel
9/18/2016 23:00,123,43,80,16,11,Klarer Himmel
9/19/2016 0:00,59,13,46,15,11,Klarer Himmel
9/19/2016 1:00,30,13,17,15,9,Klarer Himmel
9/19/2016 2:00,15,1,14,15,9,Klarer Himmel
9/19/2016 3:00,11,8,3,15,9,Klarer Himmel
9/19/2016 4:00,7,7,0,14,9,Klarer Himmel
9/19/2016 5:00,49,28,21,14,11,Klarer Himmel
9/19/2016 6:00,165,114,51,14,15,Klarer Himmel
9/19/2016 7:00,715,534,181,12,13,Klarer Himmel
9/19/2016 8:00,816,455,361,14,11,Klarer Himmel
9/19/2016 9:00,646,355,291,15,19,Klarer Himmel
9/19/2016 10:00,547,282,265,16,17,Klarer Himmel
9/19/2016 11:00,530,309,221,16,15,teilweise bewölkt
9/19/2016 12:00,592,325,267,17,9,teilweise bewölkt
9/19/2016 13:00,715,348,367,17,6,teilweise bewölkt
9/19/2016 14:00,716,354,362,18,9,teilweise bewölkt
9/19/2016 15:00,828,403,425,18,6,wolkig
9/19/2016 16:00,931,455,476,18,4,wolkig
9/19/2016 17:00,1052,486,566,17,2,wolkig
9/19/2016 18:00,1011,469,542,17,9,teilweise bewölkt
9/19/2016 19:00,731,342,389,16,4,teilweise bewölkt
9/19/2016 20:00,541,215,326,15,0,teilweise bewölkt
9/19/2016 21:00,352,154,198,14,0,Klarer Himmel
9/19/2016 22:00,262,108,154,14,0,Klarer Himmel
9/19/2016 23:00,211,52,159,14,0,Klarer Himmel
9/20/2016 0:00,131,21,110,14,4,Klarer Himmel
9/20/2016 1:00,60,13,47,14,0,Klarer Himmel
9/20/2016 2:00,39,17,22,13,0,Klarer Himmel
9/20/2016 3:00,8,1,7,13,0,Klarer Himmel
9/20/2016 4:00,18,10,8,13,0,Klarer Himmel
9/20/2016 5:00,56,41,15,13,0,wolkig
9/20/2016 6:00,175,129,46,13,0,Klarer Himmel
9/20/2016 7:00,725,498,227,13,0,Klarer Himmel
9/20/2016 8:00,871,493,378,14,0,Klarer Himmel
9/20/2016 9:00,688,407,281,14,4,Klarer Himmel
9/20/2016 10:00,513,267,246,15,4,Klarer Himmel
9/20/2016 11:00,558,309,249,16,6,Klarer Himmel
9/20/2016 12:00,614,323,291,17,7,wolkig
9/20/2016 13:00,709,352,357,18,9,wolkig
9/20/2016 14:00,796,435,361,18,9,wolkig
9/20/2016 15:00,796,387,409,18,6,wolkig
9/20/2016 16:00,962,466,496,19,0,wolkig
9/20/2016 17:00,1111,545,566,18,2,wolkig
9/20/2016 18:00,1087,498,589,17,0,Klarer Himmel
9/20/2016 19:00,843,390,453,16,0,Klarer Himmel
9/20/2016 20:00,509,237,272,16,4,Klarer Himmel
9/20/2016 21:00,359,164,195,15,6,Klarer Himmel
9/20/2016 22:00,408,134,274,14,4,Klarer Himmel
9/20/2016 23:00,264,72,192,13,4,Klarer Himmel
9/21/2016 0:00,146,27,119,11,2,Klarer Himmel
9/21/2016 1:00,85,17,68,9,0,Klarer Himmel
9/21/2016 2:00,34,5,29,8,0,Klarer Himmel
9/21/2016 3:00,17,4,13,7,0,Klarer Himmel
9/21/2016 4:00,21,13,8,7,0,Nebel
9/21/2016 5:00,55,40,15,6,0,Nebel
9/21/2016 6:00,166,123,43,6,0,Nebel
9/21/2016 7:00,761,568,193,6,0,Nebel
9/21/2016 8:00,870,517,353,10,0,Klarer Himmel
9/21/2016 9:00,780,462,318,14,2,Klarer Himmel
9/21/2016 10:00,625,357,268,17,4,wolkig
9/21/2016 11:00,716,454,262,18,7,wolkig
9/21/2016 12:00,749,389,360,19,9,Klarer Himmel
9/21/2016 13:00,762,361,401,19,7,Klarer Himmel
9/21/2016 14:00,821,363,458,20,7,Klarer Himmel
9/21/2016 15:00,888,465,423,21,7,Klarer Himmel
9/21/2016 16:00,990,493,497,20,6,Klarer Himmel
9/21/2016 17:00,1125,551,574,20,6,Klarer Himmel
9/21/2016 18:00,963,450,513,18,4,Klarer Himmel
9/21/2016 19:00,882,441,441,15,6,Klarer Himmel
9/21/2016 20:00,601,269,332,12,0,Klarer Himmel
9/21/2016 21:00,435,180,255,11,4,Klarer Himmel
9/21/2016 22:00,429,144,285,10,0,Klarer Himmel
9/21/2016 23:00,308,138,170,10,4,Klarer Himmel
9/22/2016 0:00,232,107,125,8,0,Klarer Himmel
9/22/2016 1:00,118,42,76,8,0,Klarer Himmel
9/22/2016 2:00,92,17,75,8,0,Klarer Himmel
9/22/2016 3:00,73,5,68,8,4,Klarer Himmel
9/22/2016 4:00,46,16,30,8,2,Klarer Himmel
9/22/2016 5:00,63,37,26,7,2,
9/22/2016 6:00,172,117,55,7,4,Nebel
9/22/2016 7:00,773,560,213,8,2,Nebel
9/22/2016 8:00,845,492,353,9,2,Klarer Himmel
9/22/2016 9:00,676,417,259,13,6,Klarer Himmel
9/22/2016 10:00,533,302,231,16,7,Klarer Himmel
9/22/2016 11:00,610,369,241,18,9,Klarer Himmel
9/22/2016 12:00,672,347,325,20,13,Klarer Himmel
9/22/2016 13:00,709,343,366,20,9,Klarer Himmel
9/22/2016 14:00,754,399,355,21,11,Klarer Himmel
9/22/2016 15:00,812,415,397,22,9,Klarer Himmel
9/22/2016 16:00,1032,513,519,21,9,Klarer Himmel
9/22/2016 17:00,1066,531,535,20,9,Klarer Himmel
9/22/2016 18:00,1013,505,508,17,2,Klarer Himmel
9/22/2016 19:00,821,344,477,16,0,Klarer Himmel
9/22/2016 20:00,590,228,362,13,0,Klarer Himmel
9/22/2016 21:00,380,144,236,13,0,Klarer Himmel
9/22/2016 22:00,331,115,216,12,0,Klarer Himmel
9/22/2016 23:00,211,62,149,12,0,Klarer Himmel
9/23/2016 0:00,124,38,86,11,0,Klarer Himmel
9/23/2016 1:00,81,24,57,10,0,
9/23/2016 2:00,40,6,34,9,0,Nebel
9/23/2016 3:00,28,6,22,9,0,Nebel
9/23/2016 4:00,25,11,14,9,0,Nebel
9/23/2016 5:00,56,33,23,10,2,Nebel
9/23/2016 6:00,150,102,48,9,2,Nebel
9/23/2016 7:00,660,477,183,9,0,Nebel
9/23/2016 8:00,766,485,281,11,6,Klarer Himmel
9/23/2016 9:00,637,397,240,14,6,Klarer Himmel
9/23/2016 10:00,501,308,193,15,4,Regen
9/23/2016 11:00,591,333,258,16,2,wolkig
9/23/2016 12:00,637,333,304,19,11,teilweise bewölkt
9/23/2016 13:00,764,379,385,21,13,teilweise bewölkt
9/23/2016 14:00,755,347,408,21,17,teilweise bewölkt
9/23/2016 15:00,856,429,427,20,15,teilweise bewölkt
9/23/2016 16:00,798,419,379,21,13,teilweise bewölkt
9/23/2016 17:00,792,412,380,21,19,teilweise bewölkt
9/23/2016 18:00,708,380,328,19,17,teilweise bewölkt
9/23/2016 19:00,696,335,361,16,6,Klarer Himmel
9/23/2016 20:00,556,306,250,13,2,Klarer Himmel
9/23/2016 21:00,368,158,210,11,0,Klarer Himmel
9/23/2016 22:00,274,107,167,10,0,Klarer Himmel
9/23/2016 23:00,260,102,158,9,0,Nebel
9/24/2016 0:00,253,98,155,8,0,Nebel
9/24/2016 1:00,231,74,157,7,0,Nebel
9/24/2016 2:00,140,28,112,7,0,Nebel
9/24/2016 3:00,117,19,98,7,0,Nebel
9/24/2016 4:00,89,10,79,7,4,Nebel
9/24/2016 5:00,68,24,44,7,2,Nebel
9/24/2016 6:00,52,28,24,8,6,Nebel
9/24/2016 7:00,87,57,30,9,4,Klarer Himmel
9/24/2016 8:00,198,134,64,10,6,teilweise bewölkt
9/24/2016 9:00,372,290,82,12,6,teilweise bewölkt
9/24/2016 10:00,511,360,151,15,9,Klarer Himmel
9/24/2016 11:00,671,439,232,18,11,Klarer Himmel
9/24/2016 12:00,766,485,281,21,11,
9/24/2016 13:00,697,429,268,23,15,Klarer Himmel
9/24/2016 14:00,690,328,362,23,15,Klarer Himmel
9/24/2016 15:00,577,251,326,24,9,Klarer Himmel
9/24/2016 16:00,615,237,378,23,9,Klarer Himmel
9/24/2016 17:00,591,270,321,23,7,Klarer Himmel
9/24/2016 18:00,641,294,347,19,4,Klarer Himmel
9/24/2016 19:00,583,275,308,15,2,Klarer Himmel
9/24/2016 20:00,430,213,217,13,0,Klarer Himmel
9/24/2016 21:00,309,189,120,13,4,Klarer Himmel
9/24/2016 22:00,256,119,137,15,7,Klarer Himmel
9/24/2016 23:00,298,142,156,14,6,Klarer Himmel
9/25/2016 0:00,258,109,149,12,6,Klarer Himmel
9/25/2016 1:00,243,78,165,12,4,Klarer Himmel
9/25/2016 2:00,138,26,112,12,4,Klarer Himmel
9/25/2016 3:00,154,27,127,12,6,Klarer Himmel
9/25/2016 4:00,86,25,61,11,7,Klarer Himmel
9/25/2016 5:00,55,16,39,11,7,Klarer Himmel
9/25/2016 6:00,67,27,40,10,4,Klarer Himmel
9/25/2016 7:00,43,27,16,10,7,Klarer Himmel
9/25/2016 8:00,80,61,19,12,7,Klarer Himmel
9/25/2016 9:00,225,162,63,15,13,Klarer Himmel
9/25/2016 10:00,353,244,109,18,15,Klarer Himmel
9/25/2016 11:00,466,269,197,22,11,Klarer Himmel
9/25/2016 12:00,610,333,277,23,13,Klarer Himmel
9/25/2016 13:00,635,376,259,25,17,Klarer Himmel
9/25/2016 14:00,741,426,315,26,11,Klarer Himmel
9/25/2016 15:00,717,429,288,27,13,Klarer Himmel
9/25/2016 16:00,638,305,333,27,20,Klarer Himmel
9/25/2016 17:00,632,296,336,26,13,Klarer Himmel
9/25/2016 18:00,647,295,352,22,6,Klarer Himmel
9/25/2016 19:00,528,248,280,18,0,Klarer Himmel
9/25/2016 20:00,377,144,233,21,24,Klarer Himmel
9/25/2016 21:00,161,63,98,18,20,Klarer Himmel
9/25/2016 22:00,251,60,191,17,11,Klarer Himmel
9/25/2016 23:00,121,46,75,17,9,Klarer Himmel
9/26/2016 0:00,70,20,50,16,11,Klarer Himmel
9/26/2016 1:00,24,7,17,15,7,Klarer Himmel
9/26/2016 2:00,12,8,4,14,6,wolkig
9/26/2016 3:00,9,3,6,14,4,wolkig
9/26/2016 4:00,14,10,4,14,4,wolkig
9/26/2016 5:00,53,40,13,14,6,Klarer Himmel
9/26/2016 6:00,145,96,49,13,6,Klarer Himmel
9/26/2016 7:00,805,581,224,12,4,Nebel
9/26/2016 8:00,819,474,345,13,0,Klarer Himmel
9/26/2016 9:00,709,409,300,14,6,Klarer Himmel
9/26/2016 10:00,682,363,319,17,4,Klarer Himmel
9/26/2016 11:00,576,324,252,19,7,Klarer Himmel
9/26/2016 12:00,653,350,303,20,2,
9/26/2016 13:00,782,395,387,20,7,teilweise bewölkt
9/26/2016 14:00,744,382,362,21,7,Klarer Himmel
9/26/2016 15:00,826,439,387,21,7,Klarer Himmel
9/26/2016 16:00,977,494,483,21,6,Klarer Himmel
9/26/2016 17:00,1084,519,565,20,7,Klarer Himmel
9/26/2016 18:00,1051,496,555,16,0,Klarer Himmel
9/26/2016 19:00,801,362,439,15,4,Klarer Himmel
9/26/2016 20:00,517,207,310,15,2,Klarer Himmel
9/26/2016 21:00,316,149,167,13,0,Klarer Himmel
9/26/2016 22:00,306,107,199,11,0,Klarer Himmel
9/26/2016 23:00,252,67,185,10,0,Klarer Himmel
9/27/2016 0:00,133,32,101,10,0,Klarer Himmel
9/27/2016 1:00,99,21,78,10,0,Klarer Himmel
9/27/2016 2:00,50,18,32,9,0,Klarer Himmel
9/27/2016 3:00,16,5,11,9,0,Klarer Himmel
9/27/2016 4:00,17,10,7,8,4,Klarer Himmel
9/27/2016 5:00,54,39,15,8,0,Nebel
9/27/2016 6:00,162,119,43,7,0,
9/27/2016 7:00,753,542,211,7,0,
9/27/2016 8:00,948,543,405,9,0,Klarer Himmel
9/27/2016 9:00,776,447,329,14,0,Klarer Himmel
9/27/2016 10:00,582,335,247,16,7,Klarer Himmel
9/27/2016 11:00,606,331,275,19,6,teilweise bewölkt
9/27/2016 12:00,767,384,383,20,7,teilweise bewölkt
9/27/2016 13:00,865,497,368,21,9,teilweise bewölkt
9/27/2016 14:00,837,468,369,22,11,teilweise bewölkt
9/27/2016 15:00,847,422,425,22,13,Klarer Himmel
9/27/2016 16:00,1035,512,523,22,11,Klarer Himmel
9/27/2016 17:00,1185,540,645,22,13,Klarer Himmel
9/27/2016 18:00,1120,483,637,20,7,Klarer Himmel
9/27/2016 19:00,1006,539,467,14,6,Klarer Himmel
9/27/2016 20:00,650,327,323,13,2,Klarer Himmel
9/27/2016 21:00,457,171,286,12,0,Klarer Himmel
9/27/2016 22:00,405,141,264,12,7,Klarer Himmel
9/27/2016 23:00,365,90,275,13,7,Klarer Himmel
9/28/2016 0:00,147,47,100,13,7,Klarer Himmel
9/28/2016 1:00,89,28,61,13,7,Klarer Himmel
9/28/2016 2:00,60,11,49,14,11,wolkig
9/28/2016 3:00,18,7,11,15,13,wolkig
9/28/2016 4:00,19,13,6,15,11,wolkig
9/28/2016 5:00,59,46,13,15,17,teilweise bewölkt
9/28/2016 6:00,162,114,48,15,11,wolkig
9/28/2016 7:00,734,524,210,16,13,teilweise bewölkt
9/28/2016 8:00,948,548,400,16,19,wolkig
9/28/2016 9:00,872,508,364,17,19,wolkig
9/28/2016 10:00,657,376,281,18,24,wolkig
9/28/2016 11:00,683,431,252,19,26,wolkig
9/28/2016 12:00,776,399,377,20,28,wolkig
9/28/2016 13:00,780,406,374,20,32,wolkig
9/28/2016 14:00,797,406,391,21,24,wolkig
9/28/2016 15:00,917,437,480,21,24,wolkig
9/28/2016 16:00,971,518,453,21,28,Klarer Himmel
9/28/2016 17:00,1091,541,550,22,26,Klarer Himmel
9/28/2016 18:00,1084,511,573,21,19,Klarer Himmel
9/28/2016 19:00,946,495,451,20,19,Klarer Himmel
9/28/2016 20:00,637,289,348,20,13,wolkig
9/28/2016 21:00,450,203,247,20,13,wolkig
9/28/2016 22:00,408,176,232,19,15,Klarer Himmel
9/28/2016 23:00,306,135,171,19,17,wolkig
9/29/2016 0:00,245,98,147,19,19,wolkig
9/29/2016 1:00,201,36,165,19,17,wolkig
9/29/2016 2:00,130,31,99,19,22,wolkig
9/29/2016 3:00,109,12,97,19,20,Klarer Himmel
9/29/2016 4:00,84,22,62,18,20,wolkig
9/29/2016 5:00,73,37,36,18,20,wolkig
9/29/2016 6:00,188,127,61,18,20,wolkig
9/29/2016 7:00,738,516,222,17,20,Klarer Himmel
9/29/2016 8:00,881,533,348,18,22,Klarer Himmel
9/29/2016 9:00,833,474,359,18,20,Klarer Himmel
9/29/2016 10:00,677,381,296,20,26,wolkig
9/29/2016 11:00,597,320,277,20,30,wolkig
9/29/2016 12:00,682,374,308,21,37,wolkig
9/29/2016 13:00,803,401,402,21,33,wolkig
9/29/2016 14:00,891,458,433,20,28,wolkig
9/29/2016 15:00,943,485,458,21,32,wolkig
9/29/2016 16:00,943,462,481,20,28,wolkig
9/29/2016 17:00,1021,473,548,20,33,wolkig
9/29/2016 18:00,974,472,502,20,30,wolkig
9/29/2016 19:00,695,313,382,19,26,wolkig
9/29/2016 20:00,493,221,272,18,39,Regen
9/29/2016 21:00,357,164,193,16,26,Regen
9/29/2016 22:00,278,109,169,15,19,wolkig
9/29/2016 23:00,219,84,135,15,19,Regen
9/30/2016 0:00,121,39,82,15,15,Regen
9/30/2016 1:00,82,19,63,15,13,wolkig
9/30/2016 2:00,40,10,30,14,13,wolkig
9/30/2016 3:00,44,9,35,14,7,wolkig
9/30/2016 4:00,34,13,21,14,9,wolkig
9/30/2016 5:00,53,28,25,14,9,wolkig
9/30/2016 6:00,151,98,53,14,9,wolkig
9/30/2016 7:00,662,490,172,13,7,
9/30/2016 8:00,704,442,262,14,9,wolkig
9/30/2016 9:00,613,343,270,15,15,wolkig
9/30/2016 10:00,562,315,247,15,15,wolkig
9/30/2016 11:00,615,350,265,16,17,wolkig
9/30/2016 12:00,659,353,306,16,20,wolkig
9/30/2016 13:00,828,435,393,17,24,wolkig
9/30/2016 14:00,747,397,350,18,24,wolkig
9/30/2016 15:00,772,387,385,19,24,teilweise bewölkt
9/30/2016 16:00,715,358,357,18,28,Klarer Himmel
9/30/2016 17:00,810,379,431,18,17,Klarer Himmel
9/30/2016 18:00,771,358,413,17,9,Klarer Himmel
9/30/2016 19:00,644,291,353,13,7,Klarer Himmel
9/30/2016 20:00,489,232,257,11,2,Klarer Himmel
9/30/2016 21:00,337,151,186,9,0,Klarer Himmel
9/30/2016 22:00,275,95,180,8,0,Klarer Himmel
9/30/2016 23:00,307,134,173,9,4,Klarer Himmel
10/1/2016 0:00,266,112,154,9,2,Klarer Himmel
10/1/2016 1:00,222,87,135,10,4,Klarer Himmel
10/1/2016 2:00,124,46,78,10,6,Klarer Himmel
10/1/2016 3:00,112,44,68,10,6,Regen
10/1/2016 4:00,97,28,69,10,2,Regen
10/1/2016 5:00,94,35,59,10,4,wolkig
10/1/2016 6:00,58,37,21,11,2,wolkig
10/1/2016 7:00,78,63,15,11,6,wolkig
10/1/2016 8:00,149,108,41,11,6,wolkig
10/1/2016 9:00,325,246,79,12,6,wolkig
10/1/2016 10:00,400,271,129,13,7,Regen
10/1/2016 11:00,428,296,132,14,7,Regen
10/1/2016 12:00,638,364,274,15,11,wolkig
10/1/2016 13:00,551,326,225,16,7,wolkig
10/1/2016 14:00,516,259,257,16,6,wolkig
10/1/2016 15:00,511,268,243,16,6,wolkig
10/1/2016 16:00,519,249,270,16,7,wolkig
10/1/2016 17:00,579,284,295,16,7,wolkig
10/1/2016 18:00,489,206,283,16,7,wolkig
10/1/2016 19:00,464,212,252,13,6,teilweise bewölkt
10/1/2016 20:00,336,182,154,12,7,Klarer Himmel
10/1/2016 21:00,280,142,138,11,4,wolkig
10/1/2016 22:00,156,56,100,11,6,Regen
10/1/2016 23:00,210,87,123,11,7,wolkig
10/2/2016 0:00,145,46,99,11,7,Regen
10/2/2016 1:00,153,47,106,11,7,
10/2/2016 2:00,88,29,59,11,13,
10/2/2016 3:00,94,21,73,11,11,Klarer Himmel
10/2/2016 4:00,64,11,53,10,11,Klarer Himmel
10/2/2016 5:00,40,8,32,10,6,Klarer Himmel
10/2/2016 6:00,43,17,26,9,9,Klarer Himmel
10/2/2016 7:00,42,32,10,9,11,teilweise bewölkt
10/2/2016 8:00,61,38,23,11,11,teilweise bewölkt
10/2/2016 9:00,194,152,42,12,17,teilweise bewölkt
10/2/2016 10:00,217,146,71,13,19,wolkig
10/2/2016 11:00,303,192,111,12,17,Regen
10/2/2016 12:00,203,90,113,12,17,wolkig
10/2/2016 13:00,263,153,110,12,13,wolkig
10/2/2016 14:00,293,144,149,13,19,wolkig
10/2/2016 15:00,430,226,204,14,15,wolkig
10/2/2016 16:00,426,263,163,14,17,wolkig
10/2/2016 17:00,484,269,215,14,17,Regen
10/2/2016 18:00,403,197,206,12,17,Regen
10/2/2016 19:00,308,169,139,12,15,wolkig
10/2/2016 20:00,213,109,104,12,13,Regen
10/2/2016 21:00,204,97,107,12,13,Regen
10/2/2016 22:00,117,42,75,12,13,wolkig
10/2/2016 23:00,150,63,87,13,11,Regen
10/3/2016 0:00,94,44,50,12,13,wolkig
10/3/2016 1:00,72,27,45,11,17,wolkig
10/3/2016 2:00,67,24,43,9,9,teilweise bewölkt
10/3/2016 3:00,32,11,21,9,6,wolkig
10/3/2016 4:00,27,15,12,10,6,wolkig
10/3/2016 5:00,42,16,26,10,4,wolkig
10/3/2016 6:00,37,26,11,10,9,wolkig
10/3/2016 7:00,331,266,65,10,0,Nebel
10/3/2016 8:00,309,223,86,11,2,wolkig
10/3/2016 9:00,547,415,132,11,4,wolkig
10/3/2016 10:00,524,399,125,12,9,wolkig
10/3/2016 11:00,833,633,200,13,9,wolkig
10/3/2016 12:00,808,622,186,15,9,teilweise bewölkt
10/3/2016 13:00,1102,779,323,16,11,teilweise bewölkt
10/3/2016 14:00,962,653,309,16,7,wolkig
10/3/2016 15:00,1043,658,385,14,2,Regen
10/3/2016 16:00,624,312,312,13,7,Regen
10/3/2016 17:00,433,209,224,13,4,wolkig
10/3/2016 18:00,383,211,172,13,2,Regen
10/3/2016 19:00,285,158,127,12,2,Nebel
10/3/2016 20:00,220,97,123,10,6,Nebel
10/3/2016 21:00,205,63,142,9,4,Nebel
10/3/2016 22:00,157,51,106,9,0,Nebel
10/3/2016 23:00,102,36,66,10,0,Nebel
10/4/2016 0:00,44,12,32,11,9,wolkig
10/4/2016 1:00,23,13,10,10,2,wolkig
10/4/2016 2:00,7,3,4,11,17,wolkig
10/4/2016 3:00,7,2,5,11,17,wolkig
10/4/2016 4:00,17,14,3,11,11,wolkig
10/4/2016 5:00,39,27,12,12,15,wolkig
10/4/2016 6:00,154,114,40,11,9,wolkig
10/4/2016 7:00,666,452,214,11,4,teilweise bewölkt
10/4/2016 8:00,862,503,359,11,6,teilweise bewölkt
10/4/2016 9:00,864,458,406,12,17,wolkig
10/4/2016 10:00,665,417,248,12,11,wolkig
10/4/2016 11:00,638,371,267,14,9,wolkig
10/4/2016 12:00,793,390,403,15,17,teilweise bewölkt
10/4/2016 13:00,782,351,431,15,13,teilweise bewölkt
10/4/2016 14:00,1063,439,624,16,15,teilweise bewölkt
10/4/2016 15:00,1134,573,561,17,15,teilweise bewölkt
10/4/2016 16:00,1163,591,572,16,15,teilweise bewölkt
10/4/2016 17:00,1152,572,580,15,11,teilweise bewölkt
10/4/2016 18:00,1105,536,569,14,7,teilweise bewölkt
10/4/2016 19:00,969,510,459,12,7,teilweise bewölkt
10/4/2016 20:00,591,255,336,9,0,Klarer Himmel
10/4/2016 21:00,406,190,216,9,6,Klarer Himmel
10/4/2016 22:00,366,130,236,10,13,Klarer Himmel
10/4/2016 23:00,263,95,168,10,11,Klarer Himmel
10/5/2016 0:00,169,45,124,10,7,Klarer Himmel
10/5/2016 1:00,149,19,130,9,11,Klarer Himmel
10/5/2016 2:00,101,11,90,8,11,Klarer Himmel
10/5/2016 3:00,37,5,32,8,7,Klarer Himmel
10/5/2016 4:00,28,15,13,7,11,Klarer Himmel
10/5/2016 5:00,44,36,8,7,9,Klarer Himmel
10/5/2016 6:00,175,122,53,6,9,Klarer Himmel
10/5/2016 7:00,767,555,212,5,6,Klarer Himmel
10/5/2016 8:00,926,525,401,7,15,Klarer Himmel
10/5/2016 9:00,830,468,362,8,13,Klarer Himmel
10/5/2016 10:00,841,439,402,9,17,teilweise bewölkt
10/5/2016 11:00,813,453,360,,,
10/5/2016 12:00,838,501,337,12,11,teilweise bewölkt
10/5/2016 13:00,896,476,420,13,17,teilweise bewölkt
10/5/2016 14:00,867,435,432,13,24,
10/5/2016 15:00,978,496,482,12,15,Klarer Himmel
10/5/2016 16:00,1031,539,492,13,17,Klarer Himmel
10/5/2016 17:00,1221,600,621,12,20,Klarer Himmel
10/5/2016 18:00,1046,515,531,10,11,Klarer Himmel
10/5/2016 19:00,1000,513,487,8,9,Klarer Himmel
10/5/2016 20:00,692,369,323,7,9,Klarer Himmel
10/5/2016 21:00,444,205,239,8,13,Klarer Himmel
10/5/2016 22:00,382,167,215,6,7,Klarer Himmel
10/5/2016 23:00,361,139,222,6,11,Klarer Himmel
10/6/2016 0:00,226,72,154,5,2,teilweise bewölkt
10/6/2016 1:00,171,46,125,4,7,Klarer Himmel
10/6/2016 2:00,151,20,131,6,15,Klarer Himmel
10/6/2016 3:00,108,7,101,6,13,wolkig
10/6/2016 4:00,53,12,41,7,9,wolkig
10/6/2016 5:00,86,43,43,7,11,wolkig
10/6/2016 6:00,159,103,56,8,13,wolkig
10/6/2016 7:00,620,444,176,8,13,wolkig
10/6/2016 8:00,876,514,362,8,13,wolkig
10/6/2016 9:00,722,353,369,8,19,wolkig
10/6/2016 10:00,711,364,347,9,19,wolkig
10/6/2016 11:00,537,301,236,9,13,Regen
10/6/2016 12:00,700,357,343,10,15,wolkig
10/6/2016 13:00,809,454,355,11,17,wolkig
10/6/2016 14:00,876,472,404,11,17,wolkig
10/6/2016 15:00,1027,570,457,11,17,wolkig
10/6/2016 16:00,1080,615,465,11,19,wolkig
10/6/2016 17:00,1070,591,479,11,22,wolkig
10/6/2016 18:00,959,472,487,10,15,wolkig
10/6/2016 19:00,745,373,372,10,19,wolkig
10/6/2016 20:00,422,183,239,11,19,wolkig
10/6/2016 21:00,305,113,192,10,19,wolkig
10/6/2016 22:00,256,87,169,10,15,wolkig
10/6/2016 23:00,231,60,171,10,17,wolkig
10/7/2016 0:00,216,32,184,10,19,wolkig
10/7/2016 1:00,162,16,146,10,20,wolkig
10/7/2016 2:00,83,9,74,10,22,wolkig
10/7/2016 3:00,25,7,18,10,17,wolkig
10/7/2016 4:00,17,15,2,10,19,wolkig
10/7/2016 5:00,52,37,15,10,11,wolkig
10/7/2016 6:00,177,117,60,10,15,wolkig
10/7/2016 7:00,699,464,235,10,15,wolkig
10/7/2016 8:00,760,454,306,10,11,wolkig
10/7/2016 9:00,692,407,285,11,15,wolkig
10/7/2016 10:00,508,297,211,11,13,wolkig
10/7/2016 11:00,588,347,241,12,9,wolkig
10/7/2016 12:00,688,369,319,13,11,wolkig
10/7/2016 13:00,807,413,394,14,15,teilweise bewölkt
10/7/2016 14:00,797,396,401,13,15,teilweise bewölkt
10/7/2016 15:00,811,443,368,13,17,wolkig
10/7/2016 16:00,764,413,351,14,15,wolkig
10/7/2016 17:00,870,471,399,13,19,wolkig
10/7/2016 18:00,746,367,379,12,17,wolkig
10/7/2016 19:00,611,329,282,12,11,wolkig
10/7/2016 20:00,495,265,230,12,17,wolkig
10/7/2016 21:00,310,167,143,11,11,Regen
10/7/2016 22:00,265,107,158,11,13,wolkig
10/7/2016 23:00,219,88,131,11,15,Regen
10/8/2016 0:00,247,81,166,10,11,wolkig
10/8/2016 1:00,219,90,129,10,11,wolkig
10/8/2016 2:00,139,31,108,10,11,wolkig
10/8/2016 3:00,94,20,74,8,7,Klarer Himmel
10/8/2016 4:00,71,20,51,7,4,Klarer Himmel
10/8/2016 5:00,64,13,51,6,2,Nebel
10/8/2016 6:00,57,31,26,5,4,Nebel
10/8/2016 7:00,82,58,24,6,0,Nebel
10/8/2016 8:00,199,147,52,8,6,teilweise bewölkt
10/8/2016 9:00,341,263,78,10,13,Klarer Himmel
10/8/2016 10:00,471,359,112,11,15,teilweise bewölkt
10/8/2016 11:00,583,402,181,12,13,teilweise bewölkt
10/8/2016 12:00,694,446,248,12,15,teilweise bewölkt
10/8/2016 13:00,640,373,267,12,22,teilweise bewölkt
10/8/2016 14:00,657,327,330,13,9,teilweise bewölkt
10/8/2016 15:00,633,312,321,13,11,teilweise bewölkt
10/8/2016 16:00,527,241,286,13,11,teilweise bewölkt
10/8/2016 17:00,569,242,327,12,15,teilweise bewölkt
10/8/2016 18:00,559,236,323,10,7,wolkig
10/8/2016 19:00,516,266,250,8,4,wolkig
10/8/2016 20:00,470,225,245,8,0,Klarer Himmel
10/8/2016 21:00,259,126,133,8,0,wolkig
10/8/2016 22:00,244,102,142,8,4,wolkig
10/8/2016 23:00,256,125,131,8,4,wolkig
10/9/2016 0:00,254,106,148,8,4,wolkig
10/9/2016 1:00,226,77,149,7,4,wolkig
10/9/2016 2:00,176,55,121,6,6,Klarer Himmel
10/9/2016 3:00,112,27,85,6,0,Klarer Himmel
10/9/2016 4:00,76,13,63,5,2,Nebel
10/9/2016 5:00,69,17,52,4,0,Nebel
10/9/2016 6:00,40,23,17,3,4,Nebel
10/9/2016 7:00,41,27,14,2,0,Nebel
10/9/2016 8:00,79,57,22,4,0,Nebel
10/9/2016 9:00,165,110,55,6,4,Klarer Himmel
10/9/2016 10:00,259,191,68,8,6,Klarer Himmel
10/9/2016 11:00,266,158,108,11,7,teilweise bewölkt
10/9/2016 12:00,333,199,134,11,13,wolkig
10/9/2016 13:00,430,231,199,11,9,wolkig
10/9/2016 14:00,415,216,199,12,9,wolkig
10/9/2016 15:00,409,219,190,12,11,wolkig
10/9/2016 16:00,417,205,212,11,9,wolkig
10/9/2016 17:00,501,222,279,11,7,wolkig
10/9/2016 18:00,432,193,239,10,6,Regen
10/9/2016 19:00,408,176,232,8,0,wolkig
10/9/2016 20:00,248,99,149,9,0,wolkig
10/9/2016 21:00,164,55,109,8,0,wolkig
10/9/2016 22:00,180,50,130,8,0,wolkig
10/9/2016 23:00,97,40,57,7,0,wolkig
10/10/2016 0:00,63,22,41,8,4,wolkig
10/10/2016 1:00,30,11,19,7,4,wolkig
10/10/2016 2:00,12,3,9,5,4,teilweise bewölkt
10/10/2016 3:00,3,2,1,7,7,wolkig
10/10/2016 4:00,13,11,2,7,0,wolkig
10/10/2016 5:00,43,24,19,6,7,wolkig
10/10/2016 6:00,165,112,53,6,6,Nebel
10/10/2016 7:00,513,280,233,6,4,Nebel
10/10/2016 8:00,801,476,325,6,6,Nebel
10/10/2016 9:00,1069,595,474,6,4,Nebel
10/10/2016 10:00,602,368,234,8,4,teilweise bewölkt
10/10/2016 11:00,623,327,296,10,4,teilweise bewölkt
10/10/2016 12:00,707,405,302,10,11,teilweise bewölkt
10/10/2016 13:00,870,518,352,10,11,wolkig
10/10/2016 14:00,825,479,346,11,9,wolkig
10/10/2016 15:00,943,531,412,11,11,wolkig
10/10/2016 16:00,1089,540,549,11,9,wolkig
10/10/2016 17:00,1158,541,617,10,9,wolkig
10/10/2016 18:00,1083,556,527,8,6,teilweise bewölkt
10/10/2016 19:00,988,559,429,6,0,teilweise bewölkt
10/10/2016 20:00,641,338,303,6,0,wolkig
10/10/2016 21:00,411,199,212,5,0,Nebel
10/10/2016 22:00,323,113,210,4,2,Nebel
10/10/2016 23:00,314,89,225,2,0,Nebel
10/11/2016 0:00,215,49,166,2,0,Nebel
10/11/2016 1:00,186,37,149,1,0,Nebel
10/11/2016 2:00,114,11,103,0,0,Nebel
10/11/2016 3:00,84,9,75,1,4,Nebel
10/11/2016 4:00,46,15,31,1,4,Nebel
10/11/2016 5:00,58,24,34,3,6,Nebel
10/11/2016 6:00,150,106,44,4,4,wolkig
10/11/2016 7:00,585,261,324,4,0,wolkig
10/11/2016 8:00,873,487,386,5,0,wolkig
10/11/2016 9:00,774,440,334,6,2,Regen
10/11/2016 10:00,624,372,252,7,4,Regen
10/11/2016 11:00,680,372,308,8,0,Regen
10/11/2016 12:00,743,417,326,9,2,wolkig
10/11/2016 13:00,833,485,348,9,2,wolkig
10/11/2016 14:00,870,532,338,10,2,wolkig
10/11/2016 15:00,919,533,386,10,6,wolkig
10/11/2016 16:00,940,424,516,10,6,wolkig
10/11/2016 17:00,1052,535,517,10,6,wolkig
10/11/2016 18:00,1079,520,559,10,6,wolkig
10/11/2016 19:00,957,555,402,9,6,wolkig
10/11/2016 20:00,652,409,243,9,6,Regen
10/11/2016 21:00,417,237,180,9,7,Regen
10/11/2016 22:00,360,138,222,9,11,Regen
10/11/2016 23:00,313,122,191,9,13,wolkig
10/12/2016 0:00,222,83,139,9,13,wolkig
10/12/2016 1:00,192,33,159,8,15,wolkig
10/12/2016 2:00,122,12,110,8,13,wolkig
10/12/2016 3:00,127,8,119,8,11,wolkig
10/12/2016 4:00,97,12,85,8,11,Regen
10/12/2016 5:00,83,31,52,8,9,wolkig
10/12/2016 6:00,161,107,54,7,13,wolkig
10/12/2016 7:00,491,258,233,7,13,wolkig
10/12/2016 8:00,909,519,390,7,9,wolkig
10/12/2016 9:00,736,404,332,8,13,wolkig
10/12/2016 10:00,593,371,222,8,9,wolkig
10/12/2016 11:00,744,438,306,8,11,Regen
10/12/2016 12:00,828,483,345,8,13,wolkig
10/12/2016 13:00,880,533,347,8,7,wolkig
10/12/2016 14:00,884,468,416,9,11,wolkig
10/12/2016 15:00,909,463,446,9,11,wolkig
10/12/2016 16:00,996,488,508,9,7,wolkig
10/12/2016 17:00,1033,449,584,8,11,Regen
10/12/2016 18:00,974,471,503,8,9,wolkig
10/12/2016 19:00,876,512,364,7,6,wolkig
10/12/2016 20:00,691,409,282,7,9,wolkig
10/12/2016 21:00,621,375,246,7,6,wolkig
10/12/2016 22:00,384,197,187,8,6,wolkig
10/12/2016 23:00,487,294,193,8,11,wolkig
10/13/2016 0:00,377,186,191,8,11,wolkig
10/13/2016 1:00,254,83,171,8,7,wolkig
10/13/2016 2:00,288,42,246,8,9,wolkig
10/13/2016 3:00,203,10,193,8,9,wolkig
10/13/2016 4:00,109,19,90,8,7,wolkig
10/13/2016 5:00,99,48,51,8,9,wolkig
10/13/2016 6:00,158,90,68,8,7,wolkig
10/13/2016 7:00,486,265,221,8,11,wolkig
10/13/2016 8:00,748,399,349,8,7,wolkig
10/13/2016 9:00,715,396,319,8,9,wolkig
10/13/2016 10:00,477,290,187,9,11,wolkig
10/13/2016 11:00,655,399,256,9,11,wolkig
10/13/2016 12:00,736,413,323,9,11,wolkig
10/13/2016 13:00,817,489,328,9,11,wolkig
10/13/2016 14:00,1133,465,668,9,13,wolkig
10/13/2016 15:00,1089,562,527,10,17,wolkig
10/13/2016 16:00,1177,713,464,10,11,wolkig
10/13/2016 17:00,1135,640,495,9,15,wolkig
10/13/2016 18:00,1012,531,481,9,13,wolkig
10/13/2016 19:00,792,442,350,9,11,wolkig
10/13/2016 20:00,561,298,263,8,13,wolkig
10/13/2016 21:00,375,190,185,8,15,wolkig
10/13/2016 22:00,312,117,195,8,11,wolkig
10/13/2016 23:00,207,78,129,8,13,wolkig
10/14/2016 0:00,185,63,122,8,13,teilweise bewölkt
10/14/2016 1:00,174,46,128,7,11,Klarer Himmel
10/14/2016 2:00,164,32,132,7,11,teilweise bewölkt
10/14/2016 3:00,127,10,117,7,13,teilweise bewölkt
10/14/2016 4:00,79,16,63,7,11,wolkig
10/14/2016 5:00,79,28,51,7,11,Klarer Himmel
10/14/2016 6:00,152,90,62,7,11,Klarer Himmel
10/14/2016 7:00,424,253,171,7,9,Klarer Himmel
10/14/2016 8:00,713,382,331,7,13,Klarer Himmel
10/14/2016 9:00,627,390,237,8,15,Klarer Himmel
10/14/2016 10:00,500,345,155,9,15,wolkig
10/14/2016 11:00,572,354,218,10,15,wolkig
10/14/2016 12:00,741,401,340,12,17,wolkig
10/14/2016 13:00,788,438,350,13,11,Klarer Himmel
10/14/2016 14:00,836,465,371,13,15,Klarer Himmel
10/14/2016 15:00,792,442,350,13,11,Klarer Himmel
10/14/2016 16:00,731,385,346,12,13,Klarer Himmel
10/14/2016 17:00,782,437,345,12,9,Klarer Himmel
10/14/2016 18:00,797,395,402,12,11,Klarer Himmel
10/14/2016 19:00,670,342,328,10,13,Klarer Himmel
10/14/2016 20:00,515,286,229,10,9,Klarer Himmel
10/14/2016 21:00,376,187,189,9,11,Klarer Himmel
10/14/2016 22:00,293,136,157,9,7,Klarer Himmel
10/14/2016 23:00,296,129,167,9,7,Klarer Himmel
10/15/2016 0:00,317,128,189,10,9,Regen
10/15/2016 1:00,221,57,164,10,9,Klarer Himmel
10/15/2016 2:00,192,46,146,10,6,Klarer Himmel
10/15/2016 3:00,147,32,115,10,6,Klarer Himmel
10/15/2016 4:00,105,16,89,9,6,Klarer Himmel
10/15/2016 5:00,61,27,34,9,9,Klarer Himmel
10/15/2016 6:00,62,36,26,8,4,Klarer Himmel
10/15/2016 7:00,98,71,27,8,7,teilweise bewölkt
10/15/2016 8:00,171,105,66,9,7,wolkig
10/15/2016 9:00,287,226,61,10,11,Regen
10/15/2016 10:00,421,308,113,11,9,wolkig
10/15/2016 11:00,432,277,155,11,9,
10/15/2016 12:00,554,367,187,12,7,wolkig
10/15/2016 13:00,528,307,221,13,17,Regen
10/15/2016 14:00,466,233,233,13,13,wolkig
10/15/2016 15:00,469,209,260,13,11,Regen
10/15/2016 16:00,378,179,199,13,9,Regen
10/15/2016 17:00,476,204,272,13,6,wolkig
10/15/2016 18:00,469,204,265,12,6,wolkig
10/15/2016 19:00,498,241,257,11,7,Nebel
10/15/2016 20:00,421,217,204,8,0,Nebel
10/15/2016 21:00,322,180,142,7,4,Nebel
10/15/2016 22:00,271,129,142,7,0,Nebel
10/15/2016 23:00,239,104,135,7,2,Nebel
10/16/2016 0:00,241,111,130,5,6,Nebel
10/16/2016 1:00,228,88,140,4,0,Nebel
10/16/2016 2:00,156,52,104,5,0,Nebel
10/16/2016 3:00,125,27,98,5,0,Nebel
10/16/2016 4:00,82,18,64,6,4,Nebel
10/16/2016 5:00,54,15,39,6,4,Nebel
10/16/2016 6:00,61,33,28,6,4,Nebel
10/16/2016 7:00,39,24,15,5,4,Nebel
10/16/2016 8:00,80,42,38,6,4,Nebel
10/16/2016 9:00,179,135,44,8,4,Klarer Himmel
10/16/2016 10:00,287,206,81,10,6,Klarer Himmel
10/16/2016 11:00,328,200,128,12,7,Klarer Himmel
10/16/2016 12:00,444,272,172,15,7,Klarer Himmel
10/16/2016 13:00,533,318,215,17,7,Klarer Himmel
10/16/2016 14:00,669,418,251,18,9,Klarer Himmel
10/16/2016 15:00,726,429,297,18,6,Klarer Himmel
10/16/2016 16:00,651,335,316,17,6,Klarer Himmel
10/16/2016 17:00,712,312,400,16,4,Klarer Himmel
10/16/2016 18:00,546,266,280,13,6,Klarer Himmel
10/16/2016 19:00,414,177,237,13,6,Klarer Himmel
10/16/2016 20:00,274,99,175,13,6,Klarer Himmel
10/16/2016 21:00,192,54,138,12,7,Klarer Himmel
10/16/2016 22:00,231,75,156,12,7,Klarer Himmel
10/16/2016 23:00,122,39,83,11,11,Klarer Himmel
10/17/2016 0:00,74,22,52,11,7,Klarer Himmel
10/17/2016 1:00,22,6,16,11,7,Klarer Himmel
10/17/2016 2:00,11,4,7,11,7,Klarer Himmel
10/17/2016 3:00,4,4,0,10,6,Klarer Himmel
10/17/2016 4:00,13,10,3,10,2,Klarer Himmel
10/17/2016 5:00,56,36,20,10,6,Klarer Himmel
10/17/2016 6:00,156,86,70,10,6,Klarer Himmel
10/17/2016 7:00,855,548,307,10,6,Klarer Himmel
10/17/2016 8:00,1001,539,462,10,2,Klarer Himmel
10/17/2016 9:00,1121,669,452,11,7,Klarer Himmel
10/17/2016 10:00,847,534,313,13,7,wolkig
10/17/2016 11:00,1173,542,631,15,7,Klarer Himmel
10/17/2016 12:00,1131,604,527,15,9,wolkig
10/17/2016 13:00,1359,695,664,16,7,wolkig
10/17/2016 14:00,1201,658,543,15,13,wolkig
10/17/2016 15:00,1397,630,767,15,7,wolkig
10/17/2016 16:00,1317,696,621,15,7,wolkig
10/17/2016 17:00,1543,802,741,14,6,Klarer Himmel
10/17/2016 18:00,1173,541,632,13,6,Klarer Himmel
10/17/2016 19:00,1026,565,461,12,6,Klarer Himmel
10/17/2016 20:00,551,272,279,10,0,Nebel
10/17/2016 21:00,480,184,296,10,4,Nebel
10/17/2016 22:00,356,87,269,9,2,Nebel
10/17/2016 23:00,284,74,210,7,7,Nebel
10/18/2016 0:00,139,44,95,9,4,Nebel
10/18/2016 1:00,83,12,71,10,6,Nebel
10/18/2016 2:00,26,9,17,9,4,Nebel
10/18/2016 3:00,11,9,2,7,4,Nebel
10/18/2016 4:00,15,13,2,7,4,Nebel
10/18/2016 5:00,51,33,18,7,4,Nebel
10/18/2016 6:00,167,111,56,8,6,Nebel
10/18/2016 7:00,1111,590,521,8,7,Nebel
10/18/2016 8:00,1188,636,552,8,6,Nebel
10/18/2016 9:00,1510,691,819,10,13,wolkig
10/18/2016 10:00,1060,695,365,11,15,wolkig
10/18/2016 11:00,1452,799,653,12,15,wolkig
10/18/2016 12:00,1291,819,472,14,17,wolkig
10/18/2016 13:00,1572,795,777,15,20,wolkig
10/18/2016 14:00,1083,628,455,15,19,wolkig
10/18/2016 15:00,1553,811,742,14,13,Regen
10/18/2016 16:00,1244,652,592,13,15,Regen
10/18/2016 17:00,1373,662,711,13,17,Regen
10/18/2016 18:00,1108,577,531,12,17,Regen
10/18/2016 19:00,765,361,404,11,15,Regen
10/18/2016 20:00,477,245,232,9,4,Regen
10/18/2016 21:00,474,210,264,10,11,wolkig
10/18/2016 22:00,403,164,239,10,11,Klarer Himmel
10/18/2016 23:00,257,98,159,9,13,
10/19/2016 0:00,191,86,105,8,9,teilweise bewölkt
10/19/2016 1:00,71,22,49,8,11,wolkig
10/19/2016 2:00,66,7,59,9,15,Regen
10/19/2016 3:00,87,12,75,8,17,wolkig
10/19/2016 4:00,64,14,50,7,17,wolkig
10/19/2016 5:00,67,31,36,8,17,wolkig
10/19/2016 6:00,143,91,52,7,13,Regen
10/19/2016 7:00,962,525,437,7,15,Regen
10/19/2016 8:00,1057,626,431,8,15,Regen
10/19/2016 9:00,963,432,531,8,11,Regen
10/19/2016 10:00,614,343,271,7,15,Regen
10/19/2016 11:00,726,395,331,7,11,Regen
10/19/2016 12:00,630,343,287,7,13,Regen
10/19/2016 13:00,811,498,313,7,17,Regen
10/19/2016 14:00,673,411,262,7,19,Regen
10/19/2016 15:00,782,390,392,7,20,Regen
10/19/2016 16:00,767,356,411,8,15,wolkig
10/19/2016 17:00,974,485,489,7,9,wolkig
10/19/2016 18:00,876,507,369,8,7,wolkig
10/19/2016 19:00,1040,540,500,7,11,wolkig
10/19/2016 20:00,657,314,343,7,9,Regen
10/19/2016 21:00,460,178,282,8,4,Regen
10/19/2016 22:00,486,197,289,7,11,Regen
10/19/2016 23:00,402,163,239,7,7,wolkig
10/20/2016 0:00,478,312,166,6,4,wolkig
10/20/2016 1:00,322,157,165,5,2,Nebel
10/20/2016 2:00,212,57,155,5,0,Nebel
10/20/2016 3:00,265,102,163,4,2,Nebel
10/20/2016 4:00,156,53,103,2,0,Nebel
10/20/2016 5:00,66,40,26,3,0,Nebel
10/20/2016 6:00,134,79,55,4,4,Nebel
10/20/2016 7:00,894,425,469,4,0,Nebel
10/20/2016 8:00,984,557,427,4,6,Nebel
10/20/2016 9:00,1125,606,519,6,0,Nebel
10/20/2016 10:00,1013,658,355,7,2,wolkig
10/20/2016 11:00,1170,619,551,8,4,wolkig
10/20/2016 12:00,1031,560,471,9,6,wolkig
10/20/2016 13:00,1263,623,640,9,6,wolkig
10/20/2016 14:00,1075,640,435,9,7,wolkig
10/20/2016 15:00,1243,629,614,9,7,wolkig
10/20/2016 16:00,1256,645,611,9,7,wolkig
10/20/2016 17:00,1269,661,608,8,4,wolkig
10/20/2016 18:00,896,481,415,8,9,Regen
10/20/2016 19:00,794,409,385,8,6,wolkig
10/20/2016 20:00,524,247,277,8,6,wolkig
10/20/2016 21:00,337,130,207,7,6,wolkig
10/20/2016 22:00,362,123,239,7,7,wolkig
10/20/2016 23:00,302,122,180,7,7,wolkig
10/21/2016 0:00,166,67,99,7,4,wolkig
10/21/2016 1:00,144,64,80,7,11,wolkig
10/21/2016 2:00,65,16,49,7,11,wolkig
10/21/2016 3:00,38,6,32,5,6,Nebel
10/21/2016 4:00,36,13,23,6,9,wolkig
10/21/2016 5:00,57,29,28,6,9,wolkig
10/21/2016 6:00,134,91,43,6,6,wolkig
10/21/2016 7:00,681,365,316,6,13,wolkig
10/21/2016 8:00,879,458,421,6,9,wolkig
10/21/2016 9:00,919,467,452,6,11,wolkig
10/21/2016 10:00,918,625,293,7,9,wolkig
10/21/2016 11:00,1014,531,483,7,13,wolkig
10/21/2016 12:00,922,540,382,8,11,wolkig
10/21/2016 13:00,1007,545,462,9,19,wolkig
10/21/2016 14:00,864,449,415,8,22,Regen
10/21/2016 15:00,797,410,387,8,17,Regen
10/21/2016 16:00,668,339,329,8,13,Regen
10/21/2016 17:00,562,272,290,8,11,Regen
10/21/2016 18:00,488,242,246,8,11,Regen
10/21/2016 19:00,460,246,214,8,9,Regen
10/21/2016 20:00,402,225,177,8,7,Regen
10/21/2016 21:00,329,169,160,8,6,wolkig
10/21/2016 22:00,229,106,123,8,4,wolkig
10/21/2016 23:00,214,109,105,8,4,wolkig
10/22/2016 0:00,183,74,109,8,6,wolkig
10/22/2016 1:00,215,103,112,8,6,wolkig
10/22/2016 2:00,151,53,98,8,7,wolkig
10/22/2016 3:00,143,37,106,7,7,wolkig
10/22/2016 4:00,97,25,72,7,7,wolkig
10/22/2016 5:00,59,20,39,7,7,wolkig
10/22/2016 6:00,53,27,26,7,7,wolkig
10/22/2016 7:00,108,84,24,7,9,wolkig
10/22/2016 8:00,188,116,72,7,11,wolkig
10/22/2016 9:00,339,233,106,7,11,wolkig
10/22/2016 10:00,421,293,128,7,9,wolkig
10/22/2016 11:00,439,289,150,8,11,wolkig
10/22/2016 12:00,631,383,248,8,7,wolkig
10/22/2016 13:00,650,354,296,8,11,wolkig
10/22/2016 14:00,689,350,339,8,9,wolkig
10/22/2016 15:00,716,360,356,8,9,Regen
10/22/2016 16:00,609,317,292,8,6,wolkig
10/22/2016 17:00,598,282,316,8,4,wolkig
10/22/2016 18:00,564,284,280,7,4,Nebel
10/22/2016 19:00,573,299,274,7,0,
10/22/2016 20:00,517,269,248,6,0,Nebel
10/22/2016 21:00,385,192,193,5,2,Nebel
10/22/2016 22:00,300,105,195,4,4,Nebel
10/22/2016 23:00,278,108,170,2,0,Nebel
10/23/2016 0:00,311,112,199,2,2,Nebel
10/23/2016 1:00,283,127,156,1,0,Nebel
10/23/2016 2:00,180,60,120,1,4,Nebel
10/23/2016 3:00,178,69,109,1,2,Nebel
10/23/2016 4:00,144,59,85,1,4,Nebel
10/23/2016 5:00,64,32,32,1,2,Nebel
10/23/2016 6:00,45,21,24,1,2,Nebel
10/23/2016 7:00,61,44,17,1,4,Nebel
10/23/2016 8:00,100,64,36,2,4,Nebel
10/23/2016 9:00,148,113,35,2,6,Nebel
10/23/2016 10:00,217,173,44,3,4,Nebel
10/23/2016 11:00,276,173,103,4,6,Nebel
10/23/2016 12:00,343,184,159,6,6,wolkig
10/23/2016 13:00,439,261,178,7,6,teilweise bewölkt
10/23/2016 14:00,518,322,196,9,6,teilweise bewölkt
10/23/2016 15:00,642,370,272,10,7,teilweise bewölkt
10/23/2016 16:00,718,402,316,11,4,teilweise bewölkt
10/23/2016 17:00,714,346,368,9,4,teilweise bewölkt
10/23/2016 18:00,625,318,307,6,4,Nebel
10/23/2016 19:00,458,201,257,5,6,Nebel
10/23/2016 20:00,437,116,321,5,6,Nebel
10/23/2016 21:00,226,80,146,5,4,Nebel
10/23/2016 22:00,239,70,169,4,6,Nebel
10/23/2016 23:00,109,36,73,5,4,Nebel
10/24/2016 0:00,46,18,28,5,6,Nebel
10/24/2016 1:00,22,9,13,4,6,Nebel
10/24/2016 2:00,10,6,4,4,7,Nebel
10/24/2016 3:00,3,2,1,4,6,Nebel
10/24/2016 4:00,14,11,3,4,6,Nebel
10/24/2016 5:00,44,26,18,5,7,
10/24/2016 6:00,171,118,53,5,7,
10/24/2016 7:00,1023,624,399,5,9,
10/24/2016 8:00,1094,637,457,5,6,
10/24/2016 9:00,1167,570,597,6,9,
10/24/2016 10:00,937,598,339,7,11,Klarer Himmel
10/24/2016 11:00,1294,611,683,8,9,Klarer Himmel
10/24/2016 12:00,1088,562,526,8,9,Klarer Himmel
10/24/2016 13:00,1346,694,652,9,6,Klarer Himmel
10/24/2016 14:00,1024,568,456,9,7,Regen
10/24/2016 15:00,1401,680,721,8,7,Regen
10/24/2016 16:00,957,518,439,8,9,Regen
10/24/2016 17:00,1405,680,725,8,7,Regen
10/24/2016 18:00,1058,579,479,8,6,Regen
10/24/2016 19:00,943,476,467,8,6,Regen
10/24/2016 20:00,553,243,310,8,4,Regen
10/24/2016 21:00,368,154,214,8,6,Regen
10/24/2016 22:00,279,125,154,8,4,wolkig
10/24/2016 23:00,141,59,82,8,7,wolkig
10/25/2016 0:00,127,32,95,8,6,wolkig
10/25/2016 1:00,79,13,66,8,6,Regen
10/25/2016 2:00,52,12,40,8,2,Regen
10/25/2016 3:00,29,10,19,8,6,Regen
10/25/2016 4:00,28,16,12,8,4,Regen
10/25/2016 5:00,46,24,22,8,4,Regen
10/25/2016 6:00,149,95,54,8,6,Regen
10/25/2016 7:00,1107,592,515,8,4,wolkig
10/25/2016 8:00,1343,787,556,8,7,wolkig
10/25/2016 9:00,1438,669,769,8,7,wolkig
10/25/2016 10:00,928,577,351,8,7,wolkig
10/25/2016 11:00,1294,641,653,8,9,wolkig
10/25/2016 12:00,1183,719,464,9,7,wolkig
10/25/2016 13:00,1380,635,745,9,7,wolkig
10/25/2016 14:00,1174,699,475,9,6,wolkig
10/25/2016 15:00,1500,779,721,9,4,wolkig
10/25/2016 16:00,1319,720,599,9,4,wolkig
10/25/2016 17:00,1721,844,877,9,6,wolkig
10/25/2016 18:00,1362,738,624,7,0,Nebel
10/25/2016 19:00,1295,698,597,6,0,Nebel
10/25/2016 20:00,726,336,390,7,2,Nebel
10/25/2016 21:00,624,241,383,4,0,Nebel
10/25/2016 22:00,547,181,366,5,4,Nebel
10/25/2016 23:00,290,109,181,4,4,Nebel
10/26/2016 0:00,88,technische Störung,88,2,2,Nebel
10/26/2016 1:00,45,technische Störung,45,2,0,Nebel
10/26/2016 2:00,64,technische Störung,64,2,0,Nebel
10/26/2016 3:00,44,technische Störung,44,3,2,wolkig
10/26/2016 4:00,6,technische Störung,6,4,0,wolkig
10/26/2016 5:00,32,technische Störung,32,5,0,wolkig
10/26/2016 6:00,46,technische Störung,46,5,0,wolkig
10/26/2016 7:00,478,technische Störung,478,5,0,wolkig
10/26/2016 8:00,517,technische Störung,517,6,0,wolkig
10/26/2016 9:00,615,technische Störung,615,7,6,wolkig
10/26/2016 10:00,373,technische Störung,373,8,2,wolkig
10/26/2016 11:00,585,technische Störung,585,9,0,wolkig
10/26/2016 12:00,434,technische Störung,434,10,6,wolkig
10/26/2016 13:00,652,technische Störung,652,10,4,wolkig
10/26/2016 14:00,525,technische Störung,525,10,4,wolkig
10/26/2016 15:00,834,technische Störung,834,11,4,wolkig
10/26/2016 16:00,593,technische Störung,593,11,6,wolkig
10/26/2016 17:00,835,technische Störung,835,10,6,
10/26/2016 18:00,672,technische Störung,672,8,6,Nebel
10/26/2016 19:00,649,technische Störung,649,8,6,wolkig
10/26/2016 20:00,466,technische Störung,466,8,7,wolkig
10/26/2016 21:00,442,technische Störung,442,8,6,wolkig
10/26/2016 22:00,456,technische Störung,456,8,7,wolkig
10/26/2016 23:00,254,technische Störung,254,9,9,wolkig
10/27/2016 0:00,150,technische Störung,150,9,7,
10/27/2016 1:00,124,technische Störung,124,9,6,wolkig
10/27/2016 2:00,81,technische Störung,81,9,6,wolkig
10/27/2016 3:00,72,technische Störung,72,9,7,wolkig
10/27/2016 4:00,39,technische Störung,39,9,7,wolkig
10/27/2016 5:00,34,technische Störung,34,9,6,wolkig
10/27/2016 6:00,59,technische Störung,59,9,7,wolkig
10/27/2016 7:00,512,technische Störung,512,10,9,wolkig
10/27/2016 8:00,505,technische Störung,505,10,9,wolkig
10/27/2016 9:00,625,technische Störung,625,10,9,wolkig
10/27/2016 10:00,367,technische Störung,367,10,11,wolkig
10/27/2016 11:00,750,technische Störung,750,11,11,wolkig
10/27/2016 12:00,609,93,516,12,13,wolkig
10/27/2016 13:00,1308,578,730,12,13,wolkig
10/27/2016 14:00,1001,526,475,12,15,wolkig
10/27/2016 15:00,1458,770,688,12,17,wolkig
10/27/2016 16:00,1225,658,567,12,11,wolkig
10/27/2016 17:00,1702,924,778,12,13,wolkig
10/27/2016 18:00,1349,706,643,11,11,wolkig
10/27/2016 19:00,1141,530,611,11,9,wolkig
10/27/2016 20:00,789,362,427,11,13,wolkig
10/27/2016 21:00,593,257,336,11,13,wolkig
10/27/2016 22:00,518,174,344,11,11,teilweise bewölkt
10/27/2016 23:00,279,91,188,11,17,wolkig
10/28/2016 0:00,160,56,104,11,17,wolkig
10/28/2016 1:00,82,21,61,12,15,wolkig
10/28/2016 2:00,38,6,32,11,15,teilweise bewölkt
10/28/2016 3:00,40,6,34,12,17,wolkig
10/28/2016 4:00,38,14,24,12,19,wolkig
10/28/2016 5:00,50,28,22,12,19,wolkig
10/28/2016 6:00,172,115,57,12,17,wolkig
10/28/2016 7:00,889,479,410,12,17,wolkig
10/28/2016 8:00,990,559,431,12,19,wolkig
10/28/2016 9:00,991,538,453,12,19,wolkig
10/28/2016 10:00,913,607,306,13,19,wolkig
10/28/2016 11:00,1083,590,493,13,22,wolkig
10/28/2016 12:00,953,595,358,13,24,Regen
10/28/2016 13:00,1165,549,616,13,24,Regen
10/28/2016 14:00,909,472,437,13,19,Regen
10/28/2016 15:00,951,488,463,13,20,wolkig
10/28/2016 16:00,894,494,400,13,19,Regen
10/28/2016 17:00,949,433,516,13,17,Regen
10/28/2016 18:00,841,421,420,13,15,Regen
10/28/2016 19:00,747,429,318,13,11,wolkig
10/28/2016 20:00,651,381,270,12,9,wolkig
10/28/2016 21:00,466,206,260,12,11,wolkig
10/28/2016 22:00,378,146,232,11,11,wolkig
10/28/2016 23:00,299,100,199,9,7,
10/29/2016 0:00,314,137,177,8,7,Nebel
10/29/2016 1:00,237,93,144,8,7,Nebel
10/29/2016 2:00,151,36,115,6,6,Nebel
10/29/2016 3:00,114,44,70,7,6,Nebel
10/29/2016 4:00,64,25,39,6,4,Nebel
10/29/2016 5:00,52,22,30,7,6,Nebel
10/29/2016 6:00,49,29,20,6,9,Nebel
10/29/2016 7:00,96,71,25,6,0,Nebel
10/29/2016 8:00,202,141,61,5,0,Nebel
10/29/2016 9:00,415,278,137,8,0,Nebel
10/29/2016 10:00,489,329,160,9,6,teilweise bewölkt
10/29/2016 11:00,590,408,182,11,7,teilweise bewölkt
10/29/2016 12:00,696,441,255,12,13,teilweise bewölkt
10/29/2016 13:00,769,464,305,13,13,teilweise bewölkt
10/29/2016 14:00,770,392,378,14,13,teilweise bewölkt
10/29/2016 15:00,749,382,367,13,9,teilweise bewölkt
10/29/2016 16:00,705,326,379,13,6,teilweise bewölkt
10/29/2016 17:00,729,356,373,11,6,teilweise bewölkt
10/29/2016 18:00,750,312,438,9,4,teilweise bewölkt
10/29/2016 19:00,599,277,322,8,6,teilweise bewölkt
10/29/2016 20:00,507,225,282,7,2,Nebel
10/29/2016 21:00,447,216,231,5,0,Nebel
10/29/2016 22:00,321,128,193,5,0,Nebel
10/29/2016 23:00,344,118,226,5,2,Klarer Himmel
10/30/2016 0:00,299,92,207,7,0,Klarer Himmel
10/30/2016 1:00,295,105,190,6,2,Nebel
10/30/2016 2:00,394,156,238,6,2,Nebel
10/30/2016 3:00,115,45,70,4,0,Nebel
10/30/2016 4:00,72,35,37,5,4,Nebel
10/30/2016 5:00,50,19,31,6,9,wolkig
10/30/2016 6:00,42,23,19,5,4,Nebel
10/30/2016 7:00,43,31,12,6,4,wolkig
10/30/2016 8:00,104,56,48,7,2,
10/30/2016 9:00,223,158,65,8,2,wolkig
10/30/2016 10:00,345,210,135,9,4,wolkig
10/30/2016 11:00,340,227,113,10,6,wolkig
10/30/2016 12:00,402,226,176,12,4,wolkig
10/30/2016 13:00,482,287,195,12,2,wolkig
10/30/2016 14:00,517,303,214,12,7,wolkig
10/30/2016 15:00,625,353,272,12,2,wolkig
10/30/2016 16:00,620,316,304,9,2,Nebel
10/30/2016 17:00,660,337,323,8,0,Nebel
10/30/2016 18:00,494,241,253,9,0,wolkig
10/30/2016 19:00,479,223,256,9,4,wolkig
10/30/2016 20:00,366,127,239,9,4,wolkig
10/30/2016 21:00,258,91,167,9,4,wolkig
10/30/2016 22:00,219,62,157,9,6,wolkig
10/30/2016 23:00,105,29,76,,,
10/31/2016 0:00,59,25,34,9,4,wolkig
10/31/2016 1:00,33,6,27,9,4,wolkig
10/31/2016 2:00,6,2,4,9,0,wolkig
10/31/2016 3:00,9,4,5,10,7,wolkig
10/31/2016 4:00,1,0,1,9,2,wolkig
10/31/2016 5:00,47,27,20,9,2,wolkig
10/31/2016 6:00,143,92,51,9,2,wolkig
10/31/2016 7:00,865,503,362,9,2,wolkig
10/31/2016 8:00,946,525,421,10,6,wolkig
10/31/2016 9:00,1081,562,519,10,6,wolkig
10/31/2016 10:00,922,598,324,11,2,wolkig
10/31/2016 11:00,1121,580,541,13,4,wolkig
10/31/2016 12:00,1047,594,453,13,6,wolkig
10/31/2016 13:00,1341,660,681,15,6,wolkig
10/31/2016 14:00,1111,590,521,15,6,wolkig
10/31/2016 15:00,1422,728,694,14,9,wolkig
10/31/2016 16:00,1226,663,563,13,4,wolkig
10/31/2016 17:00,1598,730,868,11,4,teilweise bewölkt
10/31/2016 18:00,1054,533,521,9,4,Klarer Himmel
10/31/2016 19:00,1065,484,581,8,0,Nebel
10/31/2016 20:00,851,451,400,8,4,Nebel
10/31/2016 21:00,738,399,339,6,2,Nebel
10/31/2016 22:00,542,243,299,5,2,Nebel
10/31/2016 23:00,437,186,251,6,6,Nebel
11/1/2016 0:00,488,227,261,technische Störung,technische Störung,
11/1/2016 1:00,474,206,268,technische Störung,technische Störung,
11/1/2016 2:00,447,167,280,technische Störung,technische Störung,
11/1/2016 3:00,345,144,201,technische Störung,technische Störung,
11/1/2016 4:00,239,83,156,technische Störung,technische Störung,
11/1/2016 5:00,128,36,92,technische Störung,technische Störung,
11/1/2016 6:00,74,32,42,technische Störung,technische Störung,
11/1/2016 7:00,66,40,26,technische Störung,technische Störung,
11/1/2016 8:00,137,76,61,technische Störung,technische Störung,
11/1/2016 9:00,236,142,94,technische Störung,technische Störung,
11/1/2016 10:00,276,174,102,technische Störung,technische Störung,
11/1/2016 11:00,328,196,132,technische Störung,technische Störung,
11/1/2016 12:00,420,224,196,technische Störung,technische Störung,
11/1/2016 13:00,450,253,197,technische Störung,technische Störung,
11/1/2016 14:00,467,266,201,technische Störung,technische Störung,
11/1/2016 15:00,452,242,210,technische Störung,technische Störung,
11/1/2016 16:00,475,249,226,technische Störung,technische Störung,
11/1/2016 17:00,500,222,278,technische Störung,technische Störung,
11/1/2016 18:00,430,208,222,technische Störung,technische Störung,
11/1/2016 19:00,370,190,180,technische Störung,technische Störung,
11/1/2016 20:00,317,131,186,technische Störung,technische Störung,
11/1/2016 21:00,207,87,120,technische Störung,technische Störung,
11/1/2016 22:00,252,80,172,technische Störung,technische Störung,
11/1/2016 23:00,142,46,96,technische Störung,technische Störung,
11/2/2016 0:00,41,13,28,4,9,Nebel
11/2/2016 1:00,28,15,13,5,9,Klarer Himmel
11/2/2016 2:00,6,3,3,4,9,teilweise bewölkt
11/2/2016 3:00,7,4,3,4,11,teilweise bewölkt
11/2/2016 4:00,11,7,4,4,7,teilweise bewölkt
11/2/2016 5:00,54,34,20,5,15,wolkig
11/2/2016 6:00,172,117,55,5,13,Klarer Himmel
11/2/2016 7:00,993,594,399,6,15,Regen
11/2/2016 8:00,1204,710,494,6,17,teilweise bewölkt
11/2/2016 9:00,1201,601,600,8,28,wolkig
11/2/2016 10:00,848,488,360,9,26,teilweise bewölkt
11/2/2016 11:00,1137,591,546,9,20,Regen
11/2/2016 12:00,1051,629,422,10,22,wolkig
11/2/2016 13:00,1270,668,602,5,26,Regen
11/2/2016 14:00,1063,580,483,10,24,Regen
11/2/2016 15:00,1362,599,763,8,20,Regen
11/2/2016 16:00,1138,612,526,8,11,Regen
11/2/2016 17:00,1564,692,872,6,11,teilweise bewölkt
11/2/2016 18:00,1180,567,613,6,15,teilweise bewölkt
11/2/2016 19:00,1143,571,572,7,15,wolkig
11/2/2016 20:00,753,400,353,6,11,teilweise bewölkt
11/2/2016 21:00,468,247,221,5,6,teilweise bewölkt
11/2/2016 22:00,453,187,266,5,4,wolkig
11/2/2016 23:00,347,132,215,5,0,wolkig
11/3/2016 0:00,243,113,130,6,2,wolkig
11/3/2016 1:00,118,23,95,5,6,wolkig
11/3/2016 2:00,87,7,80,6,7,wolkig
11/3/2016 3:00,136,11,125,6,7,wolkig
11/3/2016 4:00,111,15,96,6,9,wolkig
11/3/2016 5:00,78,39,39,5,4,wolkig
11/3/2016 6:00,173,114,59,3,6,Nebel
11/3/2016 7:00,1010,529,481,4,6,Nebel
11/3/2016 8:00,1184,686,498,5,7,wolkig
11/3/2016 9:00,1355,721,634,6,7,wolkig
11/3/2016 10:00,958,593,365,7,7,wolkig
11/3/2016 11:00,1284,639,645,8,11,teilweise bewölkt
11/3/2016 12:00,1058,570,488,9,15,teilweise bewölkt
11/3/2016 13:00,1387,656,731,9,17,teilweise bewölkt
11/3/2016 14:00,1128,624,504,9,17,teilweise bewölkt
11/3/2016 15:00,1316,616,700,8,11,wolkig
11/3/2016 16:00,1344,688,656,8,11,Klarer Himmel
11/3/2016 17:00,1553,771,782,8,7,wolkig
11/3/2016 18:00,1196,665,531,7,7,Klarer Himmel
11/3/2016 19:00,1115,511,604,7,7,
11/3/2016 20:00,673,307,366,7,9,
11/3/2016 21:00,506,213,293,7,9,wolkig
11/3/2016 22:00,448,159,289,7,7,wolkig
11/3/2016 23:00,309,87,222,7,11,wolkig
11/4/2016 0:00,171,54,117,7,9,wolkig
11/4/2016 1:00,108,32,76,7,11,wolkig
11/4/2016 2:00,31,9,22,7,13,Klarer Himmel
11/4/2016 3:00,26,7,19,7,15,Klarer Himmel
11/4/2016 4:00,15,9,6,7,15,Klarer Himmel
11/4/2016 5:00,56,37,19,7,13,wolkig
11/4/2016 6:00,159,95,64,7,15,Klarer Himmel
11/4/2016 7:00,951,549,402,7,11,Klarer Himmel
11/4/2016 8:00,1096,653,443,7,17,wolkig
11/4/2016 9:00,1041,558,483,8,17,Klarer Himmel
11/4/2016 10:00,809,524,285,8,15,Klarer Himmel
11/4/2016 11:00,940,517,423,9,13,wolkig
11/4/2016 12:00,948,575,373,10,15,wolkig
11/4/2016 13:00,1181,586,595,10,17,wolkig
11/4/2016 14:00,991,537,454,10,11,Klarer Himmel
11/4/2016 15:00,1029,493,536,10,9,Klarer Himmel
11/4/2016 16:00,862,450,412,8,6,Klarer Himmel
11/4/2016 17:00,1021,489,532,7,7,Klarer Himmel
11/4/2016 18:00,776,390,386,7,7,Klarer Himmel
11/4/2016 19:00,686,355,331,6,7,Klarer Himmel
11/4/2016 20:00,493,238,255,6,9,Klarer Himmel
11/4/2016 21:00,360,165,195,6,9,Klarer Himmel
11/4/2016 22:00,318,129,189,6,11,Klarer Himmel
11/4/2016 23:00,303,124,179,6,9,Klarer Himmel
11/5/2016 0:00,257,105,152,7,11,wolkig
11/5/2016 1:00,182,51,131,7,9,wolkig
11/5/2016 2:00,161,48,113,7,9,wolkig
11/5/2016 3:00,119,47,72,7,9,wolkig
11/5/2016 4:00,85,19,66,7,7,Regen
11/5/2016 5:00,57,24,33,6,9,Regen
11/5/2016 6:00,38,21,17,7,9,wolkig
11/5/2016 7:00,131,100,31,7,11,Regen
11/5/2016 8:00,187,137,50,7,13,wolkig
11/5/2016 9:00,382,275,107,7,17,wolkig
11/5/2016 10:00,374,279,95,7,13,wolkig
11/5/2016 11:00,431,287,144,8,15,wolkig
11/5/2016 12:00,567,336,231,8,11,wolkig
11/5/2016 13:00,528,289,239,8,17,wolkig
11/5/2016 14:00,567,276,291,9,19,teilweise bewölkt
11/5/2016 15:00,561,305,256,9,11,teilweise bewölkt
11/5/2016 16:00,498,214,284,7,7,wolkig
11/5/2016 17:00,463,151,312,6,7,wolkig
11/5/2016 18:00,436,168,268,6,7,wolkig
11/5/2016 19:00,388,186,202,5,9,Klarer Himmel
11/5/2016 20:00,335,186,149,6,11,wolkig
11/5/2016 21:00,276,125,151,6,13,teilweise bewölkt
11/5/2016 22:00,197,66,131,6,15,wolkig
11/5/2016 23:00,185,84,101,6,13,wolkig
11/6/2016 0:00,206,71,135,6,13,teilweise bewölkt
11/6/2016 1:00,223,87,136,6,15,wolkig
11/6/2016 2:00,134,48,86,5,11,teilweise bewölkt
11/6/2016 3:00,98,21,77,5,15,teilweise bewölkt
11/6/2016 4:00,53,16,37,5,13,wolkig
11/6/2016 5:00,42,10,32,5,19,wolkig
11/6/2016 6:00,33,14,19,5,17,wolkig
11/6/2016 7:00,50,21,29,5,13,wolkig
11/6/2016 8:00,53,30,23,6,19,wolkig
11/6/2016 9:00,189,148,41,6,17,wolkig
11/6/2016 10:00,247,154,93,6,17,wolkig
11/6/2016 11:00,225,137,88,7,19,wolkig
11/6/2016 12:00,293,151,142,7,22,wolkig
11/6/2016 13:00,360,197,163,7,20,wolkig
11/6/2016 14:00,350,186,164,7,20,wolkig
11/6/2016 15:00,359,171,188,7,13,Regen
11/6/2016 16:00,309,142,167,7,15,Regen
11/6/2016 17:00,348,168,180,6,9,Regen
11/6/2016 18:00,266,127,139,6,13,wolkig
11/6/2016 19:00,308,146,162,6,11,wolkig
11/6/2016 20:00,204,81,123,6,9,wolkig
11/6/2016 21:00,165,62,103,6,7,wolkig
11/6/2016 22:00,141,33,108,6,7,wolkig
11/6/2016 23:00,89,26,63,6,4,wolkig
11/7/2016 0:00,40,14,26,6,4,wolkig
11/7/2016 1:00,13,2,11,6,4,wolkig
11/7/2016 2:00,11,4,7,6,4,wolkig
11/7/2016 3:00,3,1,2,6,6,wolkig
11/7/2016 4:00,13,6,7,6,2,wolkig
11/7/2016 5:00,48,27,21,6,4,Regen
11/7/2016 6:00,175,119,56,6,2,Regen
11/7/2016 7:00,914,568,346,6,2,Regen
11/7/2016 8:00,1077,636,441,6,2,Regen
11/7/2016 9:00,965,504,461,6,9,Regen
11/7/2016 10:00,745,471,274,6,13,Regen
11/7/2016 11:00,852,347,505,5,9,Regen
11/7/2016 12:00,666,352,314,5,11,Regen
11/7/2016 13:00,932,415,517,5,13,Regen
11/7/2016 14:00,670,366,304,5,7,Regen
11/7/2016 15:00,978,461,517,4,13,Regen
11/7/2016 16:00,955,539,416,4,6,Regen
11/7/2016 17:00,1254,551,703,4,13,Regen
11/7/2016 18:00,922,428,494,3,15,Regen
11/7/2016 19:00,720,323,397,3,15,Regen
11/7/2016 20:00,445,218,227,3,15,Regen
11/7/2016 21:00,334,138,196,2,13,Regen
11/7/2016 22:00,280,123,157,2,13,Regen
11/7/2016 23:00,129,49,80,2,11,Regen
11/8/2016 0:00,64,15,49,2,11,Regen
11/8/2016 1:00,34,9,25,2,11,wolkig
11/8/2016 2:00,12,3,9,2,9,Regen
11/8/2016 3:00,2,1,1,2,11,wolkig
11/8/2016 4:00,18,12,6,2,9,wolkig
11/8/2016 5:00,43,25,18,2,9,wolkig
11/8/2016 6:00,160,110,50,2,11,wolkig
11/8/2016 7:00,970,506,464,2,9,wolkig
11/8/2016 8:00,1243,754,489,2,7,wolkig
11/8/2016 9:00,1304,626,678,2,7,wolkig
11/8/2016 10:00,950,574,376,3,11,wolkig
11/8/2016 11:00,1087,541,546,3,7,wolkig
11/8/2016 12:00,1087,665,422,3,7,wolkig
11/8/2016 13:00,1280,633,647,3,7,wolkig
11/8/2016 14:00,970,570,400,4,13,wolkig
11/8/2016 15:00,1407,677,730,3,7,wolkig
11/8/2016 16:00,1173,651,522,2,6,teilweise bewölkt
11/8/2016 17:00,1383,635,748,0,4,Klarer Himmel
11/8/2016 18:00,1100,565,535,0,6,wolkig
11/8/2016 19:00,1041,504,537,0,6,wolkig
11/8/2016 20:00,645,314,331,0,6,wolkig
11/8/2016 21:00,449,172,277,0,6,
11/8/2016 22:00,451,166,285,0,7,
11/8/2016 23:00,208,74,134,0,7,wolkig
11/9/2016 0:00,123,31,92,1,9,wolkig
11/9/2016 1:00,63,27,36,1,11,Schnee
11/9/2016 2:00,31,13,18,1,7,wolkig
11/9/2016 3:00,17,6,11,1,7,wolkig
11/9/2016 4:00,27,17,10,0,6,teilweise bewölkt
11/9/2016 5:00,53,29,24,0,4,
11/9/2016 6:00,200,146,54,0,4,wolkig
11/9/2016 7:00,1011,593,418,0,6,teilweise bewölkt
11/9/2016 8:00,1257,736,521,0,6,teilweise bewölkt
11/9/2016 9:00,1080,524,556,1,6,wolkig
11/9/2016 10:00,887,524,363,2,9,teilweise bewölkt
11/9/2016 11:00,1001,529,472,3,7,teilweise bewölkt
11/9/2016 12:00,997,588,409,4,7,wolkig
11/9/2016 13:00,1166,591,575,4,11,wolkig
11/9/2016 14:00,993,571,422,5,11,Regen
11/9/2016 15:00,1258,581,677,4,7,Regen
11/9/2016 16:00,1075,546,529,4,6,Regen
11/9/2016 17:00,1369,627,742,4,7,Regen
11/9/2016 18:00,969,479,490,3,6,Regen
11/9/2016 19:00,928,440,488,3,7,Regen
11/9/2016 20:00,576,267,309,3,7,Regen
11/9/2016 21:00,411,191,220,3,6,Regen
11/9/2016 22:00,354,149,205,3,6,Regen
11/9/2016 23:00,338,101,237,3,4,wolkig
11/10/2016 0:00,192,75,117,3,4,wolkig
11/10/2016 1:00,132,38,94,3,4,wolkig
11/10/2016 2:00,65,11,54,3,6,wolkig
11/10/2016 3:00,69,5,64,3,4,wolkig
11/10/2016 4:00,52,15,37,3,2,wolkig
11/10/2016 5:00,57,31,26,3,4,wolkig
11/10/2016 6:00,165,111,54,3,4,wolkig
11/10/2016 7:00,945,550,395,3,2,Regen
11/10/2016 8:00,1126,639,487,3,2,Regen
11/10/2016 9:00,999,554,445,3,2,Regen
11/10/2016 10:00,642,494,148,4,0,wolkig
11/10/2016 11:00,932,416,516,4,4,wolkig
11/10/2016 12:00,802,440,362,4,7,wolkig
11/10/2016 13:00,1053,499,554,4,7,wolkig
11/10/2016 14:00,890,487,403,4,4,wolkig
11/10/2016 15:00,1138,520,618,4,6,wolkig
11/10/2016 16:00,1041,572,469,4,4,wolkig
11/10/2016 17:00,1285,649,636,4,4,wolkig
11/10/2016 18:00,1007,547,460,4,4,wolkig
11/10/2016 19:00,928,370,558,4,6,wolkig
11/10/2016 20:00,546,276,270,4,7,wolkig
11/10/2016 21:00,413,181,232,4,7,wolkig
11/10/2016 22:00,374,150,224,4,9,wolkig
11/10/2016 23:00,228,102,126,4,6,wolkig
11/11/2016 0:00,119,31,88,4,7,Regen
11/11/2016 1:00,82,22,60,4,15,Regen
11/11/2016 2:00,27,4,23,3,15,Regen
11/11/2016 3:00,29,3,26,3,13,Regen
11/11/2016 4:00,47,10,37,3,17,Regen
11/11/2016 5:00,53,28,25,3,22,wolkig
11/11/2016 6:00,170,108,62,3,24,wolkig
11/11/2016 7:00,822,479,343,3,17,wolkig
11/11/2016 8:00,990,579,411,2,20,wolkig
11/11/2016 9:00,849,413,436,2,15,wolkig
11/11/2016 10:00,801,511,290,2,19,wolkig
11/11/2016 11:00,846,497,349,3,19,teilweise bewölkt
11/11/2016 12:00,820,480,340,3,11,teilweise bewölkt
11/11/2016 13:00,952,444,508,3,17,teilweise bewölkt
11/11/2016 14:00,827,422,405,3,13,wolkig
11/11/2016 15:00,766,417,349,3,11,wolkig
11/11/2016 16:00,731,365,366,2,7,wolkig
11/11/2016 17:00,747,377,370,2,9,wolkig
11/11/2016 18:00,705,374,331,1,7,wolkig
11/11/2016 19:00,539,289,250,1,4,wolkig
11/11/2016 20:00,424,222,202,1,9,wolkig
11/11/2016 21:00,310,151,159,-1,4,teilweise bewölkt
11/11/2016 22:00,234,96,138,-2,2,
11/11/2016 23:00,238,89,149,-3,0,Nebel
11/12/2016 0:00,194,51,143,-3,0,Nebel
11/12/2016 1:00,136,48,88,-2,4,Nebel
11/12/2016 2:00,158,47,111,-2,4,Nebel
11/12/2016 3:00,97,12,85,-2,7,Nebel
11/12/2016 4:00,50,11,39,-2,6,Nebel
11/12/2016 5:00,44,12,32,-2,4,Nebel
11/12/2016 6:00,43,17,26,-2,6,Nebel
11/12/2016 7:00,118,88,30,-2,7,Nebel
11/12/2016 8:00,240,149,91,-2,9,Nebel
11/12/2016 9:00,323,213,110,-1,7,
11/12/2016 10:00,353,250,103,1,9,
11/12/2016 11:00,411,271,140,2,13,Klarer Himmel
11/12/2016 12:00,572,362,210,3,13,Klarer Himmel
11/12/2016 13:00,622,360,262,3,19,Klarer Himmel
11/12/2016 14:00,620,308,312,3,17,Klarer Himmel
11/12/2016 15:00,637,274,363,3,9,wolkig
11/12/2016 16:00,509,223,286,1,6,Klarer Himmel
11/12/2016 17:00,479,210,269,1,9,wolkig
11/12/2016 18:00,448,203,245,1,9,Klarer Himmel
11/12/2016 19:00,419,205,214,1,11,Klarer Himmel
11/12/2016 20:00,351,184,167,1,9,Klarer Himmel
11/12/2016 21:00,283,150,133,1,7,Klarer Himmel
11/12/2016 22:00,232,96,136,1,11,Klarer Himmel
11/12/2016 23:00,234,85,149,1,7,Klarer Himmel
11/13/2016 0:00,216,94,122,1,7,Klarer Himmel
11/13/2016 1:00,175,62,113,1,7,Klarer Himmel
11/13/2016 2:00,171,50,121,1,7,Klarer Himmel
11/13/2016 3:00,110,35,75,1,7,Klarer Himmel
11/13/2016 4:00,63,13,50,1,7,Klarer Himmel
11/13/2016 5:00,51,16,35,1,11,Klarer Himmel
11/13/2016 6:00,39,17,22,1,9,Klarer Himmel
11/13/2016 7:00,61,39,22,1,11,Klarer Himmel
11/13/2016 8:00,64,36,28,1,7,Klarer Himmel
11/13/2016 9:00,187,137,50,1,9,Klarer Himmel
11/13/2016 10:00,215,132,83,2,9,Klarer Himmel
11/13/2016 11:00,237,134,103,3,11,Klarer Himmel
11/13/2016 12:00,244,113,131,3,7,Klarer Himmel
11/13/2016 13:00,322,183,139,4,7,Klarer Himmel
11/13/2016 14:00,395,201,194,4,6,Klarer Himmel
11/13/2016 15:00,376,205,171,3,6,Klarer Himmel
11/13/2016 16:00,364,194,170,2,6,Klarer Himmel
11/13/2016 17:00,356,149,207,1,6,Klarer Himmel
11/13/2016 18:00,373,197,176,1,6,Klarer Himmel
11/13/2016 19:00,284,131,153,0,4,Klarer Himmel
11/13/2016 20:00,238,90,148,-1,4,Klarer Himmel
11/13/2016 21:00,146,54,92,0,6,Klarer Himmel
11/13/2016 22:00,216,56,160,-1,4,Klarer Himmel
11/13/2016 23:00,98,25,73,-2,4,Klarer Himmel
11/14/2016 0:00,37,11,26,-2,6,Klarer Himmel
11/14/2016 1:00,24,8,16,-2,2,Klarer Himmel
11/14/2016 2:00,15,3,12,-2,2,Klarer Himmel
11/14/2016 3:00,6,4,2,-2,4,Klarer Himmel
11/14/2016 4:00,9,7,2,-3,4,Klarer Himmel
11/14/2016 5:00,53,34,19,-3,4,Klarer Himmel
11/14/2016 6:00,166,115,51,-3,6,Klarer Himmel
11/14/2016 7:00,918,542,376,-3,7,Klarer Himmel
11/14/2016 8:00,1109,649,460,-2,6,Klarer Himmel
11/14/2016 9:00,1028,481,547,0,11,Klarer Himmel
11/14/2016 10:00,802,507,295,2,9,Klarer Himmel
11/14/2016 11:00,989,448,541,3,11,Klarer Himmel
11/14/2016 12:00,894,482,412,4,15,Klarer Himmel
11/14/2016 13:00,1094,530,564,4,13,Klarer Himmel
11/14/2016 14:00,878,495,383,4,11,Klarer Himmel
11/14/2016 15:00,1261,620,641,4,6,Klarer Himmel
11/14/2016 16:00,1062,600,462,4,6,Klarer Himmel
11/14/2016 17:00,1511,686,825,4,7,wolkig
11/14/2016 18:00,1103,544,559,3,6,Regen
11/14/2016 19:00,946,419,527,4,11,Regen
11/14/2016 20:00,531,226,305,4,15,Regen
11/14/2016 21:00,454,190,264,4,17,Regen
11/14/2016 22:00,335,116,219,3,17,wolkig
11/14/2016 23:00,145,64,81,3,15,Regen
11/15/2016 0:00,73,28,45,3,13,Regen
11/15/2016 1:00,39,10,29,3,11,Regen
11/15/2016 2:00,5,5,0,3,11,Regen
11/15/2016 3:00,8,6,2,3,11,Regen
11/15/2016 4:00,16,10,6,4,11,Regen
11/15/2016 5:00,46,33,13,5,11,Regen
11/15/2016 6:00,146,100,46,5,11,Regen
11/15/2016 7:00,892,468,424,6,13,Regen
11/15/2016 8:00,1150,696,454,6,13,Regen
11/15/2016 9:00,1145,532,613,6,15,Regen
11/15/2016 10:00,834,561,273,7,13,Regen
11/15/2016 11:00,1016,502,514,7,15,Regen
11/15/2016 12:00,940,575,365,8,17,Regen
11/15/2016 13:00,1128,534,594,8,15,Regen
11/15/2016 14:00,883,537,346,9,15,Regen
11/15/2016 15:00,1076,491,585,9,13,Regen
11/15/2016 16:00,1041,572,469,9,15,wolkig
11/15/2016 17:00,1261,583,678,10,15,Regen
11/15/2016 18:00,1078,560,518,,,
11/15/2016 19:00,913,447,466,10,11,Regen
11/15/2016 20:00,546,218,328,10,11,Regen
11/15/2016 21:00,411,160,251,10,11,Regen
11/15/2016 22:00,413,163,250,10,9,Regen
11/15/2016 23:00,209,65,144,10,9,wolkig
11/16/2016 0:00,111,40,71,10,6,Regen
11/16/2016 1:00,44,11,33,10,6,wolkig
11/16/2016 2:00,12,7,5,10,7,wolkig
11/16/2016 3:00,11,5,6,10,7,Nebel
11/16/2016 4:00,15,8,7,10,7,Nebel
11/16/2016 5:00,50,34,16,10,7,Regen
11/16/2016 6:00,192,139,53,10,11,Regen
11/16/2016 7:00,835,497,338,10,13,Regen
11/16/2016 8:00,1153,704,449,11,15,Regen
11/16/2016 9:00,857,400,457,12,17,Regen
11/16/2016 10:00,727,428,299,13,19,wolkig
11/16/2016 11:00,856,477,379,13,20,Regen
11/16/2016 12:00,896,531,365,13,19,Regen
11/16/2016 13:00,1025,540,485,13,20,wolkig
11/16/2016 14:00,851,478,373,13,24,wolkig
11/16/2016 15:00,1149,537,612,13,24,wolkig
11/16/2016 16:00,1079,585,494,12,17,wolkig
11/16/2016 17:00,1297,647,650,12,17,wolkig
11/16/2016 18:00,1054,519,535,12,15,wolkig
11/16/2016 19:00,919,449,470,12,24,wolkig
11/16/2016 20:00,629,327,302,11,19,wolkig
11/16/2016 21:00,482,245,237,11,20,teilweise bewölkt
11/16/2016 22:00,392,140,252,11,17,teilweise bewölkt
11/16/2016 23:00,269,106,163,11,20,wolkig
11/17/2016 0:00,195,89,106,11,24,Regen
11/17/2016 1:00,147,64,83,10,20,wolkig
11/17/2016 2:00,84,18,66,9,11,wolkig
11/17/2016 3:00,92,9,83,9,11,Regen
11/17/2016 4:00,84,18,66,9,9,Regen
11/17/2016 5:00,105,29,76,8,6,Regen
11/17/2016 6:00,141,92,49,8,6,Regen
11/17/2016 7:00,797,460,337,8,6,wolkig
11/17/2016 8:00,1085,624,461,8,13,Regen
11/17/2016 9:00,1002,535,467,9,15,wolkig
11/17/2016 10:00,901,564,337,9,17,wolkig
11/17/2016 11:00,1047,530,517,10,22,wolkig
11/17/2016 12:00,946,505,441,11,20,wolkig
11/17/2016 13:00,1175,591,584,11,24,wolkig
11/17/2016 14:00,903,508,395,10,22,wolkig
11/17/2016 15:00,1147,546,601,10,17,teilweise bewölkt
11/17/2016 16:00,999,544,455,9,20,wolkig
11/17/2016 17:00,1236,645,591,9,19,wolkig
11/17/2016 18:00,1023,536,487,11,26,Regen
11/17/2016 19:00,868,396,472,10,28,Regen
11/17/2016 20:00,545,254,291,10,24,Regen
11/17/2016 21:00,430,186,244,11,20,wolkig
11/17/2016 22:00,334,124,210,12,22,wolkig
11/17/2016 23:00,244,95,149,11,22,wolkig
11/18/2016 0:00,138,43,95,11,19,Regen
11/18/2016 1:00,96,24,72,8,24,Regen
11/18/2016 2:00,47,13,34,8,7,Regen
11/18/2016 3:00,36,9,27,7,9,Regen
11/18/2016 4:00,57,11,46,7,4,Regen
11/18/2016 5:00,47,25,22,6,19,Regen
11/18/2016 6:00,143,93,50,6,13,teilweise bewölkt
11/18/2016 7:00,690,407,283,5,17,wolkig
11/18/2016 8:00,935,544,391,5,15,teilweise bewölkt
11/18/2016 9:00,870,458,412,6,19,teilweise bewölkt
11/18/2016 10:00,819,561,258,8,20,wolkig
11/18/2016 11:00,799,460,339,9,22,wolkig
11/18/2016 12:00,812,465,347,8,22,teilweise bewölkt
11/18/2016 13:00,1033,501,532,9,28,teilweise bewölkt
11/18/2016 14:00,858,470,388,9,26,teilweise bewölkt
11/18/2016 15:00,879,471,408,8,28,teilweise bewölkt
11/18/2016 16:00,741,426,315,7,20,teilweise bewölkt
11/18/2016 17:00,834,420,414,6,11,Klarer Himmel
11/18/2016 18:00,654,297,357,6,9,Regen
11/18/2016 19:00,594,340,254,5,19,teilweise bewölkt
11/18/2016 20:00,469,251,218,6,30,wolkig
11/18/2016 21:00,350,200,150,6,19,wolkig
11/18/2016 22:00,305,126,179,6,17,wolkig
11/18/2016 23:00,292,112,180,5,9,teilweise bewölkt
11/19/2016 0:00,242,78,164,6,9,wolkig
11/19/2016 1:00,192,56,136,4,9,teilweise bewölkt
11/19/2016 2:00,188,32,156,4,13,teilweise bewölkt
11/19/2016 3:00,113,26,87,4,13,teilweise bewölkt
11/19/2016 4:00,76,19,57,4,11,teilweise bewölkt
11/19/2016 5:00,48,18,30,4,11,teilweise bewölkt
11/19/2016 6:00,47,38,9,5,15,wolkig
11/19/2016 7:00,114,95,19,5,15,wolkig
11/19/2016 8:00,225,146,79,6,7,wolkig
11/19/2016 9:00,375,272,103,6,13,wolkig
11/19/2016 10:00,368,273,95,7,15,Regen
11/19/2016 11:00,408,258,150,6,17,Regen
11/19/2016 12:00,468,270,198,7,19,teilweise bewölkt
11/19/2016 13:00,549,309,240,7,22,teilweise bewölkt
11/19/2016 14:00,521,253,268,7,26,teilweise bewölkt
11/19/2016 15:00,516,284,232,7,17,teilweise bewölkt
11/19/2016 16:00,477,228,249,6,11,
11/19/2016 17:00,482,211,271,6,11,Klarer Himmel
11/19/2016 18:00,510,241,269,5,7,Klarer Himmel
11/19/2016 19:00,384,202,182,5,11,Klarer Himmel
11/19/2016 20:00,347,166,181,5,9,teilweise bewölkt
11/19/2016 21:00,290,149,141,4,9,teilweise bewölkt
11/19/2016 22:00,235,90,145,5,11,wolkig
11/19/2016 23:00,253,87,166,5,13,wolkig
11/20/2016 0:00,238,121,117,5,15,Klarer Himmel
11/20/2016 1:00,225,85,140,4,11,Klarer Himmel
11/20/2016 2:00,147,46,101,4,13,Klarer Himmel
11/20/2016 3:00,125,25,100,5,11,Klarer Himmel
11/20/2016 4:00,88,26,62,5,13,Klarer Himmel
11/20/2016 5:00,84,13,71,5,13,Klarer Himmel
11/20/2016 6:00,43,28,15,5,17,Klarer Himmel
11/20/2016 7:00,31,17,14,6,22,Klarer Himmel
11/20/2016 8:00,65,51,14,7,24,wolkig
11/20/2016 9:00,136,96,40,7,22,Regen
11/20/2016 10:00,149,102,47,7,17,wolkig
11/20/2016 11:00,181,107,74,10,30,teilweise bewölkt
11/20/2016 12:00,224,122,102,11,30,wolkig
11/20/2016 13:00,272,149,123,13,32,wolkig
11/20/2016 14:00,271,137,134,14,35,Klarer Himmel
11/20/2016 15:00,277,142,135,14,30,Klarer Himmel
11/20/2016 16:00,314,141,173,14,35,Klarer Himmel
11/20/2016 17:00,290,105,185,14,28,wolkig
11/20/2016 18:00,344,172,172,12,26,wolkig
11/20/2016 19:00,312,149,163,12,26,teilweise bewölkt
11/20/2016 20:00,222,81,141,12,19,wolkig
11/20/2016 21:00,162,51,111,11,7,teilweise bewölkt
11/20/2016 22:00,153,45,108,12,11,wolkig
11/20/2016 23:00,90,31,59,11,13,Regen
11/21/2016 0:00,44,16,28,10,6,Regen
11/21/2016 1:00,25,10,15,10,6,teilweise bewölkt
11/21/2016 2:00,8,7,1,10,7,wolkig
11/21/2016 3:00,10,5,5,10,11,wolkig
11/21/2016 4:00,19,14,5,10,11,wolkig
11/21/2016 5:00,51,34,17,11,11,Regen
11/21/2016 6:00,183,126,57,12,11,wolkig
11/21/2016 7:00,842,529,313,12,11,wolkig
11/21/2016 8:00,1103,640,463,12,13,Regen
11/21/2016 9:00,925,487,438,13,17,Regen
11/21/2016 10:00,831,523,308,12,13,Regen
11/21/2016 11:00,796,376,420,13,20,Regen
11/21/2016 12:00,769,429,340,12,9,Regen
11/21/2016 13:00,965,483,482,12,6,Regen
11/21/2016 14:00,838,473,365,13,11,Regen
11/21/2016 15:00,1178,567,611,13,9,Regen
11/21/2016 16:00,1100,604,496,13,11,wolkig
11/21/2016 17:00,1507,702,805,13,11,Klarer Himmel
11/21/2016 18:00,1086,581,505,12,7,Klarer Himmel
11/21/2016 19:00,1022,454,568,12,9,Klarer Himmel
11/21/2016 20:00,703,242,461,12,7,wolkig
11/21/2016 21:00,440,151,289,13,7,wolkig
11/21/2016 22:00,356,103,253,13,11,wolkig
11/21/2016 23:00,213,54,159,14,22,Klarer Himmel
11/22/2016 0:00,113,41,72,14,20,Klarer Himmel
11/22/2016 1:00,39,14,25,14,22,Klarer Himmel
11/22/2016 2:00,14,5,9,13,17,Klarer Himmel
11/22/2016 3:00,7,4,3,13,22,Klarer Himmel
11/22/2016 4:00,19,13,6,13,15,Klarer Himmel
11/22/2016 5:00,42,29,13,12,13,Klarer Himmel
11/22/2016 6:00,186,125,61,11,9,Klarer Himmel
11/22/2016 7:00,941,507,434,10,9,Klarer Himmel
11/22/2016 8:00,1380,860,520,11,9,Klarer Himmel
11/22/2016 9:00,1265,578,687,12,9,Klarer Himmel
11/22/2016 10:00,903,586,317,12,11,Klarer Himmel
11/22/2016 11:00,1110,581,529,13,11,Klarer Himmel
11/22/2016 12:00,1123,684,439,14,13,Klarer Himmel
11/22/2016 13:00,1196,600,596,14,13,Klarer Himmel
11/22/2016 14:00,1036,582,454,13,11,Klarer Himmel
11/22/2016 15:00,1420,702,718,12,7,Klarer Himmel
11/22/2016 16:00,1302,690,612,12,7,Klarer Himmel
11/22/2016 17:00,1392,638,754,11,6,Klarer Himmel
11/22/2016 18:00,1159,575,584,11,6,Klarer Himmel
11/22/2016 19:00,1065,470,595,11,4,Regen
11/22/2016 20:00,737,263,474,10,4,Regen
11/22/2016 21:00,394,129,265,9,7,Regen
11/22/2016 22:00,532,136,396,9,7,Klarer Himmel
11/22/2016 23:00,276,67,209,9,4,wolkig
11/23/2016 0:00,165,43,122,9,2,wolkig
11/23/2016 1:00,83,42,41,8,2,
11/23/2016 2:00,66,47,19,9,2,wolkig
11/23/2016 3:00,64,55,9,9,0,wolkig
11/23/2016 4:00,32,27,5,8,2,wolkig
11/23/2016 5:00,47,31,16,9,0,wolkig
11/23/2016 6:00,190,129,61,8,0,teilweise bewölkt
11/23/2016 7:00,921,504,417,7,0,Nebel
11/23/2016 8:00,1179,791,388,7,0,Nebel
11/23/2016 9:00,1064,549,515,7,2,Nebel
11/23/2016 10:00,925,579,346,9,2,Klarer Himmel
11/23/2016 11:00,1012,576,436,10,4,Klarer Himmel
11/23/2016 12:00,1026,637,389,12,7,Klarer Himmel
11/23/2016 13:00,1197,609,588,12,6,Klarer Himmel
11/23/2016 14:00,1048,553,495,12,4,Klarer Himmel
11/23/2016 15:00,1267,663,604,11,9,Klarer Himmel
11/23/2016 16:00,1253,640,613,9,6,Klarer Himmel
11/23/2016 17:00,1394,726,668,9,6,Klarer Himmel
11/23/2016 18:00,1234,603,631,9,4,Klarer Himmel
11/23/2016 19:00,1115,480,635,8,7,Klarer Himmel
11/23/2016 20:00,813,274,539,9,9,Klarer Himmel
11/23/2016 21:00,546,192,354,9,9,Klarer Himmel
11/23/2016 22:00,485,142,343,9,7,Klarer Himmel
11/23/2016 23:00,318,91,227,8,11,Klarer Himmel
11/24/2016 0:00,237,107,130,8,11,Klarer Himmel
11/24/2016 1:00,137,40,97,8,11,Klarer Himmel
11/24/2016 2:00,94,13,81,8,9,Klarer Himmel
11/24/2016 3:00,58,15,43,8,17,Klarer Himmel
11/24/2016 4:00,55,17,38,7,17,Klarer Himmel
11/24/2016 5:00,48,28,20,8,13,wolkig
11/24/2016 6:00,168,109,59,8,20,wolkig
11/24/2016 7:00,885,484,401,7,19,wolkig
11/24/2016 8:00,1212,705,507,7,17,wolkig
11/24/2016 9:00,1161,658,503,7,17,wolkig
11/24/2016 10:00,963,620,343,7,17,wolkig
11/24/2016 11:00,1183,541,642,7,15,wolkig
11/24/2016 12:00,928,508,420,7,13,wolkig
11/24/2016 13:00,1246,653,593,7,19,wolkig
11/24/2016 14:00,1002,547,455,7,22,wolkig
11/24/2016 15:00,1320,650,670,7,20,Klarer Himmel
11/24/2016 16:00,1282,725,557,6,17,Klarer Himmel
11/24/2016 17:00,1466,759,707,6,19,Klarer Himmel
11/24/2016 18:00,1034,502,532,5,13,Klarer Himmel
11/24/2016 19:00,977,405,572,5,11,Klarer Himmel
11/24/2016 20:00,588,193,395,5,13,teilweise bewölkt
11/24/2016 21:00,444,155,289,4,15,Klarer Himmel
11/24/2016 22:00,375,112,263,4,9,Klarer Himmel
11/24/2016 23:00,287,137,150,3,17,Klarer Himmel
11/25/2016 0:00,220,116,104,3,11,Klarer Himmel
11/25/2016 1:00,107,32,75,2,7,Klarer Himmel
11/25/2016 2:00,99,20,79,2,9,Klarer Himmel
11/25/2016 3:00,76,6,70,1,9,teilweise bewölkt
11/25/2016 4:00,45,11,34,1,13,teilweise bewölkt
11/25/2016 5:00,39,19,20,1,11,
11/25/2016 6:00,144,89,55,1,11,Klarer Himmel
11/25/2016 7:00,719,397,322,2,6,Klarer Himmel
11/25/2016 8:00,1065,630,435,2,9,Klarer Himmel
11/25/2016 9:00,924,466,458,3,13,Klarer Himmel
11/25/2016 10:00,838,555,283,4,13,Klarer Himmel
11/25/2016 11:00,911,515,396,6,11,Klarer Himmel
11/25/2016 12:00,808,481,327,7,13,Klarer Himmel
11/25/2016 13:00,1096,571,525,6,17,Klarer Himmel
11/25/2016 14:00,932,483,449,6,15,Klarer Himmel
11/25/2016 15:00,1049,535,514,4,11,Klarer Himmel
11/25/2016 16:00,893,492,401,2,11,Klarer Himmel
11/25/2016 17:00,802,378,424,1,7,Klarer Himmel
11/25/2016 18:00,804,389,415,1,6,Klarer Himmel
11/25/2016 19:00,658,301,357,0,11,Klarer Himmel
11/25/2016 20:00,554,218,336,0,6,
11/25/2016 21:00,458,150,308,0,6,
11/25/2016 22:00,278,76,202,-1,7,
11/25/2016 23:00,287,77,210,0,6,
11/26/2016 0:00,254,86,168,-1,2,
11/26/2016 1:00,189,66,123,-2,4,Nebel
11/26/2016 2:00,162,61,101,-2,2,
11/26/2016 3:00,126,50,76,-3,6,Nebel
11/26/2016 4:00,51,24,27,-3,6,Nebel
11/26/2016 5:00,57,20,37,-3,4,Nebel
11/26/2016 6:00,46,28,18,-4,0,Nebel
11/26/2016 7:00,92,67,25,-3,2,Nebel
11/26/2016 8:00,200,139,61,-3,4,Nebel
11/26/2016 9:00,370,269,101,-3,2,Nebel
11/26/2016 10:00,443,309,134,-1,2,wolkig
11/26/2016 11:00,450,283,167,-1,9,Nebel
11/26/2016 12:00,556,342,214,-1,4,Nebel
11/26/2016 13:00,564,308,256,-1,6,Nebel
11/26/2016 14:00,504,245,259,-1,6,Nebel
11/26/2016 15:00,492,236,256,-1,6,Nebel
11/26/2016 16:00,449,224,225,-1,4,Nebel
11/26/2016 17:00,463,188,275,-1,2,Nebel
11/26/2016 18:00,495,250,245,-2,4,Nebel
11/26/2016 19:00,404,188,216,-2,4,Nebel
11/26/2016 20:00,354,142,212,-2,4,Nebel
11/26/2016 21:00,300,150,150,-1,0,wolkig
11/26/2016 22:00,179,63,116,-1,4,wolkig
11/26/2016 23:00,209,63,146,-1,4,wolkig
11/27/2016 0:00,197,62,135,0,2,Regen
11/27/2016 1:00,191,56,135,0,2,wolkig
11/27/2016 2:00,144,37,107,0,0,Regen
11/27/2016 3:00,96,11,85,1,0,wolkig
11/27/2016 4:00,60,9,51,1,4,wolkig
11/27/2016 5:00,47,10,37,2,0,Nebel
11/27/2016 6:00,28,12,16,2,4,wolkig
11/27/2016 7:00,34,16,18,4,7,wolkig
11/27/2016 8:00,62,49,13,4,9,wolkig
11/27/2016 9:00,195,158,37,5,11,wolkig
11/27/2016 10:00,227,164,63,6,9,wolkig
11/27/2016 11:00,241,125,116,7,9,wolkig
11/27/2016 12:00,274,143,131,8,9,wolkig
11/27/2016 13:00,310,173,137,8,9,wolkig
11/27/2016 14:00,346,207,139,9,7,wolkig
11/27/2016 15:00,393,236,157,7,6,wolkig
11/27/2016 16:00,407,200,207,4,0,Nebel
11/27/2016 17:00,438,249,189,3,0,Nebel
11/27/2016 18:00,390,191,199,1,0,Nebel
11/27/2016 19:00,334,100,234,0,0,Nebel
11/27/2016 20:00,316,77,239,-1,6,Nebel
11/27/2016 21:00,184,53,131,0,11,Klarer Himmel
11/27/2016 22:00,161,31,130,1,11,Klarer Himmel
11/27/2016 23:00,83,15,68,0,6,Klarer Himmel
11/28/2016 0:00,33,10,23,-1,6,Nebel
11/28/2016 1:00,21,7,14,-2,2,Nebel
11/28/2016 2:00,11,3,8,-3,4,Nebel
11/28/2016 3:00,7,4,3,-5,7,Nebel
11/28/2016 4:00,11,7,4,-3,2,Nebel
11/28/2016 5:00,42,23,19,-5,6,Nebel
11/28/2016 6:00,148,98,50,-5,4,Nebel
11/28/2016 7:00,793,471,322,-4,2,Klarer Himmel
11/28/2016 8:00,1077,651,426,-5,7,Klarer Himmel
11/28/2016 9:00,972,469,503,-1,7,Klarer Himmel
11/28/2016 10:00,818,494,324,1,11,Klarer Himmel
11/28/2016 11:00,941,420,521,2,13,Klarer Himmel
11/28/2016 12:00,920,528,392,3,13,Klarer Himmel
11/28/2016 13:00,1082,517,565,3,7,teilweise bewölkt
11/28/2016 14:00,886,491,395,3,9,Klarer Himmel
11/28/2016 15:00,1433,786,647,2,7,Klarer Himmel
11/28/2016 16:00,1218,595,623,0,6,Klarer Himmel
11/28/2016 17:00,1311,590,721,-2,2,Klarer Himmel
11/28/2016 18:00,1087,575,512,-3,2,Klarer Himmel
11/28/2016 19:00,971,339,632,-4,2,Klarer Himmel
11/28/2016 20:00,582,183,399,-4,2,Klarer Himmel
11/28/2016 21:00,430,135,295,-5,2,Nebel
11/28/2016 22:00,534,119,415,-4,6,Nebel
11/28/2016 23:00,153,55,98,-5,6,Nebel
11/29/2016 0:00,77,26,51,-5,0,Nebel
11/29/2016 1:00,43,12,31,-5,0,Nebel
11/29/2016 2:00,8,5,3,-6,2,Nebel
11/29/2016 3:00,1,0,1,-7,0,Nebel
11/29/2016 4:00,17,7,10,-7,2,Nebel
11/29/2016 5:00,41,21,20,-7,2,Nebel
11/29/2016 6:00,158,106,52,-7,0,Nebel
11/29/2016 7:00,797,396,401,-7,0,Nebel
11/29/2016 8:00,1232,699,533,-7,0,
11/29/2016 9:00,1174,526,648,-5,2,
11/29/2016 10:00,922,557,365,-2,2,Klarer Himmel
11/29/2016 11:00,1053,533,520,0,4,Klarer Himmel
11/29/2016 12:00,1044,623,421,1,4,Klarer Himmel
11/29/2016 13:00,1199,548,651,1,6,Klarer Himmel
11/29/2016 14:00,977,555,422,2,4,Klarer Himmel
11/29/2016 15:00,1296,629,667,0,2,Klarer Himmel
11/29/2016 16:00,1163,608,555,-3,2,Nebel
11/29/2016 17:00,1299,594,705,-3,0,Nebel
11/29/2016 18:00,1170,622,548,-4,6,Nebel
11/29/2016 19:00,978,429,549,-5,4,Nebel
11/29/2016 20:00,619,184,435,-6,2,Nebel
11/29/2016 21:00,410,111,299,-6,4,Nebel
11/29/2016 22:00,456,105,351,-6,6,Klarer Himmel
11/29/2016 23:00,220,53,167,-7,2,Klarer Himmel
11/30/2016 0:00,95,20,75,-7,2,Klarer Himmel
11/30/2016 1:00,49,5,44,-7,0,Klarer Himmel
11/30/2016 2:00,34,4,30,-8,7,Klarer Himmel
11/30/2016 3:00,14,8,6,-8,2,Klarer Himmel
11/30/2016 4:00,16,10,6,-7,4,Klarer Himmel
11/30/2016 5:00,38,20,18,-7,4,Klarer Himmel
11/30/2016 6:00,158,104,54,-6,2,Klarer Himmel
11/30/2016 7:00,750,399,351,-7,2,Klarer Himmel
11/30/2016 8:00,1099,618,481,-7,4,Klarer Himmel
11/30/2016 9:00,957,462,495,-4,4,wolkig
11/30/2016 10:00,830,486,344,-2,7,wolkig
11/30/2016 11:00,962,517,445,0,11,wolkig
11/30/2016 12:00,900,559,341,2,13,wolkig
11/30/2016 13:00,1055,529,526,2,15,wolkig
11/30/2016 14:00,918,514,404,2,19,wolkig
11/30/2016 15:00,1087,546,541,2,17,wolkig
11/30/2016 16:00,1111,584,527,3,19,wolkig
11/30/2016 17:00,1269,622,647,3,17,wolkig
11/30/2016 18:00,1069,505,564,4,17,wolkig
11/30/2016 19:00,999,423,576,3,17,wolkig
11/30/2016 20:00,699,250,449,4,17,wolkig
11/30/2016 21:00,527,186,341,4,19,wolkig
11/30/2016 22:00,431,159,272,4,15,wolkig
11/30/2016 23:00,279,94,185,4,19,wolkig
12/1/2016 0:00,226,76,150,4,17,wolkig
12/1/2016 1:00,121,29,92,4,17,wolkig
12/1/2016 2:00,95,8,87,4,22,wolkig
12/1/2016 3:00,59,6,53,4,20,wolkig
12/1/2016 4:00,36,11,25,4,17,wolkig
12/1/2016 5:00,52,26,26,4,17,wolkig
12/1/2016 6:00,137,97,40,4,19,wolkig
12/1/2016 7:00,697,389,308,5,20,wolkig
12/1/2016 8:00,1178,685,493,5,20,wolkig
12/1/2016 9:00,1023,561,462,5,20,wolkig
12/1/2016 10:00,858,555,303,5,20,wolkig
12/1/2016 11:00,980,469,511,6,24,wolkig
12/1/2016 12:00,908,488,420,6,26,wolkig
12/1/2016 13:00,1121,545,576,6,28,wolkig
12/1/2016 14:00,998,503,495,7,24,wolkig
12/1/2016 15:00,1235,600,635,7,22,wolkig
12/1/2016 16:00,1074,581,493,7,22,wolkig
12/1/2016 17:00,1302,615,687,7,22,wolkig
12/1/2016 18:00,1147,623,524,8,24,wolkig
12/1/2016 19:00,917,355,562,8,24,wolkig
12/1/2016 20:00,680,246,434,8,28,wolkig
12/1/2016 21:00,460,177,283,8,20,wolkig
12/1/2016 22:00,399,140,259,8,19,wolkig
12/1/2016 23:00,240,66,174,9,22,wolkig
12/2/2016 0:00,161,63,98,8,19,wolkig
12/2/2016 1:00,100,22,78,8,19,Regen
12/2/2016 2:00,56,8,48,8,20,Regen
12/2/2016 3:00,70,14,56,8,19,Regen
12/2/2016 4:00,50,10,40,7,17,wolkig
12/2/2016 5:00,59,22,37,8,17,Regen
12/2/2016 6:00,130,93,37,8,17,Regen
12/2/2016 7:00,634,359,275,7,9,wolkig
12/2/2016 8:00,968,555,413,8,9,wolkig
12/2/2016 9:00,888,428,460,7,11,teilweise bewölkt
12/2/2016 10:00,804,514,290,8,9,teilweise bewölkt
12/2/2016 11:00,824,489,335,8,11,teilweise bewölkt
12/2/2016 12:00,968,613,355,8,15,teilweise bewölkt
12/2/2016 13:00,1033,539,494,8,13,teilweise bewölkt
12/2/2016 14:00,852,455,397,7,13,teilweise bewölkt
12/2/2016 15:00,866,488,378,7,11,Klarer Himmel
12/2/2016 16:00,781,386,395,4,2,Klarer Himmel
12/2/2016 17:00,805,394,411,2,0,Klarer Himmel
12/2/2016 18:00,777,397,380,1,0,Klarer Himmel
12/2/2016 19:00,646,301,345,0,0,Nebel
12/2/2016 20:00,566,219,347,-1,0,Nebel
12/2/2016 21:00,495,148,347,-2,0,Nebel
12/2/2016 22:00,384,125,259,-2,0,Nebel
12/2/2016 23:00,329,83,246,-3,0,Nebel
12/3/2016 0:00,268,71,197,-2,2,Nebel
12/3/2016 1:00,282,93,189,-3,2,Nebel
12/3/2016 2:00,188,68,120,-3,2,
12/3/2016 3:00,183,98,85,-2,4,wolkig
12/3/2016 4:00,90,54,36,-3,0,wolkig
12/3/2016 5:00,66,39,27,-3,4,Nebel
12/3/2016 6:00,42,26,16,-3,2,Nebel
12/3/2016 7:00,90,79,11,-2,4,Nebel
12/3/2016 8:00,238,186,52,-2,2,wolkig
12/3/2016 9:00,357,236,121,-1,4,wolkig
12/3/2016 10:00,390,276,114,0,6,wolkig
12/3/2016 11:00,499,326,173,0,4,wolkig
12/3/2016 12:00,519,339,180,1,4,wolkig
12/3/2016 13:00,533,283,250,2,2,teilweise bewölkt
12/3/2016 14:00,552,292,260,3,4,teilweise bewölkt
12/3/2016 15:00,591,305,286,2,4,teilweise bewölkt
12/3/2016 16:00,522,255,267,0,2,Nebel
12/3/2016 17:00,508,237,271,-2,0,Nebel
12/3/2016 18:00,493,222,271,-2,0,Nebel
12/3/2016 19:00,440,215,225,-3,0,Nebel
12/3/2016 20:00,390,143,247,-3,0,Nebel
12/3/2016 21:00,347,99,248,-4,4,Nebel
12/3/2016 22:00,258,63,195,-4,0,Nebel
12/3/2016 23:00,245,58,187,-4,0,Nebel
12/4/2016 0:00,207,82,125,-5,4,Nebel
12/4/2016 1:00,194,58,136,-5,4,Nebel
12/4/2016 2:00,151,51,100,-4,2,Nebel
12/4/2016 3:00,114,33,81,-5,2,Nebel
12/4/2016 4:00,65,18,47,-6,4,Nebel
12/4/2016 5:00,46,7,39,-5,6,Nebel
12/4/2016 6:00,30,16,14,-6,4,Nebel
12/4/2016 7:00,31,16,15,-6,2,Nebel
12/4/2016 8:00,69,44,25,-6,2,Klarer Himmel
12/4/2016 9:00,173,125,48,-3,0,Klarer Himmel
12/4/2016 10:00,259,176,83,-1,0,Klarer Himmel
12/4/2016 11:00,251,148,103,1,4,Klarer Himmel
12/4/2016 12:00,284,171,113,3,4,Klarer Himmel
12/4/2016 13:00,310,172,138,5,6,Klarer Himmel
12/4/2016 14:00,409,225,184,5,4,Klarer Himmel
12/4/2016 15:00,425,223,202,4,4,Klarer Himmel
12/4/2016 16:00,375,170,205,0,6,Klarer Himmel
12/4/2016 17:00,404,166,238,-2,4,Klarer Himmel
12/4/2016 18:00,389,157,232,-2,6,Klarer Himmel
12/4/2016 19:00,322,110,212,-2,6,Klarer Himmel
12/4/2016 20:00,236,69,167,0,4,Klarer Himmel
12/4/2016 21:00,163,51,112,-1,4,Klarer Himmel
12/4/2016 22:00,181,47,134,-2,6,Klarer Himmel
12/4/2016 23:00,91,31,60,-4,2,Klarer Himmel
12/5/2016 0:00,39,9,30,-4,4,Klarer Himmel
12/5/2016 1:00,33,13,20,-4,4,Klarer Himmel
12/5/2016 2:00,6,1,5,-4,2,Klarer Himmel
12/5/2016 3:00,4,1,3,-4,4,Klarer Himmel
12/5/2016 4:00,10,5,5,-5,2,Klarer Himmel
12/5/2016 5:00,45,24,21,-6,4,Klarer Himmel
12/5/2016 6:00,154,105,49,-7,2,Klarer Himmel
12/5/2016 7:00,668,396,272,-6,0,Klarer Himmel
12/5/2016 8:00,1072,622,450,-7,2,Klarer Himmel
12/5/2016 9:00,885,434,451,-4,0,Klarer Himmel
12/5/2016 10:00,835,514,321,0,0,Klarer Himmel
12/5/2016 11:00,921,419,502,2,4,Klarer Himmel
12/5/2016 12:00,821,441,380,4,0,Klarer Himmel
12/5/2016 13:00,1029,528,501,4,2,Klarer Himmel
12/5/2016 14:00,907,499,408,5,0,Klarer Himmel
12/5/2016 15:00,1225,591,634,4,0,Klarer Himmel
12/5/2016 16:00,1077,600,477,-1,0,Klarer Himmel
12/5/2016 17:00,1348,556,792,-3,0,Klarer Himmel
12/5/2016 18:00,1125,530,595,-4,0,Klarer Himmel
12/5/2016 19:00,952,349,603,-4,2,Klarer Himmel
12/5/2016 20:00,635,196,439,-5,0,Klarer Himmel
12/5/2016 21:00,435,138,297,-6,0,Klarer Himmel
12/5/2016 22:00,376,104,272,-6,0,Nebel
12/5/2016 23:00,188,65,123,-7,0,Nebel
12/6/2016 0:00,72,11,61,-7,2,Nebel
12/6/2016 1:00,56,12,44,-7,0,Nebel
12/6/2016 2:00,14,5,9,-7,4,Nebel
12/6/2016 3:00,8,0,8,-7,0,Klarer Himmel
12/6/2016 4:00,10,6,4,-7,2,Klarer Himmel
12/6/2016 5:00,48,23,25,-7,4,Klarer Himmel
12/6/2016 6:00,142,96,46,-7,0,Klarer Himmel
12/6/2016 7:00,756,368,388,-7,2,Klarer Himmel
12/6/2016 8:00,1214,708,506,-6,4,Klarer Himmel
12/6/2016 9:00,1114,466,648,-3,4,Klarer Himmel
12/6/2016 10:00,916,564,352,-1,4,Klarer Himmel
12/6/2016 11:00,1009,479,530,1,6,Klarer Himmel
12/6/2016 12:00,1064,635,429,2,6,Klarer Himmel
12/6/2016 13:00,1166,533,633,3,6,Klarer Himmel
12/6/2016 14:00,975,532,443,3,4,Klarer Himmel
12/6/2016 15:00,1271,664,607,2,2,Klarer Himmel
12/6/2016 16:00,1125,607,518,0,4,Klarer Himmel
12/6/2016 17:00,1317,565,752,0,6,Klarer Himmel
12/6/2016 18:00,1084,521,563,0,6,Klarer Himmel
12/6/2016 19:00,989,395,594,-1,6,Klarer Himmel
12/6/2016 20:00,652,200,452,-2,2,Klarer Himmel
12/6/2016 21:00,511,128,383,-1,6,Klarer Himmel
12/6/2016 22:00,469,136,333,-2,7,Klarer Himmel
12/6/2016 23:00,223,43,180,-1,6,Klarer Himmel
12/7/2016 0:00,102,28,74,-2,6,Klarer Himmel
12/7/2016 1:00,71,27,44,-2,6,Klarer Himmel
12/7/2016 2:00,21,10,11,-2,6,Klarer Himmel
12/7/2016 3:00,16,3,13,-2,6,Klarer Himmel
12/7/2016 4:00,19,8,11,-2,7,Klarer Himmel
12/7/2016 5:00,40,27,13,-1,7,Klarer Himmel
12/7/2016 6:00,162,114,48,-1,7,Klarer Himmel
12/7/2016 7:00,738,395,343,-1,9,Klarer Himmel
12/7/2016 8:00,1185,702,483,-1,7,Klarer Himmel
12/7/2016 9:00,937,462,475,0,7,wolkig
12/7/2016 10:00,874,534,340,1,9,Klarer Himmel
12/7/2016 11:00,943,494,449,3,9,Klarer Himmel
12/7/2016 12:00,953,538,415,4,11,Klarer Himmel
12/7/2016 13:00,1146,587,559,6,6,Klarer Himmel
12/7/2016 14:00,926,481,445,7,9,Klarer Himmel
12/7/2016 15:00,1145,551,594,7,9,Klarer Himmel
12/7/2016 16:00,1015,560,455,7,9,Klarer Himmel
12/7/2016 17:00,1288,624,664,7,9,Klarer Himmel
12/7/2016 18:00,1113,590,523,7,9,Klarer Himmel
12/7/2016 19:00,1037,468,569,8,11,Klarer Himmel
12/7/2016 20:00,784,284,500,8,11,Klarer Himmel
12/7/2016 21:00,532,174,358,8,13,Klarer Himmel
12/7/2016 22:00,531,146,385,8,19,Klarer Himmel
12/7/2016 23:00,357,150,207,8,17,Klarer Himmel
12/8/2016 0:00,272,161,111,8,19,Klarer Himmel
12/8/2016 1:00,154,63,91,8,17,Klarer Himmel
12/8/2016 2:00,76,12,64,8,15,Klarer Himmel
12/8/2016 3:00,101,8,93,8,17,Klarer Himmel
12/8/2016 4:00,91,10,81,8,15,Klarer Himmel
12/8/2016 5:00,108,36,72,8,13,Klarer Himmel
12/8/2016 6:00,169,115,54,7,13,Klarer Himmel
12/8/2016 7:00,705,386,319,7,15,Klarer Himmel
12/8/2016 8:00,1123,646,477,7,17,Klarer Himmel
12/8/2016 9:00,1114,574,540,8,19,Klarer Himmel
12/8/2016 10:00,951,628,323,9,22,Klarer Himmel
12/8/2016 11:00,959,467,492,9,19,Klarer Himmel
12/8/2016 12:00,957,534,423,10,15,Klarer Himmel
12/8/2016 13:00,1110,580,530,9,13,Klarer Himmel
12/8/2016 14:00,1014,517,497,9,13,Klarer Himmel
12/8/2016 15:00,1204,589,615,9,13,Klarer Himmel
12/8/2016 16:00,1135,592,543,8,11,Klarer Himmel
12/8/2016 17:00,1242,671,571,8,13,Klarer Himmel
12/8/2016 18:00,1138,569,569,8,13,Klarer Himmel
12/8/2016 19:00,972,392,580,8,19,wolkig
12/8/2016 20:00,621,235,386,8,17,wolkig
12/8/2016 21:00,515,186,329,7,19,Regen
12/8/2016 22:00,450,152,298,7,15,Regen
12/8/2016 23:00,290,104,186,7,13,Regen
12/9/2016 0:00,195,62,133,7,15,wolkig
12/9/2016 1:00,121,47,74,7,17,Regen
12/9/2016 2:00,72,10,62,7,17,Regen
12/9/2016 3:00,21,3,18,8,15,Regen
12/9/2016 4:00,28,7,21,8,20,wolkig
12/9/2016 5:00,54,25,29,8,19,Regen
12/9/2016 6:00,129,90,39,8,17,Regen
12/9/2016 7:00,662,378,284,9,17,wolkig
12/9/2016 8:00,933,526,407,9,19,wolkig
12/9/2016 9:00,871,453,418,9,15,wolkig
12/9/2016 10:00,852,565,287,9,15,wolkig
12/9/2016 11:00,843,517,326,9,11,wolkig
12/9/2016 12:00,886,561,325,9,13,wolkig
12/9/2016 13:00,1003,478,525,9,13,wolkig
12/9/2016 14:00,908,452,456,9,11,wolkig
12/9/2016 15:00,822,458,364,9,9,Regen
12/9/2016 16:00,793,407,386,10,13,wolkig
12/9/2016 17:00,873,441,432,9,7,wolkig
12/9/2016 18:00,852,474,378,10,13,wolkig
12/9/2016 19:00,680,351,329,10,15,wolkig
12/9/2016 20:00,456,203,253,9,13,Klarer Himmel
12/9/2016 21:00,439,150,289,9,13,Klarer Himmel
12/9/2016 22:00,400,145,255,9,11,Klarer Himmel
12/9/2016 23:00,306,96,210,9,11,Klarer Himmel
12/10/2016 0:00,240,80,160,9,9,Klarer Himmel
12/10/2016 1:00,262,93,169,8,11,Klarer Himmel
12/10/2016 2:00,163,44,119,8,9,Klarer Himmel
12/10/2016 3:00,133,29,104,8,15,Klarer Himmel
12/10/2016 4:00,84,18,66,8,15,Klarer Himmel
12/10/2016 5:00,82,27,55,8,13,Klarer Himmel
12/10/2016 6:00,52,19,33,7,15,Klarer Himmel
12/10/2016 7:00,84,66,18,8,17,Klarer Himmel
12/10/2016 8:00,210,134,76,7,13,Klarer Himmel
12/10/2016 9:00,384,282,102,8,11,wolkig
12/10/2016 10:00,423,304,119,8,13,wolkig
12/10/2016 11:00,516,363,153,8,19,wolkig
12/10/2016 12:00,602,386,216,8,19,Regen
12/10/2016 13:00,573,318,255,7,13,Regen
12/10/2016 14:00,652,343,309,7,13,Regen
12/10/2016 15:00,475,227,248,7,11,Regen
12/10/2016 16:00,516,211,305,7,11,Regen
12/10/2016 17:00,445,201,244,7,7,
12/10/2016 18:00,459,193,266,7,7,Regen
12/10/2016 19:00,443,210,233,8,9,Regen
12/10/2016 20:00,327,147,180,8,9,Regen
12/10/2016 21:00,278,120,158,8,9,Regen
12/10/2016 22:00,257,97,160,8,9,Regen
12/10/2016 23:00,195,50,145,9,11,Regen
12/11/2016 0:00,183,56,127,9,20,Regen
12/11/2016 1:00,206,70,136,9,20,Regen
12/11/2016 2:00,119,41,78,9,26,Regen
12/11/2016 3:00,80,12,68,9,26,Regen
12/11/2016 4:00,51,14,37,9,32,Regen
12/11/2016 5:00,47,10,37,9,35,Regen
12/11/2016 6:00,38,19,19,8,24,wolkig
12/11/2016 7:00,30,21,9,7,22,wolkig
12/11/2016 8:00,61,38,23,7,19,wolkig
12/11/2016 9:00,173,117,56,7,20,wolkig
12/11/2016 10:00,216,156,60,8,22,wolkig
12/11/2016 11:00,218,152,66,9,24,wolkig
12/11/2016 12:00,278,151,127,9,28,wolkig
12/11/2016 13:00,298,166,132,9,26,wolkig
12/11/2016 14:00,354,202,152,8,22,wolkig
12/11/2016 15:00,366,205,161,8,15,Regen
12/11/2016 16:00,408,221,187,8,19,Regen
12/11/2016 17:00,395,175,220,8,20,wolkig
12/11/2016 18:00,376,176,200,7,20,wolkig
12/11/2016 19:00,323,107,216,7,20,Regen
12/11/2016 20:00,316,97,219,7,17,Regen
12/11/2016 21:00,157,67,90,7,15,Regen
12/11/2016 22:00,238,62,176,7,15,wolkig
12/11/2016 23:00,102,31,71,7,17,wolkig
12/12/2016 0:00,53,16,37,7,15,wolkig
12/12/2016 1:00,32,17,15,7,17,wolkig
12/12/2016 2:00,6,3,3,7,13,wolkig
12/12/2016 3:00,4,0,4,7,15,wolkig
12/12/2016 4:00,14,10,4,7,13,Regen
12/12/2016 5:00,51,29,22,7,11,Regen
12/12/2016 6:00,162,112,50,7,9,wolkig
12/12/2016 7:00,706,425,281,6,9,Nebel
12/12/2016 8:00,1036,617,419,7,7,wolkig
12/12/2016 9:00,920,486,434,7,9,wolkig
12/12/2016 10:00,833,509,324,8,9,wolkig
12/12/2016 11:00,887,418,469,8,9,wolkig
12/12/2016 12:00,858,478,380,8,9,wolkig
12/12/2016 13:00,1004,519,485,8,13,wolkig
12/12/2016 14:00,943,545,398,7,13,wolkig
12/12/2016 15:00,1202,580,622,7,9,wolkig
12/12/2016 16:00,1146,645,501,7,4,wolkig
12/12/2016 17:00,1295,628,667,7,9,wolkig
12/12/2016 18:00,1039,508,531,7,6,wolkig
12/12/2016 19:00,920,358,562,6,4,wolkig
12/12/2016 20:00,670,215,455,6,6,wolkig
12/12/2016 21:00,411,175,236,6,6,wolkig
12/12/2016 22:00,390,125,265,6,6,wolkig
12/12/2016 23:00,219,75,144,6,7,wolkig
12/13/2016 0:00,106,47,59,6,7,wolkig
12/13/2016 1:00,47,15,32,6,6,wolkig
12/13/2016 2:00,19,6,13,5,7,wolkig
12/13/2016 3:00,22,4,18,5,7,wolkig
12/13/2016 4:00,15,8,7,4,6,wolkig
12/13/2016 5:00,68,36,32,5,7,wolkig
12/13/2016 6:00,159,116,43,5,7,Klarer Himmel
12/13/2016 7:00,768,404,364,6,7,Regen
12/13/2016 8:00,1071,612,459,6,7,Regen
12/13/2016 9:00,1130,579,551,6,7,wolkig
12/13/2016 10:00,930,599,331,6,7,wolkig
12/13/2016 11:00,965,498,467,6,6,Regen
12/13/2016 12:00,925,544,381,6,11,Regen
12/13/2016 13:00,1136,563,573,6,9,Regen
12/13/2016 14:00,957,559,398,6,13,Regen
12/13/2016 15:00,1181,646,535,6,9,wolkig
12/13/2016 16:00,1133,602,531,6,9,wolkig
12/13/2016 17:00,1304,632,672,6,7,wolkig
12/13/2016 18:00,1225,661,564,7,6,wolkig
12/13/2016 19:00,908,397,511,7,7,wolkig
12/13/2016 20:00,634,204,430,7,6,wolkig
12/13/2016 21:00,500,156,344,7,6,wolkig
12/13/2016 22:00,404,135,269,7,7,wolkig
12/13/2016 23:00,278,88,190,7,11,wolkig
12/14/2016 0:00,161,40,121,7,0,wolkig
12/14/2016 1:00,68,24,44,7,4,wolkig
12/14/2016 2:00,26,11,15,7,0,wolkig
12/14/2016 3:00,7,2,5,7,4,Nebel
12/14/2016 4:00,11,6,5,7,6,Nebel
12/14/2016 5:00,56,35,21,7,6,wolkig
12/14/2016 6:00,167,118,49,7,6,wolkig
12/14/2016 7:00,736,437,299,7,4,wolkig
12/14/2016 8:00,1087,651,436,7,0,wolkig
12/14/2016 9:00,1024,529,495,7,6,wolkig
12/14/2016 10:00,838,527,311,7,6,Nebel
12/14/2016 11:00,829,475,354,8,6,Regen
12/14/2016 12:00,952,586,366,8,6,Regen
12/14/2016 13:00,1094,563,531,8,4,wolkig
12/14/2016 14:00,960,575,385,8,7,Nebel
12/14/2016 15:00,1153,511,642,8,4,wolkig
12/14/2016 16:00,1093,576,517,8,6,wolkig
12/14/2016 17:00,1277,629,648,8,4,wolkig
12/14/2016 18:00,1104,505,599,8,4,Nebel
12/14/2016 19:00,993,454,539,8,4,wolkig
12/14/2016 20:00,720,288,432,8,6,wolkig
12/14/2016 21:00,497,211,286,8,4,wolkig
12/14/2016 22:00,521,185,336,8,2,wolkig
12/14/2016 23:00,362,157,205,8,7,wolkig
12/15/2016 0:00,278,128,150,7,4,wolkig
12/15/2016 1:00,154,47,107,6,4,teilweise bewölkt
12/15/2016 2:00,130,30,100,6,6,teilweise bewölkt
12/15/2016 3:00,80,4,76,5,6,teilweise bewölkt
12/15/2016 4:00,59,13,46,5,6,teilweise bewölkt
12/15/2016 5:00,63,31,32,5,7,
12/15/2016 6:00,165,115,50,5,9,
12/15/2016 7:00,693,389,304,5,6,
12/15/2016 8:00,1090,635,455,4,6,
12/15/2016 9:00,1015,562,453,5,9,teilweise bewölkt
12/15/2016 10:00,906,599,307,5,11,wolkig
12/15/2016 11:00,1099,562,537,6,11,wolkig
12/15/2016 12:00,1030,534,496,6,9,wolkig
12/15/2016 13:00,1112,565,547,6,9,wolkig
12/15/2016 14:00,1047,581,466,6,9,wolkig
12/15/2016 15:00,1242,638,604,6,7,wolkig
12/15/2016 16:00,1175,635,540,6,6,teilweise bewölkt
12/15/2016 17:00,1423,750,673,5,6,Klarer Himmel
12/15/2016 18:00,1050,527,523,5,7,Klarer Himmel
12/15/2016 19:00,888,325,563,4,9,Klarer Himmel
12/15/2016 20:00,715,274,441,4,7,Klarer Himmel
12/15/2016 21:00,481,171,310,4,6,Klarer Himmel
12/15/2016 22:00,440,146,294,4,6,Klarer Himmel
12/15/2016 23:00,347,130,217,3,7,Klarer Himmel
12/16/2016 0:00,205,77,128,3,7,Klarer Himmel
12/16/2016 1:00,167,54,113,3,7,Klarer Himmel
12/16/2016 2:00,107,29,78,2,6,Klarer Himmel
12/16/2016 3:00,49,7,42,2,6,Klarer Himmel
12/16/2016 4:00,73,15,58,2,6,Klarer Himmel
12/16/2016 5:00,59,25,34,2,6,Klarer Himmel
12/16/2016 6:00,145,89,56,2,6,
12/16/2016 7:00,637,391,246,2,6,Nebel
12/16/2016 8:00,883,513,370,2,7,Nebel
12/16/2016 9:00,866,448,418,2,6,
12/16/2016 10:00,803,498,305,3,9,Klarer Himmel
12/16/2016 11:00,912,524,388,4,9,Klarer Himmel
12/16/2016 12:00,925,564,361,5,7,Klarer Himmel
12/16/2016 13:00,1117,617,500,6,7,Klarer Himmel
12/16/2016 14:00,966,490,476,6,7,Klarer Himmel
12/16/2016 15:00,957,506,451,5,2,Klarer Himmel
12/16/2016 16:00,890,424,466,3,4,Klarer Himmel
12/16/2016 17:00,906,371,535,1,2,Klarer Himmel
12/16/2016 18:00,821,390,431,1,4,Klarer Himmel
12/16/2016 19:00,817,414,403,1,6,Nebel
12/16/2016 20:00,513,226,287,1,7,
12/16/2016 21:00,411,140,271,1,7,
12/16/2016 22:00,372,124,248,0,4,
12/16/2016 23:00,324,127,197,0,4,
12/17/2016 0:00,292,109,183,-1,4,Nebel
12/17/2016 1:00,245,88,157,0,6,Nebel
12/17/2016 2:00,186,50,136,0,4,
12/17/2016 3:00,141,26,115,0,6,
12/17/2016 4:00,109,19,90,1,4,
12/17/2016 5:00,75,17,58,0,2,
12/17/2016 6:00,45,21,24,0,7,
12/17/2016 7:00,89,65,24,0,6,Nebel
12/17/2016 8:00,197,128,69,1,6,Nebel
12/17/2016 9:00,332,262,70,1,6,
12/17/2016 10:00,458,358,100,2,6,
12/17/2016 11:00,455,309,146,2,6,
12/17/2016 12:00,543,344,199,3,6,
12/17/2016 13:00,553,311,242,4,2,
12/17/2016 14:00,583,308,275,4,9,
12/17/2016 15:00,561,271,290,4,2,
12/17/2016 16:00,554,268,286,4,7,wolkig
12/17/2016 17:00,524,245,279,5,4,wolkig
12/17/2016 18:00,523,222,301,5,7,Regen
12/17/2016 19:00,463,217,246,5,7,Regen
12/17/2016 20:00,381,151,230,5,6,Regen
12/17/2016 21:00,328,143,185,5,7,Regen
12/17/2016 22:00,254,89,165,5,9,wolkig
12/17/2016 23:00,229,94,135,6,9,wolkig
12/18/2016 0:00,245,89,156,6,9,Regen
12/18/2016 1:00,193,62,131,6,13,Regen
12/18/2016 2:00,135,41,94,5,9,wolkig
12/18/2016 3:00,82,20,62,6,13,wolkig
12/18/2016 4:00,85,14,71,6,13,wolkig
12/18/2016 5:00,57,6,51,6,11,wolkig
12/18/2016 6:00,35,10,25,5,9,wolkig
12/18/2016 7:00,46,21,25,5,11,wolkig
12/18/2016 8:00,51,36,15,6,15,wolkig
12/18/2016 9:00,174,123,51,6,11,wolkig
12/18/2016 10:00,247,177,70,6,11,wolkig
12/18/2016 11:00,238,158,80,7,13,wolkig
12/18/2016 12:00,303,179,124,7,11,wolkig
12/18/2016 13:00,301,168,133,7,13,wolkig
12/18/2016 14:00,408,224,184,7,9,wolkig
12/18/2016 15:00,425,251,174,7,7,wolkig
12/18/2016 16:00,449,218,231,6,13,wolkig
12/18/2016 17:00,494,238,256,6,7,wolkig
12/18/2016 18:00,395,196,199,6,6,wolkig
12/18/2016 19:00,392,161,231,6,2,wolkig
12/18/2016 20:00,329,85,244,5,6,wolkig
12/18/2016 21:00,172,46,126,5,0,wolkig
12/18/2016 22:00,190,51,139,5,0,wolkig
12/18/2016 23:00,135,40,95,5,4,wolkig
12/19/2016 0:00,82,30,52,5,4,wolkig
12/19/2016 1:00,28,9,19,5,0,wolkig
12/19/2016 2:00,11,3,8,5,0,wolkig
12/19/2016 3:00,9,1,8,5,0,wolkig
12/19/2016 4:00,19,8,11,5,0,Regen
12/19/2016 5:00,40,23,17,5,0,wolkig
12/19/2016 6:00,135,98,37,4,0,Nebel
12/19/2016 7:00,605,370,235,5,4,wolkig
12/19/2016 8:00,917,546,371,4,6,wolkig
12/19/2016 9:00,891,471,420,4,4,wolkig
12/19/2016 10:00,803,487,316,4,7,wolkig
12/19/2016 11:00,885,439,446,5,4,teilweise bewölkt
12/19/2016 12:00,887,519,368,6,7,teilweise bewölkt
12/19/2016 13:00,1093,597,496,7,7,teilweise bewölkt
12/19/2016 14:00,929,516,413,6,9,teilweise bewölkt
12/19/2016 15:00,1180,624,556,5,7,teilweise bewölkt
12/19/2016 16:00,1168,655,513,5,6,wolkig
12/19/2016 17:00,1297,634,663,5,9,wolkig
12/19/2016 18:00,1094,570,524,4,4,teilweise bewölkt
12/19/2016 19:00,1002,426,576,3,6,Klarer Himmel
12/19/2016 20:00,634,193,441,3,7,Klarer Himmel
12/19/2016 21:00,375,136,239,1,6,Klarer Himmel
12/19/2016 22:00,370,113,257,1,6,Klarer Himmel
12/19/2016 23:00,275,67,208,0,4,Klarer Himmel
12/20/2016 0:00,158,39,119,0,4,Klarer Himmel
12/20/2016 1:00,88,17,71,-1,4,Klarer Himmel
12/20/2016 2:00,52,26,26,-1,4,
12/20/2016 3:00,23,3,20,0,6,Nebel
12/20/2016 4:00,21,10,11,-1,4,Nebel
12/20/2016 5:00,47,27,20,-1,4,Nebel
12/20/2016 6:00,144,106,38,-3,0,Nebel
12/20/2016 7:00,706,365,341,-3,6,Nebel
12/20/2016 8:00,995,556,439,-3,0,Nebel
12/20/2016 9:00,979,502,477,-2,6,Nebel
12/20/2016 10:00,908,579,329,1,0,Klarer Himmel
12/20/2016 11:00,1014,515,499,3,6,Klarer Himmel
12/20/2016 12:00,1092,641,451,4,7,Klarer Himmel
12/20/2016 13:00,1168,590,578,3,13,Klarer Himmel
12/20/2016 14:00,1055,622,433,2,7,Klarer Himmel
12/20/2016 15:00,1220,629,591,1,9,Klarer Himmel
12/20/2016 16:00,1246,650,596,0,6,
12/20/2016 17:00,1299,619,680,-1,4,Nebel
12/20/2016 18:00,1128,518,610,-2,4,Nebel
12/20/2016 19:00,905,402,503,-2,4,Nebel
12/20/2016 20:00,599,225,374,-3,2,Nebel
12/20/2016 21:00,408,153,255,-2,6,Nebel
12/20/2016 22:00,418,120,298,-2,7,Nebel
12/20/2016 23:00,306,84,222,-2,7,
12/21/2016 0:00,210,63,147,-2,9,
12/21/2016 1:00,119,30,89,-2,6,
12/21/2016 2:00,55,10,45,-2,7,Klarer Himmel
12/21/2016 3:00,30,5,25,0,7,wolkig
12/21/2016 4:00,34,9,25,0,9,wolkig
12/21/2016 5:00,55,31,24,0,7,wolkig
12/21/2016 6:00,155,112,43,0,4,teilweise bewölkt
12/21/2016 7:00,656,338,318,0,9,Klarer Himmel
12/21/2016 8:00,935,551,384,0,9,Klarer Himmel
12/21/2016 9:00,924,505,419,1,7,Klarer Himmel
12/21/2016 10:00,905,552,353,2,9,Klarer Himmel
12/21/2016 11:00,954,561,393,4,13,Klarer Himmel
12/21/2016 12:00,1009,581,428,4,15,Klarer Himmel
12/21/2016 13:00,1189,712,477,6,17,Klarer Himmel
12/21/2016 14:00,1042,530,512,6,13,wolkig
12/21/2016 15:00,1179,529,650,5,13,wolkig
12/21/2016 16:00,1142,556,586,5,13,wolkig
12/21/2016 17:00,1170,585,585,5,17,Klarer Himmel
12/21/2016 18:00,1030,517,513,4,9,Klarer Himmel
12/21/2016 19:00,972,461,511,4,13,wolkig
12/21/2016 20:00,645,247,398,4,17,Regen
12/21/2016 21:00,464,124,340,4,11,Regen
12/21/2016 22:00,453,160,293,3,7,Regen
12/21/2016 23:00,380,137,243,3,6,Regen
12/22/2016 0:00,292,136,156,3,6,Regen
12/22/2016 1:00,247,71,176,3,7,Regen
12/22/2016 2:00,138,23,115,4,13,Regen
12/22/2016 3:00,99,10,89,4,11,Regen
12/22/2016 4:00,89,15,74,4,11,Regen
12/22/2016 5:00,66,19,47,3,6,Regen
12/22/2016 6:00,96,65,31,3,7,Regen
12/22/2016 7:00,371,214,157,3,7,Regen
12/22/2016 8:00,574,364,210,4,11,Regen
12/22/2016 9:00,661,372,289,4,11,Regen
12/22/2016 10:00,665,427,238,4,4,wolkig
12/22/2016 11:00,775,430,345,4,9,wolkig
12/22/2016 12:00,740,389,351,5,7,wolkig
12/22/2016 13:00,846,434,412,5,7,Regen
12/22/2016 14:00,748,413,335,6,9,Regen
12/22/2016 15:00,936,536,400,5,9,wolkig
12/22/2016 16:00,789,382,407,6,9,wolkig
12/22/2016 17:00,847,391,456,5,11,wolkig
12/22/2016 18:00,654,322,332,5,9,wolkig
12/22/2016 19:00,556,190,366,5,15,wolkig
12/22/2016 20:00,428,160,268,5,19,Regen
12/22/2016 21:00,235,90,145,5,15,Regen
12/22/2016 22:00,227,96,131,6,15,wolkig
12/22/2016 23:00,154,44,110,5,11,teilweise bewölkt
12/23/2016 0:00,149,45,104,5,11,wolkig
12/23/2016 1:00,122,30,92,4,9,teilweise bewölkt
12/23/2016 2:00,78,19,59,4,7,wolkig
12/23/2016 3:00,51,9,42,4,9,teilweise bewölkt
12/23/2016 4:00,40,10,30,5,9,wolkig
12/23/2016 5:00,40,19,21,5,11,wolkig
12/23/2016 6:00,82,54,28,5,13,wolkig
12/23/2016 7:00,222,128,94,5,13,wolkig
12/23/2016 8:00,274,177,97,5,13,wolkig
12/23/2016 9:00,328,218,110,5,15,wolkig
12/23/2016 10:00,379,251,128,6,17,wolkig
12/23/2016 11:00,426,260,166,6,15,wolkig
12/23/2016 12:00,485,268,217,7,17,wolkig
12/23/2016 13:00,540,284,256,8,15,wolkig
12/23/2016 14:00,454,242,212,8,17,wolkig
12/23/2016 15:00,464,224,240,8,15,wolkig
12/23/2016 16:00,433,224,209,7,15,Klarer Himmel
12/23/2016 17:00,358,175,183,6,17,Klarer Himmel
12/23/2016 18:00,307,136,171,6,17,Klarer Himmel
12/23/2016 19:00,248,111,137,5,20,Klarer Himmel
12/23/2016 20:00,187,88,99,5,19,Klarer Himmel
12/23/2016 21:00,151,72,79,5,22,Klarer Himmel
12/23/2016 22:00,87,32,55,4,22,wolkig
12/23/2016 23:00,119,42,77,5,26,wolkig
12/24/2016 0:00,90,12,78,6,22,wolkig
12/24/2016 1:00,97,16,81,6,26,Regen
12/24/2016 2:00,58,6,52,6,22,Regen
12/24/2016 3:00,54,11,43,6,24,Regen
12/24/2016 4:00,20,6,14,7,20,Regen
12/24/2016 5:00,26,5,21,7,22,Regen
12/24/2016 6:00,40,26,14,7,20,wolkig
12/24/2016 7:00,42,26,16,7,20,wolkig
12/24/2016 8:00,87,61,26,7,19,wolkig
12/24/2016 9:00,173,138,35,7,19,wolkig
12/24/2016 10:00,264,173,91,8,24,wolkig
12/24/2016 11:00,240,127,113,8,32,wolkig
12/24/2016 12:00,215,103,112,8,30,wolkig
12/24/2016 13:00,166,62,104,8,30,wolkig
12/24/2016 14:00,157,77,80,8,28,wolkig
12/24/2016 15:00,109,43,66,7,28,wolkig
12/24/2016 16:00,145,65,80,7,24,wolkig
12/24/2016 17:00,75,35,40,7,24,wolkig
12/24/2016 18:00,55,12,43,7,26,wolkig
12/24/2016 19:00,58,22,36,8,26,wolkig
12/24/2016 20:00,35,18,17,8,24,wolkig
12/24/2016 21:00,25,15,10,8,30,wolkig
12/24/2016 22:00,38,15,23,8,32,wolkig
12/24/2016 23:00,48,27,21,8,35,wolkig
12/25/2016 0:00,48,19,29,8,26,wolkig
12/25/2016 1:00,31,17,14,8,30,Regen
12/25/2016 2:00,9,3,6,8,26,Regen
12/25/2016 3:00,7,0,7,8,28,Regen
12/25/2016 4:00,4,0,4,8,28,Regen
12/25/2016 5:00,16,10,6,9,28,wolkig
12/25/2016 6:00,14,9,5,9,26,wolkig
12/25/2016 7:00,11,6,5,9,28,Regen
12/25/2016 8:00,12,6,6,8,28,Regen
12/25/2016 9:00,21,16,5,9,30,Regen
12/25/2016 10:00,35,20,15,9,32,Regen
12/25/2016 11:00,44,23,21,9,26,Regen
12/25/2016 12:00,43,18,25,9,22,Regen
12/25/2016 13:00,43,22,21,9,20,Regen
12/25/2016 14:00,37,18,19,9,24,Regen
12/25/2016 15:00,40,21,19,9,24,Regen
12/25/2016 16:00,43,19,24,10,24,Regen
12/25/2016 17:00,23,10,13,10,26,Regen
12/25/2016 18:00,45,23,22,10,24,Regen
12/25/2016 19:00,39,15,24,10,30,Regen
12/25/2016 20:00,40,24,16,11,26,Regen
12/25/2016 21:00,38,15,23,11,24,wolkig
12/25/2016 22:00,32,19,13,11,24,Regen
12/25/2016 23:00,29,16,13,11,26,wolkig
12/26/2016 0:00,17,9,8,11,24,Regen
12/26/2016 1:00,23,12,11,11,26,wolkig
12/26/2016 2:00,8,2,6,11,30,Regen
12/26/2016 3:00,5,2,3,11,24,Regen
12/26/2016 4:00,9,3,6,11,24,Regen
12/26/2016 5:00,11,2,9,11,26,Regen
12/26/2016 6:00,20,6,14,10,26,Regen
12/26/2016 7:00,13,9,4,10,22,Regen
12/26/2016 8:00,14,7,7,9,33,Regen
12/26/2016 9:00,27,22,5,8,24,Regen
12/26/2016 10:00,29,19,10,8,24,Regen
12/26/2016 11:00,42,20,22,8,32,wolkig
12/26/2016 12:00,86,55,31,8,32,teilweise bewölkt
12/26/2016 13:00,72,35,37,8,28,teilweise bewölkt
12/26/2016 14:00,89,57,32,8,35,teilweise bewölkt
12/26/2016 15:00,135,76,59,7,33,teilweise bewölkt
12/26/2016 16:00,75,47,28,6,26,teilweise bewölkt
12/26/2016 17:00,86,38,48,6,32,teilweise bewölkt
12/26/2016 18:00,96,54,42,6,26,teilweise bewölkt
12/26/2016 19:00,66,30,36,5,28,teilweise bewölkt
12/26/2016 20:00,67,26,41,5,28,teilweise bewölkt
12/26/2016 21:00,83,40,43,4,28,Klarer Himmel
12/26/2016 22:00,57,19,38,5,30,Klarer Himmel
12/26/2016 23:00,61,27,34,5,32,Klarer Himmel
12/27/2016 0:00,33,13,20,4,32,Klarer Himmel
12/27/2016 1:00,21,4,17,5,30,Klarer Himmel
12/27/2016 2:00,12,5,7,5,22,teilweise bewölkt
12/27/2016 3:00,26,5,21,4,20,teilweise bewölkt
12/27/2016 4:00,10,4,6,4,19,teilweise bewölkt
12/27/2016 5:00,29,16,13,4,19,wolkig
12/27/2016 6:00,64,43,21,4,19,teilweise bewölkt
12/27/2016 7:00,125,68,57,5,20,wolkig
12/27/2016 8:00,139,93,46,5,17,wolkig
12/27/2016 9:00,171,114,57,5,17,wolkig
12/27/2016 10:00,184,126,58,6,26,Klarer Himmel
12/27/2016 11:00,187,124,63,7,26,Klarer Himmel
12/27/2016 12:00,272,167,105,8,24,teilweise bewölkt
12/27/2016 13:00,245,132,113,8,22,teilweise bewölkt
12/27/2016 14:00,330,199,131,8,22,wolkig
12/27/2016 15:00,303,163,140,8,19,wolkig
12/27/2016 16:00,323,148,175,8,17,wolkig
12/27/2016 17:00,279,118,161,7,15,teilweise bewölkt
12/27/2016 18:00,234,87,147,6,15,teilweise bewölkt
12/27/2016 19:00,194,97,97,6,15,teilweise bewölkt
12/27/2016 20:00,133,42,91,5,11,teilweise bewölkt
12/27/2016 21:00,94,44,50,4,11,teilweise bewölkt
12/27/2016 22:00,81,35,46,6,9,wolkig
12/27/2016 23:00,50,14,36,6,11,wolkig
12/28/2016 0:00,42,11,31,5,11,wolkig
12/28/2016 1:00,59,12,47,5,11,wolkig
12/28/2016 2:00,14,0,14,3,11,wolkig
12/28/2016 3:00,11,3,8,2,13,teilweise bewölkt
12/28/2016 4:00,6,3,3,2,7,Klarer Himmel
12/28/2016 5:00,25,15,10,2,6,
12/28/2016 6:00,61,45,16,0,0,Nebel
12/28/2016 7:00,140,81,59,3,11,Nebel
12/28/2016 8:00,199,136,63,3,9,Nebel
12/28/2016 9:00,236,167,69,3,9,Nebel
12/28/2016 10:00,245,151,94,3,9,wolkig
12/28/2016 11:00,265,185,80,4,6,wolkig
12/28/2016 12:00,285,157,128,4,7,wolkig
12/28/2016 13:00,277,150,127,5,7,wolkig
12/28/2016 14:00,294,149,145,5,6,wolkig
12/28/2016 15:00,302,142,160,5,7,wolkig
12/28/2016 16:00,343,163,180,4,4,wolkig
12/28/2016 17:00,292,124,168,4,6,wolkig
12/28/2016 18:00,311,135,176,4,6,wolkig
12/28/2016 19:00,259,125,134,4,2,wolkig
12/28/2016 20:00,180,91,89,4,0,wolkig
12/28/2016 21:00,143,64,79,5,4,wolkig
12/28/2016 22:00,122,46,76,4,4,wolkig
12/28/2016 23:00,81,32,49,3,4,wolkig
12/29/2016 0:00,71,23,48,3,4,wolkig
12/29/2016 1:00,66,15,51,0,2,teilweise bewölkt
12/29/2016 2:00,54,7,47,-1,0,Nebel
12/29/2016 3:00,32,2,30,-2,0,Nebel
12/29/2016 4:00,26,6,20,-3,0,Nebel
12/29/2016 5:00,27,11,16,-3,0,Nebel
12/29/2016 6:00,60,36,24,-3,0,Nebel
12/29/2016 7:00,142,80,62,-3,0,Nebel
12/29/2016 8:00,163,115,48,-4,2,Nebel
12/29/2016 9:00,238,159,79,-1,6,Klarer Himmel
12/29/2016 10:00,231,146,85,1,4,Klarer Himmel
12/29/2016 11:00,247,156,91,3,7,Klarer Himmel
12/29/2016 12:00,316,198,118,4,4,Klarer Himmel
12/29/2016 13:00,336,182,154,5,7,Klarer Himmel
12/29/2016 14:00,361,212,149,5,9,Klarer Himmel
12/29/2016 15:00,352,190,162,4,7,Klarer Himmel
12/29/2016 16:00,381,177,204,2,4,Klarer Himmel
12/29/2016 17:00,360,141,219,0,4,Klarer Himmel
12/29/2016 18:00,311,111,200,1,7,Klarer Himmel
12/29/2016 19:00,266,128,138,0,6,Klarer Himmel
12/29/2016 20:00,160,45,115,-2,2,Klarer Himmel
12/29/2016 21:00,112,58,54,-3,6,Nebel
12/29/2016 22:00,146,33,113,-3,4,Nebel
12/29/2016 23:00,85,24,61,-3,0,Nebel
12/30/2016 0:00,82,25,57,-3,0,Nebel
12/30/2016 1:00,53,21,32,-4,4,Nebel
12/30/2016 2:00,22,5,17,-4,0,Nebel
12/30/2016 3:00,20,9,11,-4,4,Nebel
12/30/2016 4:00,8,4,4,-5,0,Nebel
12/30/2016 5:00,27,16,11,-5,0,Nebel
12/30/2016 6:00,54,33,21,-5,0,Nebel
12/30/2016 7:00,108,70,38,-5,0,
12/30/2016 8:00,165,103,62,-3,9,Nebel
12/30/2016 9:00,203,139,64,-2,6,Klarer Himmel
12/30/2016 10:00,238,159,79,1,7,Klarer Himmel
12/30/2016 11:00,274,167,107,2,6,Klarer Himmel
12/30/2016 12:00,351,194,157,4,6,Klarer Himmel
12/30/2016 13:00,355,194,161,5,6,Klarer Himmel
12/30/2016 14:00,356,191,165,4,9,Klarer Himmel
12/30/2016 15:00,354,190,164,4,7,Klarer Himmel
12/30/2016 16:00,333,162,171,0,7,Klarer Himmel
12/30/2016 17:00,323,121,202,0,7,Klarer Himmel
12/30/2016 18:00,264,121,143,-1,7,Klarer Himmel
12/30/2016 19:00,240,112,128,-2,7,Nebel
12/30/2016 20:00,152,62,90,-3,6,Nebel
12/30/2016 21:00,115,51,64,-3,0,Nebel
12/30/2016 22:00,155,44,111,-4,0,Nebel
12/30/2016 23:00,92,26,66,-4,6,Nebel
12/31/2016 0:00,93,17,76,-4,4,Nebel
12/31/2016 1:00,60,20,40,-6,0,Nebel
12/31/2016 2:00,26,6,20,-5,6,Nebel
12/31/2016 3:00,19,6,13,-3,6,Nebel
12/31/2016 4:00,19,3,16,-1,6,Nebel
12/31/2016 5:00,30,14,16,-1,13,Nebel
12/31/2016 6:00,21,12,9,-1,13,Nebel
12/31/2016 7:00,31,17,14,-1,9,wolkig
12/31/2016 8:00,76,45,31,-1,9,wolkig
12/31/2016 9:00,133,96,37,0,7,Nebel
12/31/2016 10:00,199,121,78,0,11,Nebel
12/31/2016 11:00,258,155,103,0,11,Nebel
12/31/2016 12:00,273,135,138,0,11,wolkig
12/31/2016 13:00,236,102,134,0,9,wolkig
12/31/2016 14:00,182,62,120,0,11,wolkig
12/31/2016 15:00,129,68,61,0,7,wolkig
12/31/2016 16:00,138,76,62,0,11,wolkig
12/31/2016 17:00,172,90,82,1,7,wolkig
12/31/2016 18:00,256,131,125,1,6,wolkig
12/31/2016 19:00,275,122,153,1,7,wolkig
12/31/2016 20:00,176,85,91,2,7,wolkig
12/31/2016 21:00,89,44,45,3,13,wolkig
12/31/2016 22:00,102,52,50,3,11,wolkig
12/31/2016 23:00,151,121,30,3,15,wolkig
,,,,,,
Jahressumme,4105177,,,,,
